,total_tweets,avg_tweet_length,avg_sentiment,activity_duration,degree,rumor_ratio,events,neighbors,rumor_tweets,non_rumor_tweets,total_tweets
2911191121,2,52.5,-0.012331247329711914,1997271.0,2,0.5,"[""charliehebdo-all-rnr-threads"", ""sydneysiege-all-rnr-threads""]","[""384779793"", ""177886974""]",1,1,2
102149847,4,72.0,-0.33329588174819946,2169797.0,3,1.0,"[""charliehebdo-all-rnr-threads"", ""sydneysiege-all-rnr-threads""]","[""384779793"", ""51241574"", ""14293310""]",4,0,4
25067168,7,118.28571428571429,-0.615983784198761,6565211.0,44,0.7142857142857143,"[""charliehebdo-all-rnr-threads"", ""germanwings-crash-all-rnr-threads""]","[""2206690108"", ""376679692"", ""1550984940"", ""55771784"", ""33668152"", ""66291237"", ""546134107"", ""935302063"", ""58054668"", ""34033504"", ""2407727400"", ""1867323613"", ""302802506"", ""104394500"", ""370666310"", ""73081987"", ""427588761"", ""2711184886"", ""200468277"", ""2304287907"", ""2459278543"", ""993859812"", ""116402034"", ""1221129204"", ""241309199"", ""24118236"", ""56666374"", ""122025735"", ""9114032"", ""2413247540"", ""2875761863"", ""1357102304"", ""41964836"", ""2494313337"", ""76987535"", ""558096359"", ""707502001"", ""1635904842"", ""40420774"", ""2950954733"", ""869413422"", ""632834693"", ""1348798826"", ""27233309""]",5,2,7
14569869,8,124.375,-0.6190893054008484,8591747.0,61,0.625,"[""charliehebdo-all-rnr-threads"", ""germanwings-crash-all-rnr-threads"", ""sydneysiege-all-rnr-threads""]","[""315326703"", ""108171720"", ""2172247089"", ""201825680"", ""2483752741"", ""279178451"", ""60526729"", ""23444554"", ""16901935"", ""30186455"", ""52404825"", ""1234987687"", ""486165114"", ""27151453"", ""55218013"", ""802057369"", ""25995131"", ""335230484"", ""163852928"", ""21565433"", ""232510233"", ""20167195"", ""73509960"", ""14569869"", ""522638276"", ""2888296032"", ""2279864526"", ""2471587969"", ""1106204762"", ""2780648743"", ""285089704"", ""1121260147"", ""470436587"", ""2905542639"", ""968138851"", ""893485608"", ""921217862"", ""1241486952"", ""2893611147"", ""2417900712"", ""895570464"", ""716027743"", ""20232263"", ""75613253"", ""2627038460"", ""23430012"", ""1914421867"", ""467290324"", ""68397297"", ""1357583305"", ""365528020"", ""19498310"", ""32245985"", ""20422957"", ""1348798826"", ""2924844507"", ""31480794"", ""418854161"", ""1852187108"", ""221310328"", ""3091317905""]",5,3,8
315326703,6,105.66666666666667,-0.3919459780057271,1981978.0,3,0.6666666666666666,"[""charliehebdo-all-rnr-threads"", ""sydneysiege-all-rnr-threads""]","[""7587032"", ""64643056"", ""14569869""]",4,2,6
22240612,3,115.66666666666667,-0.7131050825119019,8576105.0,18,0.6666666666666666,"[""charliehebdo-all-rnr-threads"", ""germanwings-crash-all-rnr-threads"", ""sydneysiege-all-rnr-threads""]","[""114923863"", ""22763983"", ""37629266"", ""1130203891"", ""243495444"", ""211639643"", ""2566535282"", ""1672452854"", ""3082649305"", ""88728383"", ""2241901423"", ""23417338"", ""598684128"", ""58743465"", ""547071660"", ""503203687"", ""1530746612"", ""245725998""]",2,1,3
547071660,7,81.42857142857143,-0.4296206406184605,2023066.0,3,0.7142857142857143,"[""charliehebdo-all-rnr-threads"", ""sydneysiege-all-rnr-threads""]","[""22021978"", ""459390022"", ""22240612""]",5,2,7
87416722,38,114.97368421052632,-0.5458183445428547,13381998.0,419,0.8421052631578947,"[""charliehebdo-all-rnr-threads"", ""germanwings-crash-all-rnr-threads"", ""ottawashooting-all-rnr-threads"", ""sydneysiege-all-rnr-threads""]","[""191146381"", ""2747175253"", ""203122412"", ""2732961533"", ""220223791"", ""239834621"", ""82901787"", ""819134659"", ""49731754"", ""705123059"", ""559396058"", ""145687776"", ""1905556350"", ""483998751"", ""1243715287"", ""147181485"", ""225893954"", ""267876593"", ""218159431"", ""1951178581"", ""550415486"", ""995397505"", ""407661988"", ""388768535"", ""1474332679"", ""363222560"", ""358284864"", ""2842312205"", ""429930033"", ""16947403"", ""186223456"", ""2434772232"", ""2429279764"", ""208984397"", ""221804660"", ""42719424"", ""526197032"", ""295348538"", ""1291034648"", ""171145213"", ""91093655"", ""2933943867"", ""281737861"", ""2582427774"", ""62862239"", ""1600900638"", ""948928304"", ""203679586"", ""227782167"", ""187387276"", ""384529217"", ""906933410"", ""90888044"", ""112189017"", ""260864726"", ""18687276"", ""192744648"", ""243121060"", ""2263772618"", ""16724607"", ""2958552807"", ""602017519"", ""20036134"", ""155187280"", ""2339751753"", ""2654320636"", ""2859122517"", ""249130717"", ""139876129"", ""76779374"", ""18845980"", ""395446240"", ""383424401"", ""188507421"", ""286374794"", ""245308008"", ""2523423999"", ""172488281"", ""87266142"", ""312348051"", ""2842724201"", ""1202276791"", ""118077973"", ""23792545"", ""2418473433"", ""539116569"", ""385935972"", ""38670249"", ""2766568073"", ""937751498"", ""921320174"", ""1020681224"", ""19466430"", ""2884577892"", ""908214080"", ""777548653"", ""195510381"", ""351263372"", ""315498872"", ""226299861"", ""179483838"", ""34465477"", ""1022571973"", ""541775049"", ""86395110"", ""172804217"", ""9055772"", ""36941760"", ""199007460"", ""189579869"", ""571262169"", ""81227900"", ""143182513"", ""20856538"", ""84464003"", ""806713213"", ""124774303"", ""324529622"", ""206596726"", ""44883498"", ""845422015"", ""222796094"", ""343379535"", ""72588786"", ""158030840"", ""2448195321"", ""252287181"", ""227594086"", ""2862600845"", ""214462611"", ""289084923"", ""19349293"", ""513175616"", ""2939872661"", ""24777627"", ""921820068"", ""20041872"", ""407978238"", ""703223386"", ""386471391"", ""1130935460"", ""285048452"", ""1292381898"", ""166758079"", ""48304732"", ""615160218"", ""2182840076"", ""27346105"", ""62591883"", ""33196223"", ""1437948078"", ""2151615237"", ""238707598"", ""45953887"", ""23238499"", ""208480735"", ""209636315"", ""729145220"", ""250600508"", ""436685523"", ""158661955"", ""550454381"", ""285493238"", ""66379716"", ""179519496"", ""21612139"", ""349766971"", ""24282590"", ""81856960"", ""224403587"", ""67924459"", ""1626325842"", ""43598441"", ""304339385"", ""253646082"", ""2773995686"", ""145777083"", ""2545113975"", ""146199428"", ""2464502209"", ""17713530"", ""2951345235"", ""372703979"", ""1216469426"", ""631876809"", ""1201839704"", ""221370044"", ""954530826"", ""156668129"", ""574718143"", ""1018544503"", ""1104066115"", ""16195103"", ""1434028597"", ""309142386"", ""388156578"", ""397512639"", ""2322458507"", ""407273164"", ""30394227"", ""1929619202"", ""50671243"", ""2763818631"", ""622745714"", ""378188513"", ""30470640"", ""63224277"", ""302174491"", ""33169889"", ""2898256383"", ""1344175285"", ""110856651"", ""15507696"", ""18524109"", ""51109691"", ""249207023"", ""318716836"", ""157341362"", ""348608945"", ""267386083"", ""24875893"", ""1009543891"", ""2243504739"", ""292726322"", ""471897811"", ""19537549"", ""57023952"", ""23293888"", ""21929681"", ""1718603144"", ""64043937"", ""64657863"", ""3025149855"", ""2861194665"", ""240886720"", ""932819575"", ""27688964"", ""397930647"", ""597706051"", ""414247388"", ""299810381"", ""20428835"", ""120782305"", ""2504418569"", ""2419734564"", ""478402262"", ""1671271333"", ""194672239"", ""401218524"", ""25734092"", ""1372532851"", ""235865079"", ""2718279617"", ""287576440"", ""831840157"", ""103922613"", ""291355998"", ""206330242"", ""570287667"", ""483374202"", ""749000928"", ""537487633"", ""2613224950"", ""1298174406"", ""26550932"", ""264268327"", ""192359034"", ""164050933"", ""26212879"", ""16681775"", ""241263178"", ""884264040"", ""528837552"", ""18975311"", ""29036071"", ""45114355"", ""263688853"", ""382791333"", ""462304626"", ""53880536"", ""18171434"", ""2609080965"", ""326382274"", ""1655525964"", ""794921233"", ""2925094346"", ""874385394"", ""316625731"", ""369408768"", ""2333715792"", ""20075307"", ""408421362"", ""772997556"", ""60634139"", ""2370908751"", ""309075828"", ""1184253228"", ""251792619"", ""2960490339"", ""175591388"", ""561121463"", ""18904196"", ""317902092"", ""21786638"", ""33689392"", ""2818020373"", ""434872912"", ""26482400"", ""495422346"", ""207960838"", ""1158170036"", ""161611216"", ""101445204"", ""32444081"", ""2432870707"", ""233885425"", ""220197973"", ""2256809998"", ""83421448"", ""352560642"", ""529660770"", ""17664062"", ""264125211"", ""259207823"", ""548766000"", ""369816192"", ""575616768"", ""2459707910"", ""34002867"", ""96417553"", ""1040687791"", ""113028815"", ""176466856"", ""351675635"", ""87136959"", ""310265421"", ""67016448"", ""1013937854"", ""175232190"", ""325510698"", ""2302407630"", ""261409977"", ""2293159495"", ""2904297721"", ""1223768887"", ""41146136"", ""67353252"", ""431590274"", ""15740635"", ""735554419"", ""398263845"", ""276614225"", ""108075653"", ""2749029470"", ""113398005"", ""1234987687"", ""21642088"", ""260797558"", ""121794872"", ""2779940700"", ""91862493"", ""188411123"", ""503507177"", ""62046136"", ""1430803813"", ""18466590"", ""47424036"", ""617229652"", ""243232619"", ""296948666"", ""23231169"", ""21509847"", ""2534441287"", ""296858138"", ""2848043788"", ""378213175"", ""1333122608"", ""83665850"", ""948517734"", ""179837791"", ""63708761"", ""2647331531"", ""2329395194"", ""2753302078"", ""531755631"", ""274880541"", ""449281486"", ""105623738"", ""701833698"", ""549532026"", ""39960151"", ""595828202"", ""50823122"", ""2530450641"", ""36629451"", ""857775810"", ""328093424"", ""441214199"", ""52090691"", ""44191692"", ""52011684"", ""477820454"", ""457736552"", ""292194848"", ""88650307"", ""1410065744"", ""83599454"", ""203365139"", ""309655617"", ""701132841"", ""941878034"", ""53764530"", ""246293216"", ""537538085"", ""1421147582"", ""195059447"", ""1847114280"", ""2276576072"", ""90743337""]",32,6,38
2654320636,12,106.5,-0.18998109797636667,2178068.0,1,0.75,"[""charliehebdo-all-rnr-threads"", ""sydneysiege-all-rnr-threads""]","[""87416722""]",9,3,12
243232619,4,41.5,-0.5348435491323471,1970533.0,2,0.5,"[""charliehebdo-all-rnr-threads"", ""sydneysiege-all-rnr-threads""]","[""1161902875"", ""87416722""]",2,2,4
18845980,3,82.33333333333333,-0.831043561299642,8554515.0,3,0.3333333333333333,"[""charliehebdo-all-rnr-threads"", ""germanwings-crash-all-rnr-threads"", ""sydneysiege-all-rnr-threads""]","[""2280470022"", ""278067201"", ""87416722""]",1,2,3
1040687791,3,87.0,-0.19556361436843872,6784550.0,2,1.0,"[""charliehebdo-all-rnr-threads"", ""ottawashooting-all-rnr-threads""]","[""87416722"", ""5402612""]",3,0,3
7587032,89,129.47191011235958,-0.35445539335186566,13443820.0,950,0.5280898876404494,"[""charliehebdo-all-rnr-threads"", ""germanwings-crash-all-rnr-threads"", ""ottawashooting-all-rnr-threads"", ""sydneysiege-all-rnr-threads""]","[""213655226"", ""43863481"", ""203122412"", ""2753139956"", ""2305228178"", ""1471720957"", ""712887475"", ""2723676503"", ""393786263"", ""42498454"", ""1672970340"", ""237672903"", ""2938673260"", ""2799835019"", ""75977801"", ""595036225"", ""792856020"", ""24408882"", ""191723646"", ""49351684"", ""751363842"", ""2930298332"", ""900675710"", ""300234290"", ""2707815410"", ""25826256"", ""21901872"", ""132494834"", ""549688044"", ""1585970245"", ""2736026781"", ""147181485"", ""1447779020"", ""422062818"", ""546924455"", ""186167438"", ""1269616364"", ""2352647582"", ""112777979"", ""69643057"", ""173435768"", ""2900433696"", ""2837302235"", ""51849743"", ""19824644"", ""608990161"", ""707669335"", ""1474332679"", ""20819614"", ""397587164"", ""363661801"", ""2281433283"", ""2147835768"", ""1603077498"", ""598886559"", ""618227502"", ""2850609607"", ""48399136"", ""52915212"", ""2208746299"", ""36051110"", ""1101548340"", ""578221595"", ""147605712"", ""145946570"", ""103972238"", ""532299353"", ""2475652522"", ""1435418814"", ""2922757403"", ""435081194"", ""551234726"", ""1356415058"", ""288999355"", ""396021583"", ""216360237"", ""2408538376"", ""1633769822"", ""38635358"", ""53322615"", ""2152015562"", ""458768756"", ""1921089186"", ""2408509784"", ""19563004"", ""41379801"", ""2322687739"", ""2933943867"", ""281737861"", ""118261863"", ""169626752"", ""1600900638"", ""94365114"", ""21719375"", ""525641377"", ""2202558595"", ""27602314"", ""900691963"", ""738546480"", ""422552416"", ""288730262"", ""549344450"", ""572454746"", ""2547431512"", ""2732709982"", ""361247001"", ""144109245"", ""360283600"", ""868681170"", ""71545502"", ""379326514"", ""585772278"", ""2815093989"", ""19331152"", ""47067827"", ""2915597476"", ""2840119379"", ""1315370654"", ""192744648"", ""2958552807"", ""2760046609"", ""1678319448"", ""1874429234"", ""42829207"", ""160547588"", ""230553901"", ""43283737"", ""426537685"", ""573692319"", ""1976772002"", ""26785968"", ""733092889"", ""2374882148"", ""2569461165"", ""879038035"", ""2311818881"", ""1546021448"", ""2957540893"", ""25049396"", ""1615792554"", ""238749905"", ""2252485347"", ""39831495"", ""1058745000"", ""2231654796"", ""1429966902"", ""391318757"", ""2378065634"", ""1022865097"", ""470374459"", ""43851362"", ""2775150405"", ""2879414031"", ""28888756"", ""170762585"", ""2824552901"", ""1291930495"", ""95212557"", ""968020818"", ""1347116040"", ""466489364"", ""1427382770"", ""587412250"", ""113422955"", ""66103873"", ""15606755"", ""606653364"", ""26446539"", ""1604396971"", ""20427278"", ""1228556048"", ""394840322"", ""230967933"", ""109087837"", ""240219985"", ""563178382"", ""714420762"", ""20617408"", ""1857854515"", ""210774597"", ""604855824"", ""190218122"", ""19443081"", ""315326703"", ""2945871636"", ""101499891"", ""40614889"", ""358992193"", ""145456012"", ""193422307"", ""43953931"", ""453889433"", ""2191277311"", ""2794829648"", ""33827440"", ""2280470022"", ""2707571696"", ""214007688"", ""41623942"", ""1894275583"", ""2741866624"", ""2942267809"", ""1268120574"", ""108617893"", ""56650052"", ""390625296"", ""25047467"", ""47582275"", ""1262186544"", ""2396634450"", ""275553430"", ""2884577892"", ""35683492"", ""138713188"", ""2621261169"", ""1446864968"", ""997608943"", ""2817299007"", ""2668764799"", ""254507476"", ""260644597"", ""2262088470"", ""16727355"", ""2558972356"", ""635549765"", ""2193141103"", ""132676483"", ""734713182"", ""2856588296"", ""1183116912"", ""931746864"", ""413095393"", ""1911832471"", ""2544187700"", ""1685120202"", ""702077915"", ""449157548"", ""19614883"", ""1887260479"", ""1120005338"", ""443086827"", ""622210592"", ""199459019"", ""17436585"", ""44464005"", ""426916231"", ""18716042"", ""50014086"", ""245051131"", ""268722191"", ""147484686"", ""229891234"", ""806713213"", ""19149609"", ""1967132004"", ""157322283"", ""19177894"", ""457170115"", ""206596726"", ""1176480541"", ""207372536"", ""21175450"", ""301357413"", ""222796094"", ""1487419980"", ""2643935373"", ""2325485624"", ""2325285027"", ""86853453"", ""455724651"", ""72588786"", ""529583598"", ""1464687919"", ""2190060020"", ""153120929"", ""2883239325"", ""339718453"", ""2725416517"", ""358165338"", ""533270802"", ""2566535282"", ""1325117106"", ""367907778"", ""428391320"", ""35439079"", ""126621128"", ""2845970116"", ""1469280505"", ""1542767918"", ""1301499264"", ""1951309200"", ""2812004227"", ""2768771465"", ""729018318"", ""2183674353"", ""88505381"", ""20585360"", ""25407482"", ""266275672"", ""1956154830"", ""513175616"", ""2939872661"", ""20324285"", ""1959527118"", ""1851354788"", ""288298411"", ""98719957"", ""553013804"", ""1267085329"", ""290800404"", ""610194645"", ""23524864"", ""23476172"", ""313821261"", ""222562630"", ""20498025"", ""27222636"", ""252682590"", ""1506045206"", ""2206721762"", ""84429722"", ""2593197311"", ""1887799932"", ""32424872"", ""22921558"", ""797183347"", ""1578120853"", ""36096153"", ""62591883"", ""14183914"", ""2663218640"", ""1437948078"", ""19750998"", ""20902016"", ""33217936"", ""624557599"", ""2270384360"", ""2155595043"", ""1401723518"", ""354917016"", ""2391992534"", ""3088448937"", ""105599936"", ""1528559454"", ""2945009729"", ""2750908439"", ""2163490567"", ""220981466"", ""479259008"", ""2451649196"", ""204246297"", ""2886586060"", ""420445035"", ""494828633"", ""81025017"", ""197396710"", ""386169472"", ""43303611"", ""1636935235"", ""1032826321"", ""43759072"", ""564198569"", ""25958881"", ""185203533"", ""2811807426"", ""335788977"", ""1633311770"", ""20527694"", ""2841003016"", ""239853650"", ""165255622"", ""171360721"", ""62966062"", ""833819329"", ""284033773"", ""218104926"", ""2459714353"", ""2811450023"", ""633599209"", ""1966555952"", ""97519068"", ""2225289911"", ""997535641"", ""385088282"", ""181873706"", ""114853106"", ""140016557"", ""953169685"", ""2464502209"", ""489497300"", ""259813726"", ""1095967202"", ""325982055"", ""17400044"", ""765608984"", ""2765808926"", ""958317980"", ""2873512124"", ""21081411"", ""569592930"", ""225956216"", ""2907447939"", ""610028948"", ""44859449"", ""2561821225"", ""824250668"", ""117789874"", ""24283002"", ""2326869021"", ""402738328"", ""2319436008"", ""15486485"", ""441036257"", ""1021883684"", ""2407380144"", ""29442661"", ""2734350850"", ""2768705528"", ""304946185"", ""247679867"", ""1495284030"", ""2404671441"", ""2407248410"", ""2565682773"", ""150219628"", ""2938577656"", ""519740250"", ""52369289"", ""2416197957"", ""2221182175"", ""928940965"", ""39879845"", ""478034979"", ""2887763805"", ""94573305"", ""973822920"", ""612920099"", ""2195413480"", ""221544397"", ""386236013"", ""27632057"", ""1264660638"", ""358414075"", ""33951038"", ""2471529011"", ""213698858"", ""152891927"", ""525304762"", ""2771542204"", ""1927566248"", ""886911072"", ""361925737"", ""108459307"", ""71319477"", ""274161652"", ""142321213"", ""2806409452"", ""1827417535"", ""52413014"", ""174365756"", ""1667493679"", ""61731433"", ""312884233"", ""2467959607"", ""455636856"", ""70621811"", ""2288506714"", ""428930828"", ""594155937"", ""368041715"", ""70871976"", ""2485233738"", ""26748741"", ""2873772514"", ""163489910"", ""487054198"", ""2898190371"", ""2560935911"", ""2306816966"", ""544433101"", ""2749103731"", ""56645514"", ""22625357"", ""91528467"", ""34278773"", ""147202533"", ""1358618826"", ""262377489"", ""288967732"", ""606686901"", ""42400054"", ""2370914096"", ""2585884892"", ""14991954"", ""716785466"", ""2724407548"", ""78139544"", ""2346533108"", ""2210914145"", ""2722033756"", ""2669265942"", ""853276514"", ""152499321"", ""761638963"", ""449898604"", ""616111882"", ""1137320347"", ""303733375"", ""387523648"", ""79408564"", ""417877098"", ""1297338674"", ""249340848"", ""224775883"", ""2243504739"", ""463117507"", ""379672324"", ""391609366"", ""236446264"", ""27074991"", ""21052177"", ""30859403"", ""57023952"", ""19498310"", ""2950954733"", ""2378106931"", ""751562797"", ""213757408"", ""359015191"", ""1618526544"", ""365414075"", ""366999739"", ""858157333"", ""20676184"", ""861178922"", ""53668717"", ""923278088"", ""436029388"", ""188248678"", ""2397850208"", ""20308222"", ""229537740"", ""30657692"", ""315880426"", ""56688219"", ""1420534482"", ""143598168"", ""1324288885"", ""489906592"", ""2484423203"", ""610256326"", ""419403303"", ""66037316"", ""331632622"", ""2398403977"", ""186847460"", ""19157433"", ""245683175"", ""2435800394"", ""262329855"", ""113964688"", ""478402262"", ""473048213"", ""348584520"", ""1530746612"", ""2361318380"", ""1148205248"", ""21068048"", ""191074342"", ""1613521332"", ""900352195"", ""232805236"", ""1372692300"", ""1169619438"", ""82062775"", ""848351792"", ""17876008"", ""1633711352"", ""944949480"", ""846160506"", ""371295497"", ""86602719"", ""611516397"", ""2403111176"", ""2804531655"", ""71118174"", ""606532908"", ""18379848"", ""2560120714"", ""21579943"", ""594785442"", ""192181644"", ""49317619"", ""749000928"", ""2620056154"", ""2247428833"", ""2875706024"", ""872508648"", ""2237327754"", ""21355755"", ""2864140683"", ""157982561"", ""351156603"", ""2770600568"", ""1550164182"", ""2181425453"", ""593076631"", ""192359034"", ""730825878"", ""546475152"", ""2347869676"", ""1149038040"", ""20858066"", ""2496076532"", ""490433723"", ""2869304847"", ""520011678"", ""2817362840"", ""312996321"", ""109553437"", ""2598442396"", ""464134033"", ""2701606112"", ""1097602477"", ""23984185"", ""354793705"", ""2239469596"", ""2313361531"", ""49117684"", ""2918939051"", ""2701566703"", ""2878888883"", ""1106668680"", ""1180564789"", ""2241324176"", ""1655525964"", ""1450030952"", ""794921233"", ""68956490"", ""24639297"", ""18142861"", ""2495801377"", ""160653702"", ""299076079"", ""404095923"", ""138408070"", ""464830821"", ""92922700"", ""976596115"", ""604569449"", ""149050232"", ""70133596"", ""1473132685"", ""1964938920"", ""395264215"", ""325604362"", ""2370908751"", ""1184253228"", ""309075828"", ""2841491128"", ""2371695217"", ""376679692"", ""1093219254"", ""2173233478"", ""2190518857"", ""30458580"", ""2305290142"", ""26097979"", ""392739061"", ""296688908"", ""206118549"", ""2759522404"", ""270984369"", ""181109231"", ""568596507"", ""474174981"", ""1958563062"", ""131251989"", ""1204397358"", ""2903064759"", ""1853445666"", ""198123914"", ""260679517"", ""849008012"", ""84557057"", ""2901435751"", ""98635168"", ""36649116"", ""53741029"", ""2297320726"", ""21062446"", ""122294990"", ""238712201"", ""635190388"", ""41187181"", ""125344265"", ""247261209"", ""1516812560"", ""1949674452"", ""192039517"", ""211384657"", ""66758318"", ""21009701"", ""279483370"", ""494501255"", ""20034278"", ""364318005"", ""1653834024"", ""233688459"", ""282756639"", ""293110878"", ""1550984940"", ""148699617"", ""2363818055"", ""438601264"", ""198091495"", ""80240161"", ""280242927"", ""1893228739"", ""1201859449"", ""1586039095"", ""870691879"", ""57938385"", ""56160047"", ""84363987"", ""1111814293"", ""256546847"", ""2751165905"", ""3041579847"", ""2875644124"", ""590177097"", ""44864646"", ""35289638"", ""2235443075"", ""881582755"", ""1087142540"", ""476232425"", ""56734871"", ""500595457"", ""74824409"", ""38255197"", ""2945865278"", ""2737956670"", ""428149314"", ""514466260"", ""746980435"", ""2493987576"", ""1420213766"", ""2283483315"", ""2915138085"", ""481926126"", ""256456300"", ""218186492"", ""2420699738"", ""504958389"", ""60477982"", ""2718113595"", ""1145977771"", ""1348798826"", ""201479875"", ""2791981962"", ""237724213"", ""505918122"", ""2826262117"", ""6575472"", ""126987176"", ""2324261167"", ""2176959405"", ""702317425"", ""99790322"", ""1115498155"", ""987503203"", ""2647755663"", ""35338516"", ""1092400777"", ""119788492"", ""705665868"", ""1234987687"", ""57444129"", ""14964429"", ""371217924"", ""68128089"", ""35774997"", ""2717600311"", ""134240162"", ""54268327"", ""2459278543"", ""2779940700"", ""72833846"", ""27424922"", ""2316172820"", ""21181417"", ""91824582"", ""2743945505"", ""70650435"", ""397145467"", ""2919712403"", ""258106149"", ""304637914"", ""1129809848"", ""433150658"", ""91372324"", ""304281220"", ""2866426901"", ""558271681"", ""43513369"", ""297607906"", ""719862841"", ""794860933"", ""53135856"", ""23583472"", ""377170560"", ""377247309"", ""125454330"", ""67311089"", ""567643509"", ""2296133130"", ""149913262"", ""66133238"", ""567414819"", ""24859059"", ""224748430"", ""1331604092"", ""42046422"", ""2959967321"", ""296948666"", ""1724090454"", ""28813349"", ""413856809"", ""568564628"", ""178845084"", ""47642961"", ""1122694848"", ""438440486"", ""2534441287"", ""2248475133"", ""2727649149"", ""149286219"", ""343269643"", ""483989956"", ""2734300973"", ""204833735"", ""81169025"", ""217179750"", ""2848043788"", ""173844579"", ""447711346"", ""87762392"", ""227555454"", ""26308290"", ""1057370910"", ""948517734"", ""2950026934"", ""2846895994"", ""291561694"", ""105439246"", ""2688202392"", ""97646569"", ""2927507078"", ""2404923194"", ""558969189"", ""369181340"", ""983433582"", ""2602391361"", ""1262157433"", ""1347766734"", ""1574237179"", ""179294405"", ""1539580423"", ""1101212720"", ""1035136412"", ""608069196"", ""2916904681"", ""25644597"", ""633081670"", ""303896480"", ""54727574"", ""610143940"", ""1173408768"", ""578896287"", ""2752626905"", ""595158733"", ""529286343"", ""459983485"", ""498084828"", ""80280391"", ""298701234"", ""521469669"", ""264862915"", ""554553205"", ""339187164"", ""242389046"", ""2475634148"", ""2530450641"", ""300836889"", ""605824949"", ""906682020"", ""149100048"", ""820458320"", ""134595287"", ""2528078443"", ""19349456"", ""158523125"", ""134738729"", ""354668309"", ""797099875"", ""1072387866"", ""109030123"", ""191007877"", ""69251164"", ""2260562620"", ""23469560"", ""18863590"", ""2885348567"", ""580824264"", ""612618297"", ""135915194"", ""2432634950"", ""79802631"", ""268433270"", ""1381996868"", ""220951379"", ""125192586"", ""1670295002"", ""1475233393"", ""146753510"", ""866796758"", ""1062498002"", ""229547869"", ""941878034"", ""142668518"", ""110630248"", ""39780739"", ""2946309485"", ""36326275"", ""2611014717"", ""195059447"", ""2562641084"", ""538401540"", ""1704223766"", ""19238906"", ""1895366173"", ""204043844"", ""2949326851"", ""190751640"", ""91097228"", ""371455679"", ""759592362"", ""74924830"", ""70559981""]",47,42,89
2311818881,3,33.666666666666664,-0.0625650684038798,2018088.0,2,1.0,"[""charliehebdo-all-rnr-threads"", ""sydneysiege-all-rnr-threads""]","[""38142380"", ""7587032""]",3,0,3
881582755,16,124.8125,-0.37050636857748037,2173145.0,5,0.0625,"[""charliehebdo-all-rnr-threads"", ""sydneysiege-all-rnr-threads""]","[""7587032"", ""171953871"", ""31135856"", ""16305558"", ""1920286333""]",1,15,16
224775883,2,94.5,-0.2590023875236511,2021728.0,2,1.0,"[""charliehebdo-all-rnr-threads"", ""sydneysiege-all-rnr-threads""]","[""292777349"", ""7587032""]",2,0,2
6591312,3,123.0,-0.7264959017435709,6564462.0,32,1.0,"[""charliehebdo-all-rnr-threads"", ""germanwings-crash-all-rnr-threads""]","[""14013202"", ""22441656"", ""407779393"", ""336118461"", ""1569448915"", ""16330790"", ""211757224"", ""2459278543"", ""264882189"", ""582523469"", ""2378914268"", ""19392326"", ""177830416"", ""909990571"", ""501824127"", ""47694347"", ""2513308740"", ""337164050"", ""1566093012"", ""1618325365"", ""2799588421"", ""5967972"", ""220347418"", ""1582265598"", ""142088047"", ""225970425"", ""57081338"", ""16461724"", ""109982213"", ""106376530"", ""140749707"", ""258730076""]",3,0,3
1569448915,6,69.5,-0.0696726143360138,18605846.0,5,0.5,"[""charliehebdo-all-rnr-threads"", ""putinmissing-all-rnr-threads"", ""ottawashooting-all-rnr-threads"", ""ferguson-all-rnr-threads""]","[""24630719"", ""36309919"", ""14090948"", ""6591312"", ""16343974""]",3,3,6
225970425,4,133.5,-0.23389892280101776,2023591.0,4,0.5,"[""charliehebdo-all-rnr-threads"", ""sydneysiege-all-rnr-threads""]","[""6591312"", ""1532402708"", ""14700117"", ""2378713202""]",2,2,4
2378914268,15,100.53333333333333,-0.24782222112019855,6719825.0,11,0.26666666666666666,"[""charliehebdo-all-rnr-threads"", ""ottawashooting-all-rnr-threads"", ""sydneysiege-all-rnr-threads""]","[""1359226843"", ""427515851"", ""46078438"", ""17537467"", ""15384969"", ""14511951"", ""417419122"", ""153029181"", ""6591312"", ""605283640"", ""374712154""]",4,11,15
16973333,78,123.37179487179488,-0.23879666358996657,13444369.0,783,0.2692307692307692,"[""charliehebdo-all-rnr-threads"", ""germanwings-crash-all-rnr-threads"", ""ottawashooting-all-rnr-threads"", ""sydneysiege-all-rnr-threads""]","[""100882501"", ""18770158"", ""14176603"", ""622787201"", ""22369295"", ""2793506633"", ""15209730"", ""2932319783"", ""2887851225"", ""264103932"", ""372285707"", ""236537745"", ""1639471315"", ""113206743"", ""1503342588"", ""203442882"", ""26205596"", ""337777764"", ""705123059"", ""2668571772"", ""565059002"", ""601365653"", ""132494834"", ""2827604185"", ""868371006"", ""1585970245"", ""137124849"", ""56666374"", ""136053941"", ""456583666"", ""527882595"", ""577081736"", ""542168853"", ""1693249255"", ""3080919807"", ""26223216"", ""20488488"", ""2219393934"", ""416191861"", ""2502534685"", ""2584543170"", ""267906861"", ""16574787"", ""2370091944"", ""951430134"", ""19559028"", ""424843364"", ""62532011"", ""2865404526"", ""754701355"", ""627243009"", ""173454905"", ""475736463"", ""20064015"", ""449472564"", ""98782570"", ""104863726"", ""20994010"", ""1944541152"", ""2739380114"", ""2493421416"", ""15714573"", ""295720763"", ""2663033660"", ""326360024"", ""60766201"", ""2933943867"", ""953315940"", ""88963598"", ""68398170"", ""1475561804"", ""24259655"", ""100205953"", ""496651076"", ""2584501496"", ""2887597602"", ""1386263192"", ""879978907"", ""563147998"", ""561310857"", ""128327004"", ""1376963456"", ""2815093989"", ""486632518"", ""303937008"", ""2909686726"", ""2786921609"", ""33478717"", ""1198710258"", ""2922814893"", ""8423622"", ""222546638"", ""2723985351"", ""1268353729"", ""2153404664"", ""26210477"", ""29986370"", ""2153807785"", ""865430124"", ""2756953204"", ""2704810752"", ""2288530875"", ""64430687"", ""257395153"", ""1734835350"", ""408564763"", ""147546061"", ""2626274968"", ""2792832576"", ""1417678760"", ""57094606"", ""2873549954"", ""1445859979"", ""18334049"", ""22403315"", ""469845522"", ""73416159"", ""1110190452"", ""27413161"", ""38133247"", ""17665641"", ""487952954"", ""2217956377"", ""2189084134"", ""116186330"", ""578937930"", ""2826624542"", ""54882415"", ""2365868554"", ""38692829"", ""60967581"", ""2401371607"", ""203862227"", ""283582930"", ""284955277"", ""211210976"", ""353479913"", ""604855824"", ""1354084202"", ""195368024"", ""2391287540"", ""845757049"", ""321402315"", ""256358298"", ""1118669732"", ""309550090"", ""123217844"", ""60923866"", ""92072090"", ""731478738"", ""448605844"", ""1596359430"", ""81304470"", ""106116797"", ""45827883"", ""15783997"", ""712205318"", ""787082544"", ""1020681224"", ""235520398"", ""207175934"", ""2800990939"", ""48684811"", ""42438301"", ""401230764"", ""580676113"", ""51975278"", ""352220792"", ""127220658"", ""23355252"", ""74262274"", ""198827022"", ""1889171928"", ""1528260655"", ""14183379"", ""121257658"", ""2309415634"", ""2612603865"", ""360018604"", ""49425223"", ""18745886"", ""21055097"", ""1911832471"", ""131607173"", ""561655209"", ""523741822"", ""396605502"", ""108368459"", ""466228100"", ""2193206563"", ""258596053"", ""2924747729"", ""44464005"", ""2807499635"", ""224295570"", ""1652614104"", ""174950408"", ""2856401319"", ""152318420"", ""2654308451"", ""364263893"", ""54489465"", ""21862462"", ""2534846484"", ""505778824"", ""1119305256"", ""28393138"", ""1123095367"", ""13222472"", ""2582320573"", ""36193886"", ""2383970420"", ""382471208"", ""358346497"", ""245347553"", ""2785513130"", ""795927228"", ""46611379"", ""72588786"", ""2464329458"", ""244396093"", ""43532617"", ""24403686"", ""541479517"", ""1548701510"", ""143914927"", ""32612452"", ""2193176855"", ""137763513"", ""204844864"", ""51043990"", ""2862600845"", ""631186634"", ""433183070"", ""351739907"", ""1059686779"", ""160450335"", ""2723262499"", ""104495655"", ""140467741"", ""2935809620"", ""2806280001"", ""2782303899"", ""426013492"", ""2406528461"", ""481215865"", ""418731150"", ""995367439"", ""2223314346"", ""1271901084"", ""1874825863"", ""53013955"", ""27859283"", ""553928442"", ""1063642980"", ""351928139"", ""2871280115"", ""52520519"", ""24500736"", ""2384105730"", ""2429521228"", ""1116612139"", ""635756247"", ""1854687270"", ""364941973"", ""114113009"", ""456505414"", ""48304732"", ""332795738"", ""1897951344"", ""259928379"", ""1337986381"", ""322378843"", ""53502436"", ""248784419"", ""2402466856"", ""799691582"", ""308373336"", ""55646388"", ""65581806"", ""124819189"", ""2886586060"", ""66920357"", ""63930141"", ""204265458"", ""21722790"", ""47987456"", ""315244740"", ""2164978852"", ""374577469"", ""463227494"", ""210235966"", ""19860629"", ""811523612"", ""2964610828"", ""307054184"", ""1626325842"", ""21649562"", ""550436298"", ""959403319"", ""1146629010"", ""16474992"", ""2990802156"", ""2596835575"", ""953169685"", ""1355123996"", ""623831289"", ""2464502209"", ""346937412"", ""2324410026"", ""128917051"", ""165109443"", ""2766218625"", ""16293469"", ""111707613"", ""489825874"", ""342688405"", ""191884380"", ""183960617"", ""228295911"", ""423866693"", ""46505504"", ""2907401280"", ""9709412"", ""229431399"", ""98350238"", ""396681390"", ""158900511"", ""250025394"", ""246217949"", ""272893755"", ""42321389"", ""133275441"", ""118850495"", ""1181486587"", ""75109799"", ""122475762"", ""353147411"", ""3042574384"", ""136089885"", ""1345045837"", ""1600662793"", ""2715055025"", ""1012735345"", ""152891927"", ""43531759"", ""567039350"", ""186047604"", ""224494638"", ""19792878"", ""2771542204"", ""1381794456"", ""2780648743"", ""21574458"", ""31789939"", ""602235769"", ""258003948"", ""168235468"", ""20361510"", ""110280728"", ""236684588"", ""204376428"", ""2817435066"", ""1597836632"", ""374211739"", ""1333033202"", ""2915986449"", ""2706148363"", ""334212755"", ""27447436"", ""2850717933"", ""618811816"", ""145035335"", ""379823944"", ""1885109588"", ""91800790"", ""2849029587"", ""484962664"", ""46532482"", ""73043514"", ""2279657306"", ""1421239776"", ""27221221"", ""2525932772"", ""518172448"", ""2406050977"", ""77195448"", ""18142983"", ""2966346232"", ""54882986"", ""415620907"", ""21389327"", ""45851324"", ""83678700"", ""339603169"", ""20165699"", ""38859818"", ""1719561684"", ""2967281807"", ""2685086010"", ""394059966"", ""558164020"", ""1329199266"", ""2871588796"", ""1688194142"", ""24621292"", ""2268073886"", ""2426247668"", ""711329731"", ""273950218"", ""2580777979"", ""15721747"", ""58419534"", ""593253537"", ""387675300"", ""838881872"", ""156135746"", ""500052743"", ""714817772"", ""2743947822"", ""443899044"", ""1905318102"", ""2274722621"", ""2939440823"", ""213757408"", ""2734291692"", ""96648562"", ""2177175701"", ""8598692"", ""1424029057"", ""2657669424"", ""532255850"", ""2915714339"", ""249166005"", ""79939817"", ""2903328589"", ""43290136"", ""1118914326"", ""45099091"", ""290292870"", ""2313204826"", ""1572817922"", ""1104722846"", ""1326677923"", ""2739241927"", ""625716485"", ""35948102"", ""1022707310"", ""18046092"", ""380848493"", ""573550199"", ""222189121"", ""398484815"", ""380347990"", ""24655343"", ""294029717"", ""2813610969"", ""2636328522"", ""213223080"", ""895709839"", ""510996222"", ""2343312707"", ""378050142"", ""2906635462"", ""1084438494"", ""1332623515"", ""186822322"", ""180707499"", ""1633645357"", ""298152761"", ""17876008"", ""2848441612"", ""15777813"", ""61965562"", ""338520198"", ""27855027"", ""1642566085"", ""405194953"", ""76009410"", ""1650202562"", ""313301124"", ""1541366612"", ""59054994"", ""195383427"", ""587391384"", ""2288286954"", ""1528701288"", ""2449093162"", ""1651027262"", ""223625592"", ""75988484"", ""1373597017"", ""2448215593"", ""399480655"", ""5793562"", ""446409001"", ""872917746"", ""567480203"", ""29177184"", ""633263251"", ""2878172763"", ""1277113134"", ""275732229"", ""1180564789"", ""2486147647"", ""279925324"", ""19442509"", ""336755015"", ""160187124"", ""17473505"", ""14591467"", ""2773566528"", ""18832320"", ""546381549"", ""261041421"", ""162629067"", ""2634736558"", ""734305040"", ""994468279"", ""501648934"", ""2370908751"", ""2841491128"", ""376679692"", ""296233696"", ""33763482"", ""2569761853"", ""100912673"", ""748693008"", ""17652921"", ""272013503"", ""184517401"", ""82565659"", ""2859996381"", ""16945537"", ""552147240"", ""242013838"", ""2148809806"", ""2229718093"", ""350067280"", ""223234584"", ""20360717"", ""131151891"", ""362616512"", ""433366025"", ""218533424"", ""258485414"", ""1676198762"", ""393281467"", ""1444585286"", ""253471213"", ""2718811747"", ""2443844124"", ""165382248"", ""57592238"", ""2155353372"", ""98101047"", ""62043694"", ""737555773"", ""11688082"", ""289414660"", ""2951968857"", ""2396005776"", ""418217963"", ""2684760270"", ""2365682870"", ""445357890"", ""442548468"", ""363821385"", ""230045723"", ""196695518"", ""1014842906"", ""53479508"", ""2842660390"", ""347358838"", ""85333224"", ""376652613"", ""2573360142"", ""1327643474"", ""2400003328"", ""1080276308"", ""2241111392"", ""2474889544"", ""20233838"", ""2189523500"", ""134364455"", ""1493793625"", ""438235670"", ""86459786"", ""1050455592"", ""30435855"", ""114962484"", ""2898115168"", ""919389188"", ""147634420"", ""2945865278"", ""34375766"", ""398416621"", ""2899924184"", ""149893927"", ""2731571574"", ""2815827712"", ""161616878"", ""14194726"", ""2419629020"", ""68919090"", ""20883153"", ""279288717"", ""8863322"", ""400683845"", ""302880448"", ""7840452"", ""1678093298"", ""209771034"", ""2257552586"", ""27619454"", ""1348798826"", ""438168562"", ""34589188"", ""2599997960"", ""21546203"", ""444459896"", ""254691950"", ""192486342"", ""570307870"", ""212924513"", ""536683652"", ""17951262"", ""2800512436"", ""1445819197"", ""1316823470"", ""1037326434"", ""568119166"", ""755388331"", ""403504067"", ""1202152410"", ""1234987687"", ""182298599"", ""129597517"", ""469180343"", ""1668697268"", ""21527503"", ""2559887646"", ""2342981651"", ""8528342"", ""2396475041"", ""2459278543"", ""1347193062"", ""1129129021"", ""25472797"", ""177160564"", ""18286682"", ""1966608271"", ""157780872"", ""200700159"", ""21176836"", ""70650435"", ""1865494322"", ""190558607"", ""408742444"", ""2529686724"", ""2509208545"", ""2891831385"", ""584977551"", ""2405664311"", ""1903257068"", ""39174667"", ""631107358"", ""44449632"", ""420223654"", ""93476665"", ""229110952"", ""429873593"", ""46100172"", ""2394781032"", ""26849753"", ""2670826476"", ""136746401"", ""1543095236"", ""466460907"", ""66284799"", ""2173671946"", ""579725302"", ""130539641"", ""33610882"", ""2248475133"", ""1610238266"", ""901448065"", ""295826471"", ""246471208"", ""366806573"", ""53363343"", ""2880182432"", ""221210505"", ""310724538"", ""546311167"", ""1664844716"", ""19608718"", ""147823431"", ""549186500"", ""97863902"", ""277747585"", ""2393507977"", ""1425647202"", ""346186868"", ""1382894354"", ""752726084"", ""3023037872"", ""2844361126"", ""518697925"", ""1489892526"", ""264210776"", ""23490130"", ""151435231"", ""42900765"", ""426561297"", ""399593257"", ""2497032703"", ""2711297047"", ""593715286"", ""193071149"", ""27355937"", ""129024290"", ""59066615"", ""366100285"", ""248792277"", ""341417046"", ""2828909245"", ""891458323"", ""1477064977"", ""337916417"", ""902554447"", ""221753246"", ""19045104"", ""1459802210"", ""89265314"", ""2349064556"", ""259619085"", ""2245399752"", ""11545812"", ""239466907"", ""45161114"", ""1551994398"", ""531859781"", ""376589457"", ""136398254"", ""1159834147"", ""2873027869"", ""720928663"", ""427230369"", ""394572841"", ""21076793"", ""866536687"", ""1596598591"", ""576627484"", ""1093195092"", ""77325070"", ""2864066428"", ""2540317524"", ""127496158"", ""54484871"", ""1052816738"", ""2800401174"", ""1670295002"", ""296308749"", ""2163314342"", ""1621791"", ""2357670932"", ""2271943451"", ""2966544387"", ""1914421867"", ""37684026"", ""528004561"", ""1314652826"", ""29511068"", ""1916513502"", ""384502861"", ""1145792010"", ""349169217"", ""43873328"", ""1978253712"", ""258730076"", ""378144306"", ""136754171""]",21,57,78
1610238266,3,130.0,-0.6013408303260803,2029789.0,2,1.0,"[""charliehebdo-all-rnr-threads"", ""sydneysiege-all-rnr-threads""]","[""1020058453"", ""16973333""]",3,0,3
148653311,6,129.66666666666666,-0.34995250900586444,6623347.0,81,0.5,"[""charliehebdo-all-rnr-threads"", ""ottawashooting-all-rnr-threads""]","[""1339638134"", ""79593384"", ""112680705"", ""955970244"", ""322774956"", ""2402692262"", ""455653727"", ""569898594"", ""379672324"", ""185192570"", ""35761322"", ""2651737706"", ""501174288"", ""2393167764"", ""27273742"", ""2209994712"", ""41277688"", ""1301364216"", ""351889336"", ""2371293119"", ""260564418"", ""101589791"", ""2847661133"", ""1387105728"", ""560501622"", ""43089397"", ""66897225"", ""448457262"", ""2269093039"", ""313542861"", ""21424262"", ""31042573"", ""446514380"", ""1463721109"", ""548473375"", ""90888044"", ""132577759"", ""2312483851"", ""125454330"", ""567643509"", ""824915659"", ""86785588"", ""2531741394"", ""295903525"", ""410202830"", ""2662813495"", ""27366826"", ""495888667"", ""250257768"", ""1053543126"", ""1602224485"", ""2537023472"", ""17565364"", ""218468492"", ""14544703"", ""462304626"", ""602274330"", ""2306913865"", ""16822707"", ""51310666"", ""41300398"", ""17896573"", ""55577298"", ""1094009750"", ""15427912"", ""2710487168"", ""2346957501"", ""252089852"", ""93657860"", ""2417708630"", ""281942499"", ""35711113"", ""138142342"", ""1225414310"", ""2672630702"", ""434609176"", ""2499739573"", ""22298246"", ""1045042717"", ""21557584"", ""15896379""]",3,3,6
125454330,2,51.0,-0.6716417074203491,6568404.0,2,1.0,"[""charliehebdo-all-rnr-threads"", ""germanwings-crash-all-rnr-threads""]","[""148653311"", ""7587032""]",2,0,2
6017542,40,128.72499999999997,-0.4412949860095977,13213643.0,281,0.7,"[""charliehebdo-all-rnr-threads"", ""germanwings-crash-all-rnr-threads"", ""ottawashooting-all-rnr-threads"", ""sydneysiege-all-rnr-threads""]","[""2685015253"", ""239747685"", ""773001488"", ""216898338"", ""2842765578"", ""258897214"", ""838811618"", ""28352458"", ""487286986"", ""26901161"", ""81260589"", ""2573035633"", ""26133679"", ""41851861"", ""102055261"", ""2921881022"", ""29941292"", ""2942292673"", ""2496449354"", ""89959371"", ""36716860"", ""17936432"", ""46841171"", ""26614727"", ""1254746366"", ""24122822"", ""18142983"", ""301357413"", ""40869489"", ""244850695"", ""22444475"", ""628038157"", ""447767702"", ""241837896"", ""153320499"", ""47746339"", ""302321658"", ""524230125"", ""1058370912"", ""110811339"", ""42178519"", ""863454194"", ""132494834"", ""481295316"", ""46322647"", ""49259564"", ""263259572"", ""1567694065"", ""36033359"", ""30396416"", ""2820031272"", ""13854412"", ""168468750"", ""325823732"", ""2360552568"", ""220658283"", ""360855272"", ""335218024"", ""1085149063"", ""2220406891"", ""65655621"", ""80240975"", ""280777600"", ""47049617"", ""262293426"", ""384593182"", ""266657802"", ""433223861"", ""25505101"", ""267906861"", ""1364847644"", ""242136633"", ""75854948"", ""796606375"", ""95293056"", ""21267005"", ""409275587"", ""17325647"", ""250761217"", ""3028620082"", ""2883972239"", ""172584839"", ""2207114184"", ""44942611"", ""88268871"", ""160300478"", ""352517611"", ""204459963"", ""102142168"", ""23513005"", ""220921868"", ""2459278543"", ""464840550"", ""27450763"", ""285048452"", ""103923392"", ""19455392"", ""2571833844"", ""42388054"", ""193585297"", ""2933943867"", ""476089983"", ""1403764388"", ""570012819"", ""2230651269"", ""237970936"", ""26015734"", ""183419986"", ""25888359"", ""271202735"", ""222013657"", ""126800237"", ""2382973171"", ""283776030"", ""929662333"", ""1183126435"", ""354917016"", ""9924642"", ""628407933"", ""2828120210"", ""806652920"", ""2878373798"", ""1025481421"", ""961485776"", ""23278101"", ""1005257844"", ""263465449"", ""134411522"", ""2178953859"", ""167780925"", ""2455993906"", ""60091786"", ""358150055"", ""366925211"", ""185008554"", ""2549934751"", ""2925362938"", ""274609320"", ""102547354"", ""242900070"", ""93505049"", ""2857714525"", ""2919058680"", ""223989368"", ""48336972"", ""24990868"", ""517794513"", ""302071994"", ""22202896"", ""377107762"", ""244134922"", ""2294725468"", ""176853382"", ""228491611"", ""610840041"", ""18927670"", ""2468384811"", ""1136640559"", ""1696846248"", ""2857575721"", ""352396831"", ""54291352"", ""232565693"", ""24317650"", ""2238718954"", ""2429548903"", ""315794586"", ""129691306"", ""27768732"", ""2818076829"", ""23079877"", ""2168956690"", ""2273282888"", ""2433924142"", ""2358526862"", ""344489688"", ""281773824"", ""171143543"", ""117802791"", ""2195116544"", ""15173159"", ""34881422"", ""193103129"", ""252204575"", ""340699153"", ""1336642830"", ""867163658"", ""25235198"", ""2753258517"", ""23655847"", ""436543207"", ""148516959"", ""233632255"", ""47573748"", ""562486448"", ""595158733"", ""9815412"", ""22918923"", ""21202566"", ""25468212"", ""848295019"", ""402738328"", ""70327041"", ""444255250"", ""2851170553"", ""374357782"", ""867336522"", ""19900434"", ""440073533"", ""29995100"", ""2370908751"", ""342525301"", ""1485192062"", ""2457063384"", ""2418639158"", ""22204217"", ""434181425"", ""86026819"", ""2877730245"", ""1677842870"", ""729846000"", ""2873613330"", ""283665372"", ""1240056830"", ""313094231"", ""2687181098"", ""300274425"", ""2377178491"", ""1386146952"", ""69190453"", ""936248274"", ""34217911"", ""61292472"", ""2350717406"", ""1164203605"", ""22342990"", ""26200286"", ""2331161887"", ""93132953"", ""2496329197"", ""2924117172"", ""2558058282"", ""2437087002"", ""467394861"", ""171370131"", ""1508249221"", ""102753391"", ""33936084"", ""589718517"", ""86376511"", ""2806472778"", ""48155944"", ""617434038"", ""15448383"", ""257246987"", ""542813993"", ""551519702"", ""2803007648"", ""17273892"", ""3029778698"", ""23524389"", ""774185456"", ""1074987822"", ""164604959"", ""50901303"", ""39909279"", ""1041049706"", ""409600225"", ""17679507"", ""21057124"", ""154502755"", ""2923834516"", ""286947618"", ""204310108"", ""53041072"", ""102818456"", ""18135036"", ""2358039120"", ""157560762"", ""258730076"", ""5026991""]",28,12,40
20639175,20,118.4,-0.35699006617069245,19289011.0,80,0.75,"[""charliehebdo-all-rnr-threads"", ""germanwings-crash-all-rnr-threads"", ""sydneysiege-all-rnr-threads"", ""ottawashooting-all-rnr-threads"", ""ferguson-all-rnr-threads""]","[""608804472"", ""94600148"", ""20639175"", ""2840136808"", ""2562053132"", ""2512932974"", ""57409844"", ""269112578"", ""14349870"", ""531897219"", ""2478060493"", ""874734408"", ""232358211"", ""375721095"", ""782925072"", ""2448677148"", ""2561008639"", ""32583066"", ""22819351"", ""370702394"", ""538711270"", ""147910192"", ""219815274"", ""166967730"", ""234469670"", ""2515181563"", ""19417982"", ""2608761522"", ""2311197780"", ""383506589"", ""2836917903"", ""16866880"", ""505549131"", ""29165126"", ""142552360"", ""1536019639"", ""15817213"", ""135370173"", ""287516609"", ""1884588199"", ""69948337"", ""215424647"", ""433344503"", ""2700128671"", ""2884710657"", ""174050336"", ""48278272"", ""257663805"", ""2273282888"", ""18535252"", ""18983429"", ""318443441"", ""1475898865"", ""723090685"", ""1498224577"", ""329454031"", ""126732937"", ""147438072"", ""159939228"", ""1634512056"", ""15082945"", ""2416084189"", ""3968"", ""254536058"", ""5402612"", ""17879224"", ""1511137568"", ""56881051"", ""569900167"", ""2342154031"", ""2206788811"", ""20281336"", ""107794362"", ""2886703624"", ""22095149"", ""95108733"", ""2490694031"", ""398464203"", ""7838552"", ""191770625""]",15,5,20
2478060493,5,76.6,-0.16034379005432128,2194404.0,5,0.2,"[""charliehebdo-all-rnr-threads"", ""sydneysiege-all-rnr-threads""]","[""20639175"", ""334715818"", ""18018877"", ""499696436"", ""260661314""]",1,4,5
367709007,3,118.33333333333333,-0.31007277965545654,4119762.0,17,0.3333333333333333,"[""charliehebdo-all-rnr-threads"", ""gurlitt-all-rnr-threads""]","[""2909294196"", ""221783224"", ""372753711"", ""945524334"", ""93002286"", ""315185209"", ""550854560"", ""1162651273"", ""18200615"", ""588149845"", ""361135947"", ""457276178"", ""2384915342"", ""337948866"", ""2209535899"", ""950722801"", ""1030493862""]",1,2,3
2909294196,12,87.16666666666667,-0.34738272925217945,2033479.0,9,0.5,"[""charliehebdo-all-rnr-threads"", ""sydneysiege-all-rnr-threads""]","[""16671007"", ""532779460"", ""351120282"", ""597251143"", ""9609632"", ""17984709"", ""367709007"", ""431969214"", ""322572436""]",6,6,12
2384915342,7,116.42857142857143,0.16829499176570348,2041947.0,7,0.2857142857142857,"[""charliehebdo-all-rnr-threads"", ""sydneysiege-all-rnr-threads""]","[""14098166"", ""5402612"", ""224682566"", ""367709007"", ""16675569"", ""786764"", ""428333""]",2,5,7
1367531,48,112.52083333333333,-0.4682572695116202,19282118.0,619,0.625,"[""charliehebdo-all-rnr-threads"", ""germanwings-crash-all-rnr-threads"", ""sydneysiege-all-rnr-threads"", ""ottawashooting-all-rnr-threads"", ""ferguson-all-rnr-threads""]","[""555906005"", ""333631424"", ""2982327641"", ""59511805"", ""2444262739"", ""2572500237"", ""1369778664"", ""2548547708"", ""89787904"", ""785617561"", ""154138113"", ""2932876156"", ""853246909"", ""593685906"", ""1334108503"", ""16267083"", ""79284431"", ""606573794"", ""912271266"", ""450991824"", ""2688880416"", ""2771974062"", ""2523783230"", ""20868628"", ""1892037781"", ""2830421171"", ""740010326"", ""2961516138"", ""259064870"", ""140044212"", ""22438286"", ""454916835"", ""36738874"", ""181057672"", ""187579804"", ""30786441"", ""1066464163"", ""2264503075"", ""232367421"", ""103972238"", ""3091377492"", ""208072082"", ""1324830925"", ""31750214"", ""65525247"", ""872061751"", ""585310614"", ""272949457"", ""2904599122"", ""758132576"", ""311399175"", ""18573961"", ""2584501496"", ""275831401"", ""929662333"", ""19983237"", ""478137343"", ""2907408885"", ""116205535"", ""21622781"", ""2731852156"", ""609351362"", ""64704431"", ""16321657"", ""518671857"", ""103101818"", ""431282205"", ""2922814893"", ""220217402"", ""1296110076"", ""542047708"", ""573692319"", ""428558750"", ""2878538431"", ""2854117936"", ""1332873901"", ""168223059"", ""66233923"", ""242506573"", ""499819476"", ""352214678"", ""2342489587"", ""229295126"", ""1930943850"", ""1776800904"", ""1378267670"", ""135376922"", ""14709531"", ""110611375"", ""2525488348"", ""72613897"", ""978283423"", ""103999662"", ""117222719"", ""379889572"", ""2887986123"", ""1273480106"", ""309119396"", ""255062000"", ""148291255"", ""1041093895"", ""2686109520"", ""25039517"", ""28837157"", ""21009409"", ""2913701404"", ""2436384176"", ""1462419804"", ""540083657"", ""1610215518"", ""999907196"", ""153876973"", ""567360834"", ""803405311"", ""2515006951"", ""2889833692"", ""302425104"", ""120493964"", ""54017531"", ""274505708"", ""75491056"", ""2743208849"", ""259583691"", ""930216948"", ""321402315"", ""287371352"", ""329702630"", ""22273502"", ""50526034"", ""101556961"", ""1578514610"", ""285622629"", ""41623942"", ""2706645518"", ""1051654645"", ""886032552"", ""247138504"", ""2868807506"", ""102753391"", ""2373376284"", ""521476842"", ""352496440"", ""1199105660"", ""2817299007"", ""360842913"", ""2403400711"", ""1247754552"", ""1355670361"", ""2250820010"", ""19877207"", ""475456375"", ""457481692"", ""1912053961"", ""16320885"", ""54306177"", ""1146806390"", ""447290500"", ""146958450"", ""26001065"", ""2785975828"", ""1482440491"", ""2473219639"", ""1482457993"", ""2270300742"", ""221046735"", ""1969722380"", ""1017134550"", ""491817984"", ""2833265281"", ""2191889226"", ""2601685062"", ""79917675"", ""815557454"", ""59696953"", ""505778824"", ""746919546"", ""2895289449"", ""1487419980"", ""20514637"", ""33273895"", ""2954820721"", ""981120547"", ""424003023"", ""59890670"", ""2916544419"", ""70840791"", ""260491149"", ""912911725"", ""39408066"", ""424455969"", ""542754811"", ""1091099017"", ""2886733472"", ""2684118603"", ""43065163"", ""35874573"", ""310973713"", ""243457746"", ""2869411497"", ""356864823"", ""27859283"", ""362481555"", ""294450894"", ""551580888"", ""342296046"", ""1399838677"", ""2544931616"", ""1325358739"", ""102091700"", ""2176274673"", ""2675055421"", ""93013695"", ""84429722"", ""405036807"", ""2851551783"", ""2766929145"", ""329234762"", ""474738230"", ""213530957"", ""1891353350"", ""1064124998"", ""903143731"", ""62591883"", ""403212047"", ""19750998"", ""2189248559"", ""324035512"", ""469024509"", ""2694450841"", ""2602664509"", ""207368777"", ""437704468"", ""44272969"", ""89190254"", ""251513781"", ""313427517"", ""1345396363"", ""61011529"", ""2367650918"", ""2851263210"", ""1348029342"", ""75896584"", ""45177143"", ""2654195378"", ""963544670"", ""2865107214"", ""23345913"", ""2427575526"", ""1513807932"", ""26655737"", ""583792055"", ""1949150929"", ""69032114"", ""1429565516"", ""428936612"", ""253034379"", ""1345498502"", ""91597186"", ""489497300"", ""67623033"", ""2804183066"", ""1216469426"", ""571419153"", ""1503872983"", ""373341375"", ""2671784430"", ""334290988"", ""2895624665"", ""234814707"", ""2734020596"", ""330015109"", ""24728591"", ""339267365"", ""2878381248"", ""2734350850"", ""2768705528"", ""16023784"", ""272027429"", ""112344261"", ""2330901798"", ""2213473914"", ""321750373"", ""2486160777"", ""484514913"", ""421677297"", ""48906174"", ""2552698171"", ""35743866"", ""239065112"", ""295058041"", ""2568107372"", ""169609704"", ""719472690"", ""25582157"", ""35759628"", ""2322798020"", ""2799847634"", ""183350111"", ""2967781022"", ""2851634685"", ""2448407404"", ""17094323"", ""540478799"", ""1498965000"", ""24786780"", ""180853802"", ""288461917"", ""76570498"", ""23519206"", ""85393216"", ""2864854481"", ""2954480851"", ""331986205"", ""23823428"", ""179579790"", ""605151082"", ""2898190371"", ""275865954"", ""193048446"", ""924584022"", ""2247959851"", ""1857982483"", ""2898669987"", ""427688288"", ""2535168234"", ""2961649574"", ""107031620"", ""62268351"", ""2573466151"", ""20686232"", ""2361372481"", ""604683985"", ""1193374880"", ""2215260181"", ""2755858024"", ""1365192943"", ""2444514337"", ""2716582503"", ""363808138"", ""412870436"", ""22055226"", ""1862612232"", ""846344521"", ""1969009903"", ""1621733996"", ""2791444802"", ""78898625"", ""558164020"", ""167512844"", ""71451636"", ""911413658"", ""233522189"", ""563740777"", ""529642241"", ""553010243"", ""2995328595"", ""1078069398"", ""40813213"", ""1931848874"", ""2763083529"", ""1879595107"", ""34126592"", ""1098815064"", ""1503164911"", ""359015191"", ""220997167"", ""1350989725"", ""2903328589"", ""500410336"", ""566973108"", ""2864052523"", ""351219719"", ""70918726"", ""2940041869"", ""1726476212"", ""2540416722"", ""375795665"", ""462569930"", ""1066371373"", ""874743020"", ""2690842873"", ""1273670323"", ""2614336239"", ""748588237"", ""464391330"", ""930880214"", ""21965432"", ""36666554"", ""27345147"", ""2828120210"", ""1056475747"", ""166167970"", ""846298957"", ""47857781"", ""329415796"", ""20764155"", ""2884173593"", ""2536796111"", ""275758578"", ""1682547080"", ""471302763"", ""2509417839"", ""357877628"", ""578756547"", ""2905601601"", ""472083714"", ""2560120714"", ""2423599832"", ""2894423816"", ""29897650"", ""257484626"", ""913311864"", ""325062971"", ""2613224950"", ""54372224"", ""49930322"", ""2530367546"", ""271875446"", ""470283065"", ""402488515"", ""2273282888"", ""2752192451"", ""2828443618"", ""1339269476"", ""2264548713"", ""2453850531"", ""16169629"", ""374357782"", ""140739842"", ""295198089"", ""1561413559"", ""2370908751"", ""40331982"", ""60398280"", ""115741432"", ""1883661948"", ""2822954427"", ""366248873"", ""2423364223"", ""21656717"", ""330519528"", ""19635122"", ""576801455"", ""1948075638"", ""211885617"", ""487630770"", ""489864494"", ""2477717754"", ""1391753906"", ""2602892338"", ""74884785"", ""567326156"", ""442572090"", ""48375445"", ""755576502"", ""75592503"", ""163722969"", ""17679507"", ""2691032407"", ""538653558"", ""154680479"", ""273025101"", ""1637725969"", ""21508426"", ""32660080"", ""1091725316"", ""2942314827"", ""43679281"", ""86836936"", ""710525314"", ""2723735572"", ""1523306520"", ""22585606"", ""29246239"", ""841058988"", ""316838430"", ""196579078"", ""17734252"", ""2760614537"", ""88015928"", ""469439467"", ""223637055"", ""1498629798"", ""150156884"", ""1595149356"", ""2251173986"", ""15572981"", ""447241214"", ""863784570"", ""272563544"", ""1271386550"", ""862022622"", ""1085149063"", ""1323218581"", ""762027770"", ""2554021538"", ""275762094"", ""1957490102"", ""2867787756"", ""521761797"", ""224833414"", ""100150564"", ""399382566"", ""506730928"", ""1211368500"", ""1170521407"", ""17983686"", ""2956625407"", ""1597398924"", ""360113205"", ""192848943"", ""488893751"", ""122203248"", ""292629799"", ""64864764"", ""460849436"", ""261453997"", ""1639519178"", ""2204192636"", ""349251918"", ""2453124741"", ""142348663"", ""1551514550"", ""232215648"", ""268626754"", ""1007239393"", ""2912688233"", ""2369337056"", ""1909327327"", ""2839026554"", ""2157530853"", ""166263516"", ""241710283"", ""1345704769"", ""520401044"", ""2955756534"", ""597856749"", ""59237343"", ""17539456"", ""539332519"", ""615327247"", ""820502666"", ""478595374"", ""287183523"", ""94107710"", ""630251548"", ""1715176734"", ""1932648374"", ""501381054"", ""24321792"", ""1161853861"", ""2654253809"", ""16635996"", ""1051217779"", ""2243206261"", ""1327978776"", ""535554692"", ""318573723"", ""465790247"", ""2821577173"", ""34598159"", ""21614788"", ""909423811"", ""2484962204"", ""893954870"", ""46797286"", ""48310336"", ""28420590"", ""2198356523"", ""715206841"", ""259383883"", ""2204086600"", ""716768603"", ""2335375795"", ""2959360301"", ""259059584"", ""42568997"", ""250767676"", ""276089611"", ""1487097990"", ""2855983119"", ""887432780"", ""2559155400"", ""28863975"", ""290000051"", ""534721187"", ""1508408258"", ""528581970"", ""416690465"", ""2853256766"", ""317672205"", ""373601625"", ""559997364"", ""48724336"", ""119782056"", ""441014362"", ""339127100"", ""1254341334"", ""2731790954"", ""1209637092"", ""63989053"", ""417074878"", ""2319462686"", ""2900148061"", ""2349295460"", ""2352562980"", ""2885348567"", ""1460665812"", ""35787166"", ""16989970"", ""79802631"", ""329734806"", ""1598896028"", ""761321078"", ""139862643"", ""2187582525"", ""1138683673"", ""738723848"", ""150503785""]",30,18,48
79802631,35,84.11428571428571,-0.2865271942956107,2190847.0,14,0.42857142857142855,"[""charliehebdo-all-rnr-threads"", ""sydneysiege-all-rnr-threads""]","[""22993014"", ""17672825"", ""2574072036"", ""5402612"", ""7587032"", ""2097571"", ""3108351"", ""28785486"", ""18839785"", ""16931360"", ""742143"", ""1367531"", ""469509327"", ""428333""]",15,20,35
64643056,104,123.9326923076923,-0.41808531891841155,19230976.0,832,0.6442307692307693,"[""charliehebdo-all-rnr-threads"", ""germanwings-crash-all-rnr-threads"", ""sydneysiege-all-rnr-threads"", ""putinmissing-all-rnr-threads"", ""ottawashooting-all-rnr-threads"", ""ferguson-all-rnr-threads""]","[""557870733"", ""1538543972"", ""2190743918"", ""2879601310"", ""702591266"", ""87104813"", ""33857678"", ""514863000"", ""1011996840"", ""2711204024"", ""198660058"", ""2363101508"", ""118826051"", ""128370270"", ""39871064"", ""1428922874"", ""243825867"", ""2729860567"", ""2792858448"", ""43464149"", ""2167901880"", ""588149845"", ""805218732"", ""2658183165"", ""1117363285"", ""2954137227"", ""252464060"", ""2167757069"", ""125534451"", ""285566662"", ""392958028"", ""843685266"", ""3080919807"", ""429978338"", ""50235966"", ""334136215"", ""1022564808"", ""127836912"", ""73465147"", ""22529583"", ""46746701"", ""388768535"", ""267906861"", ""2969395535"", ""2886738278"", ""1957179614"", ""588998617"", ""178947924"", ""23133818"", ""282367461"", ""2654158955"", ""526619697"", ""1201405195"", ""275288575"", ""1645178179"", ""1215196814"", ""1059286154"", ""1159932996"", ""266236372"", ""727520658"", ""2614001430"", ""433991853"", ""201463245"", ""256976823"", ""248095178"", ""2461872043"", ""508166970"", ""2739380114"", ""594233612"", ""458768756"", ""2820702651"", ""1729065984"", ""2834755475"", ""59366017"", ""2173887149"", ""548739797"", ""537291530"", ""136536267"", ""39042421"", ""1317830694"", ""963145339"", ""1024343762"", ""469699513"", ""77425319"", ""579015370"", ""242120939"", ""2919917269"", ""234981515"", ""926383879"", ""614711212"", ""1280062580"", ""1220694312"", ""64643056"", ""2750047536"", ""1726319492"", ""2727933986"", ""460705232"", ""1450167320"", ""460623393"", ""15347644"", ""187304961"", ""1938251479"", ""2758058493"", ""1183468362"", ""1925803393"", ""355542022"", ""2922814893"", ""62155958"", ""80112107"", ""16573662"", ""2376076501"", ""45804408"", ""2301069197"", ""19470459"", ""1343546233"", ""2267239039"", ""2686106365"", ""202991265"", ""179102510"", ""76779374"", ""97322041"", ""59456108"", ""1359421328"", ""114130973"", ""322721461"", ""71597066"", ""16548115"", ""177394608"", ""23457428"", ""16071327"", ""2180434818"", ""107796984"", ""114240550"", ""2840919860"", ""561038271"", ""2682891252"", ""974823110"", ""2353127840"", ""258591990"", ""227441287"", ""255062000"", ""398791317"", ""1946065472"", ""1709681166"", ""190112127"", ""733471032"", ""47903435"", ""94981921"", ""181681493"", ""31419673"", ""8431652"", ""250649619"", ""117213468"", ""1712159514"", ""204195016"", ""593344418"", ""283582930"", ""1931711646"", ""1576004756"", ""62246679"", ""16960958"", ""7310842"", ""180884051"", ""315326703"", ""280012815"", ""256358298"", ""227444145"", ""888078932"", ""830674884"", ""474517400"", ""20628538"", ""185879040"", ""934246032"", ""74747435"", ""2957076329"", ""191947594"", ""377540405"", ""49485604"", ""491736061"", ""2511739878"", ""2734598839"", ""1020681224"", ""263912528"", ""226997507"", ""434512121"", ""36844227"", ""1038235795"", ""30982296"", ""194160226"", ""2286567210"", ""2817299007"", ""2691186956"", ""2779390794"", ""2475902143"", ""361135947"", ""85761585"", ""326175211"", ""17581602"", ""7329762"", ""2268915379"", ""177972446"", ""114804210"", ""54536619"", ""247348642"", ""783252408"", ""74459554"", ""46619441"", ""1462638932"", ""396859685"", ""466228100"", ""1524697098"", ""414653470"", ""29577416"", ""557111376"", ""50365183"", ""2785975828"", ""17436585"", ""464989725"", ""257186308"", ""813307975"", ""480252546"", ""271114521"", ""190624049"", ""490065494"", ""2595978877"", ""2263883537"", ""2478450709"", ""33928457"", ""2351339382"", ""2708805361"", ""175680666"", ""1626408469"", ""326892463"", ""2600621242"", ""17669739"", ""248908746"", ""66612236"", ""2464329458"", ""1043595505"", ""2342163477"", ""2336626717"", ""107682762"", ""1335041754"", ""21497824"", ""385796018"", ""239552078"", ""570184874"", ""1354399494"", ""2830305847"", ""2764413217"", ""551551599"", ""561715710"", ""2841533735"", ""504655640"", ""1639936908"", ""490188779"", ""751972855"", ""1648689541"", ""133247890"", ""532393287"", ""300602089"", ""131532978"", ""70466051"", ""124358668"", ""582641228"", ""290830753"", ""385057255"", ""2941652236"", ""322575976"", ""214400781"", ""296988845"", ""2427757981"", ""86694324"", ""161646128"", ""2147763698"", ""2195477666"", ""2363741781"", ""177904568"", ""26015031"", ""23147616"", ""2223435566"", ""17685299"", ""292487890"", ""213530957"", ""586287288"", ""281854613"", ""62591883"", ""1010780318"", ""2938592060"", ""2728658254"", ""2816034688"", ""2200860579"", ""2746498917"", ""128753624"", ""43089397"", ""188869825"", ""80942220"", ""277939663"", ""2326203306"", ""253517139"", ""1401723518"", ""354917016"", ""244996519"", ""32279580"", ""2914002725"", ""2782190170"", ""980457650"", ""401535830"", ""2657037480"", ""1327640226"", ""2313836011"", ""435243817"", ""2409386977"", ""20812593"", ""1090948867"", ""2886586060"", ""274955258"", ""1240917696"", ""70638153"", ""38519201"", ""2238287285"", ""2736563152"", ""276488996"", ""469396358"", ""816132036"", ""1302764899"", ""1208396532"", ""61953062"", ""403016602"", ""315957263"", ""114115853"", ""2284678018"", ""1443219385"", ""236837623"", ""77294073"", ""2708850794"", ""792579313"", ""1535932902"", ""154284486"", ""132776522"", ""31319544"", ""279366830"", ""2744222581"", ""258666879"", ""383355199"", ""2787148060"", ""394142623"", ""497771286"", ""899439308"", ""1100048125"", ""138132973"", ""2484656220"", ""350042055"", ""244108572"", ""2712856529"", ""127296308"", ""25641158"", ""2734020596"", ""2951935810"", ""441919659"", ""257186141"", ""301510626"", ""134307442"", ""209845048"", ""528531511"", ""742533474"", ""390462746"", ""170539874"", ""448043662"", ""2768705528"", ""365495645"", ""938671448"", ""2372104719"", ""211264482"", ""1115578729"", ""75765850"", ""362550270"", ""489927288"", ""2788944340"", ""2520327521"", ""626361745"", ""497537643"", ""189355737"", ""1568775032"", ""2736950783"", ""1723818170"", ""184510373"", ""1687518794"", ""190734698"", ""386978211"", ""518630436"", ""435517180"", ""2444050885"", ""159176236"", ""1890856070"", ""325234656"", ""127770294"", ""2730011913"", ""2326652760"", ""2476744150"", ""1024309812"", ""1090901779"", ""469190964"", ""2235299638"", ""21745651"", ""2262897560"", ""459430033"", ""434770945"", ""1436131861"", ""608417913"", ""287045452"", ""86261227"", ""951710294"", ""223466412"", ""2475721884"", ""2440150836"", ""109892126"", ""1528623175"", ""262486400"", ""236684588"", ""1276393525"", ""1177975800"", ""15688765"", ""212493407"", ""2586578106"", ""606330171"", ""2308329118"", ""2409013237"", ""374895381"", ""1397423635"", ""117584614"", ""1652769782"", ""38213676"", ""2453432296"", ""36621824"", ""2777537827"", ""2696828833"", ""22953738"", ""1362249300"", ""73043514"", ""19873463"", ""1977489326"", ""51410043"", ""165546381"", ""2380248444"", ""43462866"", ""360973161"", ""2215260181"", ""56317737"", ""1093009717"", ""1526906239"", ""47797027"", ""2791848577"", ""2903123943"", ""128884534"", ""2315428177"", ""458196351"", ""1621733996"", ""2967281807"", ""78898625"", ""2176555676"", ""26703"", ""23618173"", ""2179493785"", ""257952831"", ""87638663"", ""7114422"", ""2784960722"", ""158379198"", ""2587291417"", ""484570092"", ""57023952"", ""2353224308"", ""71481297"", ""27734496"", ""2439885205"", ""2820211315"", ""271032785"", ""230970655"", ""2274722621"", ""1648639159"", ""2582045087"", ""147128397"", ""175742582"", ""94626353"", ""1455992354"", ""2163438643"", ""430625413"", ""52853970"", ""835884122"", ""257151360"", ""2409045720"", ""200468277"", ""2541008220"", ""284551366"", ""2627943512"", ""2302890619"", ""26633733"", ""151978461"", ""14178479"", ""932980694"", ""2362261736"", ""1198971475"", ""213223080"", ""2875761863"", ""2817620199"", ""240577959"", ""1093360003"", ""887957676"", ""2962507555"", ""164719717"", ""1100855744"", ""2360062596"", ""2364786337"", ""994722061"", ""2330708426"", ""56432677"", ""414177066"", ""187147866"", ""24842995"", ""2733503194"", ""2204434298"", ""48152193"", ""578756547"", ""2853423165"", ""112947311"", ""225937279"", ""405194953"", ""295596713"", ""19577412"", ""167826483"", ""361617342"", ""2441910085"", ""2474620261"", ""25118166"", ""913311864"", ""1031773916"", ""2773644809"", ""2742669599"", ""1630361768"", ""869684162"", ""2864140683"", ""1011970700"", ""1048389972"", ""2514573504"", ""421320878"", ""2728381618"", ""131399352"", ""2966300729"", ""620885638"", ""2306857765"", ""2273282888"", ""2659891316"", ""18581038"", ""562236448"", ""34486207"", ""328589344"", ""844570771"", ""82411036"", ""306656413"", ""1486161968"", ""2453850531"", ""77583831"", ""2342479104"", ""2520482240"", ""2395354315"", ""1336161774"", ""2313976729"", ""3022663776"", ""346797498"", ""2489876530"", ""96435825"", ""16395830"", ""2365843422"", ""2871981538"", ""2370908751"", ""2891835399"", ""609355875"", ""2841491128"", ""204779004"", ""1131136735"", ""1032587216"", ""63430346"", ""15296929"", ""47941897"", ""400360169"", ""2933463437"", ""51962082"", ""328602738"", ""217978608"", ""297080451"", ""49146214"", ""1521814032"", ""166320569"", ""154221630"", ""1437045672"", ""1026953953"", ""1908658609"", ""69519762"", ""266554539"", ""1228514706"", ""143362318"", ""2356788104"", ""2659656338"", ""60618619"", ""55786563"", ""295602554"", ""41833173"", ""160336594"", ""2465947416"", ""2799887553"", ""16382144"", ""615647625"", ""251839291"", ""602062366"", ""326142499"", ""2711590999"", ""1653834024"", ""45901402"", ""78262626"", ""136909997"", ""1454185417"", ""282756639"", ""150601108"", ""359328460"", ""30627476"", ""2381131435"", ""301599956"", ""20652674"", ""83794329"", ""2744928150"", ""2915660732"", ""1627753237"", ""2785154331"", ""1387510518"", ""483945427"", ""5501422"", ""36997079"", ""1396491763"", ""2729244818"", ""293981380"", ""15803977"", ""300273970"", ""47726591"", ""257531308"", ""295510001"", ""919389188"", ""260376368"", ""1662150878"", ""2945865278"", ""2729847836"", ""2856002834"", ""47683059"", ""2813909150"", ""2564986392"", ""2488864572"", ""178687010"", ""1569707556"", ""61755415"", ""323448649"", ""1206161593"", ""249809080"", ""58167203"", ""318691517"", ""256455213"", ""2348571228"", ""33786971"", ""231726421"", ""2601118704"", ""1348798826"", ""343096504"", ""34759202"", ""228332540"", ""448836862"", ""589286587"", ""1694505757"", ""516388235"", ""2355673955"", ""542493512"", ""336105168"", ""1499044742"", ""176123550"", ""1648253690"", ""86445403"", ""21323445"", ""15037033"", ""383863452"", ""1047778986"", ""2459278543"", ""53007084"", ""2345950056"", ""2730696769"", ""107886071"", ""164211696"", ""257143165"", ""379076308"", ""22707692"", ""573730718"", ""535944375"", ""2471587969"", ""930789798"", ""478742268"", ""924176922"", ""2438105965"", ""2493221947"", ""190224295"", ""1938260035"", ""313483181"", ""2721045099"", ""871591850"", ""216714909"", ""18987335"", ""1722043892"", ""1536019639"", ""17677590"", ""310162203"", ""275701337"", ""480147479"", ""2513407114"", ""164154640"", ""2216598879"", ""146008666"", ""13003922"", ""192406867"", ""2319950984"", ""136457053"", ""1064312154"", ""107990104"", ""450581573"", ""634690404"", ""1345554990"", ""431745600"", ""2373783968"", ""2240343734"", ""1850792372"", ""1213606554"", ""139752644"", ""21643658"", ""1605803646"", ""93189471"", ""2217457444"", ""211777000"", ""556503737"", ""113693399"", ""179250417"", ""131395119"", ""39296307"", ""1382894354"", ""219630174"", ""18694252"", ""107573070"", ""2933799228"", ""2954532452"", ""2986972833"", ""48631414"", ""93312530"", ""245571248"", ""2232007742"", ""459983485"", ""255108166"", ""2965771385"", ""18044932"", ""929959202"", ""1494243667"", ""2171144353"", ""494822288"", ""497056985"", ""2241840566"", ""38979348"", ""329454031"", ""20523223"", ""230816634"", ""2925871667"", ""295758576"", ""1332753127"", ""622969430"", ""61169729"", ""151613726"", ""2213758655"", ""2311394295"", ""842830795"", ""110694564"", ""579901840"", ""536223591"", ""238413353"", ""283895307"", ""317920566"", ""529711774"", ""83448956"", ""353022618"", ""41404457"", ""388896551"", ""1173106255"", ""311450043"", ""41683319"", ""2879416903"", ""94894401"", ""25508307"", ""2193866757"", ""2516616586"", ""2256985338"", ""2960946279"", ""105078752"", ""1298672137"", ""2187632677"", ""1005960060"", ""2885348567"", ""291076313"", ""1960908224"", ""2659206870"", ""114872619"", ""262222386"", ""433301961"", ""20707060"", ""851323664"", ""1342369176"", ""754335954"", ""2375634619"", ""437237690"", ""1480842452"", ""1323620664"", ""2225011040"", ""236170649"", ""1694169914"", ""16258138"", ""2699270084"", ""2957428788"", ""350370049"", ""1591762152"", ""2780435246"", ""73683739"", ""2449698240""]",67,37,104
830674884,5,122.2,-0.28483014106750487,6647749.0,4,0.4,"[""charliehebdo-all-rnr-threads"", ""ottawashooting-all-rnr-threads""]","[""19533817"", ""469509327"", ""270016438"", ""64643056""]",2,3,5
1100855744,9,52.55555555555556,-0.09965706533855861,6689103.0,4,0.7777777777777778,"[""charliehebdo-all-rnr-threads"", ""ottawashooting-all-rnr-threads""]","[""87818409"", ""868112707"", ""2097571"", ""64643056""]",7,2,9
1382894354,13,127.07692307692308,-0.4412539372077355,2157300.0,3,0.5384615384615384,"[""charliehebdo-all-rnr-threads"", ""sydneysiege-all-rnr-threads""]","[""16887175"", ""16973333"", ""64643056""]",7,6,13
14544703,2,40.0,-0.28862425684928894,12680849.0,2,0.5,"[""charliehebdo-all-rnr-threads"", ""ferguson-all-rnr-threads""]","[""148653311"", ""14849562""]",1,1,2
1045042717,3,73.0,0.12190695603688557,1973450.0,3,0.3333333333333333,"[""charliehebdo-all-rnr-threads"", ""sydneysiege-all-rnr-threads""]","[""1128995864"", ""148653311"", ""268676434""]",1,2,3
3108351,66,124.01515151515152,-0.2519448417605776,19336871.0,666,0.4393939393939394,"[""charliehebdo-all-rnr-threads"", ""germanwings-crash-all-rnr-threads"", ""sydneysiege-all-rnr-threads"", ""gurlitt-all-rnr-threads"", ""ottawashooting-all-rnr-threads"", ""ferguson-all-rnr-threads""]","[""2892548240"", ""1109685884"", ""587935398"", ""2462310905"", ""2261679157"", ""38233752"", ""1503342588"", ""172176516"", ""2270967824"", ""320342277"", ""11094282"", ""1407027576"", ""139198644"", ""497731840"", ""261547866"", ""56666374"", ""345461924"", ""1787271"", ""851424812"", ""19404891"", ""127836912"", ""2335652682"", ""446090752"", ""21242484"", ""734634998"", ""385867775"", ""626870495"", ""82412657"", ""2596804566"", ""2924963856"", ""161695818"", ""363390100"", ""2208746299"", ""258896387"", ""278441165"", ""2883972239"", ""1226575850"", ""36226017"", ""2264503075"", ""547664351"", ""2863916360"", ""499847732"", ""2882783909"", ""2453305489"", ""248095178"", ""1591128037"", ""25072348"", ""2933943867"", ""2313788123"", ""13205972"", ""592214012"", ""76158998"", ""2560148358"", ""528571015"", ""2584501496"", ""173720699"", ""986507257"", ""2418899281"", ""560227730"", ""2802005307"", ""20334324"", ""3101746117"", ""49013218"", ""1575238116"", ""804854018"", ""560801236"", ""414013525"", ""725694205"", ""507794602"", ""1667721308"", ""2077351"", ""14857438"", ""1483693003"", ""15550043"", ""1596737431"", ""2540893166"", ""22587262"", ""514869271"", ""15125592"", ""2786765641"", ""794671951"", ""1715066035"", ""15628190"", ""2813039335"", ""626674509"", ""518921096"", ""167291226"", ""51620055"", ""451059709"", ""2927454722"", ""1635730448"", ""2711672473"", ""2162983369"", ""915436742"", ""917497788"", ""2431432212"", ""2869205353"", ""2513043992"", ""27813235"", ""2856927247"", ""38133247"", ""205850618"", ""616416863"", ""2707253917"", ""402743744"", ""531717118"", ""1931711646"", ""869413422"", ""113087476"", ""91803279"", ""2784477327"", ""2560950470"", ""11305972"", ""966066764"", ""2497747132"", ""16976029"", ""1084264573"", ""22053500"", ""37467514"", ""1020681224"", ""2396634450"", ""24733289"", ""745248356"", ""38699733"", ""20148675"", ""330063072"", ""2310735727"", ""1038235795"", ""194160226"", ""34301277"", ""716009929"", ""779735708"", ""1134734004"", ""2575739305"", ""41968576"", ""790772725"", ""139035638"", ""356720999"", ""89404711"", ""232372741"", ""87883699"", ""147010281"", ""17436585"", ""275566691"", ""560374994"", ""193110887"", ""1482457993"", ""2878548752"", ""431538893"", ""2331281468"", ""2814701906"", ""450603723"", ""190280139"", ""121176980"", ""2412015985"", ""257855006"", ""2965530474"", ""2186571412"", ""2685926647"", ""2368476672"", ""2206466353"", ""2607779288"", ""1942274774"", ""510307226"", ""161803021"", ""2610394916"", ""301466964"", ""1542767918"", ""128750531"", ""329119160"", ""160450335"", ""2730420754"", ""1598812760"", ""188108079"", ""490112666"", ""262457799"", ""1213237104"", ""544560619"", ""2684118603"", ""31545766"", ""2181875067"", ""185066670"", ""2755909005"", ""289383524"", ""91857015"", ""224426162"", ""18788135"", ""1380746959"", ""399345871"", ""134518138"", ""526416183"", ""2949833486"", ""1020663524"", ""2795931064"", ""551843418"", ""349265905"", ""476853918"", ""2851551783"", ""48304732"", ""564419593"", ""2699970331"", ""37359097"", ""1910974609"", ""240818448"", ""2361076726"", ""2398658035"", ""146788186"", ""74748351"", ""135394878"", ""316869157"", ""1939196694"", ""416032772"", ""747707262"", ""2586370488"", ""1431952093"", ""220981466"", ""119191967"", ""1720304882"", ""2886586060"", ""22298467"", ""1062791150"", ""1061029789"", ""575880247"", ""336196057"", ""23388995"", ""35373316"", ""225898637"", ""221543326"", ""930970945"", ""1156022551"", ""2255785158"", ""10715902"", ""628974175"", ""1701374971"", ""1355650153"", ""2936694741"", ""229482248"", ""78837703"", ""385988456"", ""2741557706"", ""2474493694"", ""2194747062"", ""720186867"", ""121418355"", ""1201343808"", ""465682606"", ""26156936"", ""115372837"", ""387516768"", ""207023127"", ""327110602"", ""7905512"", ""243780912"", ""68280589"", ""489497300"", ""2842658438"", ""361988610"", ""135771704"", ""67251641"", ""54589494"", ""2413375176"", ""35235587"", ""12736222"", ""2268647587"", ""228578937"", ""102724810"", ""878655300"", ""532751180"", ""154857864"", ""49864302"", ""2723303783"", ""93290821"", ""909894727"", ""429456363"", ""16043259"", ""249864384"", ""2574551884"", ""622297777"", ""450610574"", ""45727588"", ""30148992"", ""566549469"", ""2834846529"", ""2930923669"", ""2407248410"", ""353785603"", ""789530898"", ""714272731"", ""18340804"", ""2254699749"", ""222184684"", ""373264592"", ""939825373"", ""2628252246"", ""112669391"", ""46991806"", ""22342990"", ""83947010"", ""262989940"", ""74162921"", ""27435867"", ""1436131861"", ""2937525600"", ""224180296"", ""1660476866"", ""1550786821"", ""112254843"", ""236175465"", ""434988195"", ""2863535713"", ""1960036903"", ""101516992"", ""904482176"", ""548221028"", ""2898190371"", ""389548615"", ""32412385"", ""193104543"", ""2689665578"", ""426453747"", ""2388709281"", ""3106208237"", ""1652769782"", ""352940830"", ""2961649574"", ""2281072854"", ""411701635"", ""2679728168"", ""22953738"", ""72255970"", ""372464674"", ""81260589"", ""25658504"", ""501164397"", ""35313783"", ""41687976"", ""43462866"", ""2271943398"", ""18142983"", ""22463338"", ""2431932690"", ""24688874"", ""48354257"", ""189118361"", ""1388575970"", ""2447771113"", ""20527491"", ""893485608"", ""370495082"", ""2223008040"", ""1370664036"", ""345644480"", ""2176555676"", ""1226364937"", ""1329199266"", ""2871588796"", ""17768216"", ""2532865220"", ""390479893"", ""58419534"", ""838881872"", ""344911215"", ""286528561"", ""14948551"", ""2178954146"", ""2942227093"", ""1677868495"", ""543529717"", ""23074025"", ""1500422358"", ""34126592"", ""200641413"", ""35930326"", ""1963561561"", ""94626353"", ""244572918"", ""2855109985"", ""2185497955"", ""792510331"", ""626682905"", ""85362875"", ""249166005"", ""79939817"", ""2903328589"", ""2396462640"", ""2829665949"", ""1028762646"", ""345286844"", ""18714664"", ""531134841"", ""2912943557"", ""795612026"", ""75971805"", ""18983688"", ""1953945078"", ""528122975"", ""113655459"", ""2875761863"", ""2895871151"", ""60815956"", ""2959425978"", ""107498390"", ""451505396"", ""33329570"", ""2958801627"", ""101897618"", ""2403111176"", ""869790421"", ""117014208"", ""97082594"", ""72516101"", ""225937279"", ""1620537127"", ""2560120714"", ""622365344"", ""244074866"", ""1531935692"", ""2172133068"", ""517656712"", ""34831969"", ""964945489"", ""2824462458"", ""99045521"", ""29897650"", ""579504493"", ""78202987"", ""2797018281"", ""2864140683"", ""2369976362"", ""102238015"", ""16161856"", ""2306857765"", ""37713818"", ""1199790986"", ""1069517660"", ""327332233"", ""162645448"", ""20649494"", ""136234813"", ""61191047"", ""14942482"", ""500028700"", ""232704551"", ""1561024902"", ""340867806"", ""127587958"", ""97221801"", ""1497680641"", ""2356127598"", ""2837612147"", ""442691734"", ""127625962"", ""26960518"", ""861786355"", ""15232867"", ""103245828"", ""16562019"", ""546381549"", ""277264910"", ""585695952"", ""2370908751"", ""1017578654"", ""2904195064"", ""2774026927"", ""2155504715"", ""17816354"", ""2252890903"", ""412850734"", ""392739061"", ""51962082"", ""375088982"", ""20423979"", ""1400722148"", ""33752742"", ""2874478519"", ""2793021060"", ""2220433850"", ""360656343"", ""249221120"", ""266554539"", ""227084128"", ""2880026929"", ""12531012"", ""1225414310"", ""2906020675"", ""934537771"", ""223791935"", ""713090676"", ""28506572"", ""576321401"", ""2923472146"", ""289414660"", ""2951968857"", ""60684098"", ""509601309"", ""1635731965"", ""127059434"", ""35659801"", ""2665795880"", ""2833701362"", ""2239722660"", ""1637725969"", ""523212986"", ""30981130"", ""1656511472"", ""2339831378"", ""107804798"", ""159577419"", ""16953991"", ""1569425222"", ""16804088"", ""2164725326"", ""1396841557"", ""2904066798"", ""2951520791"", ""347358838"", ""220139267"", ""705193680"", ""223637055"", ""467185569"", ""416087960"", ""58159821"", ""52648706"", ""104635760"", ""2714239686"", ""744216896"", ""766398499"", ""114962484"", ""197777712"", ""26867040"", ""2945865278"", ""2819572487"", ""18826013"", ""598849362"", ""44674111"", ""33772637"", ""1569707556"", ""1665597157"", ""40328161"", ""537291796"", ""2818826268"", ""2283483315"", ""2951504681"", ""234912898"", ""2601118704"", ""2257552586"", ""1348798826"", ""725748750"", ""1856237718"", ""1857713904"", ""105303715"", ""31473618"", ""427182981"", ""2858149972"", ""475510687"", ""165390488"", ""115898203"", ""1917883639"", ""177182882"", ""15198585"", ""82637042"", ""1550449868"", ""456536763"", ""150111340"", ""2826961293"", ""2459278543"", ""1926571681"", ""349915681"", ""17512048"", ""2195883799"", ""56150520"", ""52740328"", ""2570631118"", ""48831366"", ""2196766572"", ""2735769510"", ""718379695"", ""99753691"", ""448737306"", ""467222390"", ""24181873"", ""929461117"", ""47717943"", ""965033180"", ""460862690"", ""2669987066"", ""367408834"", ""64250634"", ""352068186"", ""51563148"", ""191517957"", ""701094366"", ""45124518"", ""2344887835"", ""465790247"", ""392442635"", ""63360254"", ""2905473567"", ""342885148"", ""177512390"", ""461986120"", ""372875229"", ""2195116544"", ""18455693"", ""538765846"", ""225465923"", ""1933481100"", ""1498709924"", ""223460381"", ""542872926"", ""32663310"", ""1350488119"", ""29389759"", ""41395813"", ""94792767"", ""140561313"", ""2826651588"", ""2851170553"", ""234783426"", ""107918290"", ""631554075"", ""1845781398"", ""240114180"", ""515151082"", ""89475682"", ""15372043"", ""2317689248"", ""551261286"", ""390548200"", ""2649727383"", ""165057262"", ""91987344"", ""80989248"", ""38385875"", ""25768661"", ""2427483865"", ""521005895"", ""1634512056"", ""1203856092"", ""47063444"", ""96205465"", ""774864242"", ""2900148061"", ""915990943"", ""24089505"", ""39983401"", ""185761585"", ""30332498"", ""2921262581"", ""51069583"", ""220405320"", ""1851971178"", ""2345690030"", ""79802631"", ""2960884011"", ""379855423"", ""120437670"", ""17915515"", ""534186644"", ""2429539070"", ""790947306"", ""1886182728"", ""227695186"", ""3108351"", ""44861432"", ""45282172""]",29,37,66
5402612,107,126.12149532710276,-0.42037920695598996,13218879.0,1397,0.6448598130841121,"[""charliehebdo-all-rnr-threads"", ""germanwings-crash-all-rnr-threads"", ""sydneysiege-all-rnr-threads"", ""gurlitt-all-rnr-threads"", ""ottawashooting-all-rnr-threads""]","[""575652263"", ""702591266"", ""33857678"", ""2301041090"", ""3064848597"", ""1109685884"", ""34334779"", ""2590559634"", ""560192642"", ""2202258718"", ""344582086"", ""2253764612"", ""68020024"", ""78337155"", ""2961303215"", ""3096548182"", ""2638177484"", ""712738646"", ""2729623004"", ""392958028"", ""859095241"", ""766658"", ""407098854"", ""278192441"", ""196968989"", ""20501027"", ""2443498549"", ""3014589401"", ""29406737"", ""2267500054"", ""469699513"", ""193114114"", ""529571885"", ""55489461"", ""379137307"", ""87633846"", ""37078327"", ""368224044"", ""2922814893"", ""24259225"", ""295794474"", ""244115238"", ""2949990112"", ""759052645"", ""78397375"", ""2867388897"", ""312261322"", ""26446477"", ""889557408"", ""999907196"", ""2446614943"", ""1591303436"", ""1712159514"", ""410193959"", ""3084587848"", ""513577150"", ""341439889"", ""14080610"", ""2659792329"", ""803236128"", ""484907475"", ""2460352694"", ""82635917"", ""2497286180"", ""2611157111"", ""1528260655"", ""20561955"", ""20703831"", ""276900232"", ""138793265"", ""111139898"", ""149455345"", ""610701091"", ""1166086116"", ""2315926309"", ""147787443"", ""622210592"", ""44464005"", ""34856840"", ""126456202"", ""136221823"", ""227478844"", ""2889479943"", ""129999150"", ""2930966744"", ""2547509651"", ""69082293"", ""79212768"", ""186870988"", ""66843801"", ""337575512"", ""25212308"", ""861542600"", ""22217443"", ""237488620"", ""407277096"", ""123628014"", ""9138142"", ""802220874"", ""181186276"", ""2851551783"", ""2283194563"", ""2921552959"", ""332764033"", ""2914717815"", ""45579453"", ""232695008"", ""921191076"", ""302703226"", ""556894056"", ""369785880"", ""578550086"", ""492586213"", ""1090948867"", ""31618419"", ""168487312"", ""47502031"", ""518651331"", ""52299200"", ""43086592"", ""350124933"", ""2320525034"", ""34033504"", ""78837703"", ""757258002"", ""172529940"", ""423625300"", ""380542968"", ""22907744"", ""2464502209"", ""205843793"", ""21098865"", ""110850940"", ""268044192"", ""53156275"", ""98350238"", ""176809173"", ""347951481"", ""17588612"", ""14321748"", ""16304067"", ""89835577"", ""1033997960"", ""1850166343"", ""2425710504"", ""272136130"", ""94195346"", ""25008096"", ""17579955"", ""62830137"", ""815589109"", ""20410226"", ""951710294"", ""2905655700"", ""53987594"", ""14266111"", ""241643059"", ""76412576"", ""77739297"", ""215454677"", ""294655592"", ""702733796"", ""489974410"", ""168507862"", ""38762773"", ""2499725734"", ""2213552347"", ""1382857729"", ""43343657"", ""147202533"", ""2961649574"", ""831573920"", ""96820406"", ""128856362"", ""3016036575"", ""2215260181"", ""1325193295"", ""180340957"", ""27071062"", ""561416973"", ""2905430920"", ""2925097786"", ""48088248"", ""2857893113"", ""124729169"", ""1118430193"", ""116486879"", ""531134841"", ""15189196"", ""2580359761"", ""2841788625"", ""115501423"", ""1318763773"", ""89841906"", ""2753876550"", ""1530746612"", ""36113858"", ""84236580"", ""16599598"", ""172938122"", ""204944073"", ""18379848"", ""20987358"", ""537748667"", ""826046582"", ""1882846454"", ""1527156632"", ""1518883244"", ""2181425453"", ""26087651"", ""17855637"", ""177226293"", ""105623922"", ""131877198"", ""434563280"", ""1915170884"", ""33289323"", ""605443736"", ""2298094741"", ""205042570"", ""2841491128"", ""1255955048"", ""1497628081"", ""2826697284"", ""415109792"", ""465897557"", ""148461480"", ""60821338"", ""1731483115"", ""2787299182"", ""1018575726"", ""27067245"", ""99959521"", ""32444081"", ""490602212"", ""1268731999"", ""194127801"", ""1722647352"", ""64253306"", ""76994576"", ""1344572136"", ""321366897"", ""9081792"", ""248317578"", ""51114968"", ""37393408"", ""24242690"", ""29452854"", ""44299861"", ""59843216"", ""1072677926"", ""2365216921"", ""19009612"", ""139102545"", ""58167203"", ""345650937"", ""200857548"", ""21641212"", ""363935625"", ""443973466"", ""324908191"", ""228332540"", ""414312619"", ""1380691543"", ""1320134354"", ""197827014"", ""524775262"", ""82637042"", ""2400232080"", ""17132699"", ""134240162"", ""65403897"", ""62745266"", ""2256704753"", ""390099536"", ""78970329"", ""51540875"", ""2459797201"", ""17227075"", ""119318607"", ""567414819"", ""2562156394"", ""511201679"", ""2731790200"", ""94107710"", ""338909128"", ""296948666"", ""243447325"", ""19016076"", ""198836488"", ""582590664"", ""2785055123"", ""341682495"", ""396166155"", ""465790247"", ""2855854585"", ""2389777327"", ""1347766734"", ""190988390"", ""362075658"", ""2396533820"", ""243144602"", ""583762770"", ""19916681"", ""36466844"", ""791197"", ""199562817"", ""121229255"", ""15206921"", ""2542439420"", ""415836706"", ""606484205"", ""1634512056"", ""177186359"", ""74251363"", ""2569102596"", ""79802631"", ""2950318395"", ""63514440"", ""2719726640"", ""26219483"", ""1519315820"", ""16926230"", ""256518676"", ""20872583"", ""38699127"", ""264698850"", ""302253794"", ""2449982929"", ""560242800"", ""353286597"", ""43521065"", ""2873976901"", ""147181485"", ""47127416"", ""17248271"", ""2457682945"", ""523996194"", ""2766089701"", ""2408067523"", ""2716100047"", ""1181263850"", ""2877094585"", ""2776794626"", ""2428217983"", ""17215642"", ""87558021"", ""2883972239"", ""2484346413"", ""1301364216"", ""2315651983"", ""146566390"", ""281737861"", ""2933943867"", ""220551760"", ""1341896072"", ""929662333"", ""488916603"", ""2299325254"", ""386022923"", ""76380832"", ""254163854"", ""824915659"", ""2847847026"", ""104487298"", ""28839148"", ""2483752741"", ""48494546"", ""2578699266"", ""47476475"", ""774322105"", ""196516767"", ""539824041"", ""36177523"", ""77180390"", ""232703102"", ""2704810752"", ""238161737"", ""72613897"", ""1413433423"", ""2225907621"", ""561038271"", ""22403315"", ""1063347440"", ""2186960016"", ""302774717"", ""584988562"", ""1931711646"", ""22237278"", ""2846896705"", ""516103610"", ""1551160460"", ""965138012"", ""2925766126"", ""2195327711"", ""267989050"", ""2279504647"", ""634380003"", ""230267094"", ""236954775"", ""225279905"", ""146583530"", ""318463648"", ""17436585"", ""407279130"", ""2266196862"", ""2485652287"", ""2811672208"", ""67493037"", ""2921091842"", ""2879860455"", ""560009657"", ""1047778988"", ""41851861"", ""2783210830"", ""14944842"", ""18889581"", ""488799853"", ""1621548380"", ""619933086"", ""36033359"", ""226355976"", ""197351686"", ""220658283"", ""92491779"", ""160450335"", ""2782303899"", ""65412902"", ""2378935614"", ""1147663772"", ""248274160"", ""2754393364"", ""53101778"", ""2716912782"", ""27304360"", ""150709446"", ""42368754"", ""861700170"", ""295986246"", ""27706906"", ""418243137"", ""1574460648"", ""219026394"", ""2313836011"", ""2925362938"", ""1472778894"", ""327034464"", ""2651807532"", ""226516956"", ""2821320587"", ""61788586"", ""1345498502"", ""1511863236"", ""18413391"", ""21551156"", ""738803227"", ""1957119620"", ""2912429401"", ""34029690"", ""441036257"", ""538661886"", ""2788246408"", ""222438483"", ""392993359"", ""2254699749"", ""2785717076"", ""2965078709"", ""61784730"", ""1653573420"", ""2510410071"", ""556600669"", ""248722214"", ""805358514"", ""142165701"", ""2815596137"", ""2551443991"", ""1067999394"", ""48582984"", ""2242871101"", ""817431612"", ""181344414"", ""133496245"", ""227600013"", ""2285818776"", ""43717672"", ""20686232"", ""380256889"", ""2289257983"", ""2722033756"", ""2848372747"", ""281912753"", ""161813635"", ""88168692"", ""1554966415"", ""547415395"", ""544973485"", ""17836555"", ""103019313"", ""919998853"", ""22692756"", ""612901341"", ""362758378"", ""2805865690"", ""190846001"", ""459621192"", ""56698300"", ""2743585979"", ""1098815064"", ""90282879"", ""359015191"", ""16882000"", ""534914804"", ""751487816"", ""2167026835"", ""354601707"", ""206948196"", ""18983688"", ""16545567"", ""311994165"", ""2843321440"", ""339847349"", ""214174937"", ""19224100"", ""2358079231"", ""133050773"", ""22058808"", ""56914108"", ""225937279"", ""35673724"", ""2622559649"", ""41108256"", ""20711027"", ""50984153"", ""229487698"", ""2828024478"", ""2770935493"", ""326353546"", ""182749452"", ""18910589"", ""50609698"", ""354849447"", ""14112322"", ""194580642"", ""1226130840"", ""74490017"", ""2453850531"", ""172699821"", ""430092847"", ""24639297"", ""2218326164"", ""442691734"", ""10929352"", ""384303406"", ""14788631"", ""352482990"", ""2753359816"", ""414397846"", ""162629067"", ""2458739701"", ""28292289"", ""55743289"", ""2823497341"", ""270955821"", ""366248873"", ""1481591064"", ""1967689338"", ""2478042691"", ""2778715182"", ""320683307"", ""1868999378"", ""123390762"", ""50237699"", ""903332077"", ""48155944"", ""2779455120"", ""34692294"", ""299273094"", ""422676936"", ""2437756686"", ""420101419"", ""2538899928"", ""273025101"", ""237689572"", ""491917237"", ""2469725611"", ""1637725969"", ""120624301"", ""3069498803"", ""283393209"", ""230045723"", ""19910285"", ""590223302"", ""427515851"", ""52294841"", ""100064436"", ""2413562079"", ""181935023"", ""42743672"", ""49594954"", ""253867514"", ""723773060"", ""1446296653"", ""171944690"", ""65876505"", ""549181612"", ""47909467"", ""1856237718"", ""203207703"", ""292629799"", ""296385184"", ""2168110979"", ""2588241813"", ""299566836"", ""402151186"", ""294278734"", ""478368334"", ""1473295404"", ""2156289693"", ""920873413"", ""2916418126"", ""135939638"", ""20912737"", ""2191883604"", ""323854120"", ""20005540"", ""121509920"", ""356481986"", ""2578314115"", ""413856809"", ""149286219"", ""2848043788"", ""24056462"", ""1722524101"", ""948517734"", ""557764791"", ""2784361440"", ""63708761"", ""48612569"", ""9687742"", ""345192837"", ""273332894"", ""2420516678"", ""233697162"", ""621930944"", ""1426841690"", ""262288871"", ""389859047"", ""292074881"", ""2939874382"", ""83646746"", ""448208242"", ""325942107"", ""1510073408"", ""520684217"", ""839235774"", ""2788722909"", ""390678047"", ""24528266"", ""139659437"", ""352545633"", ""405426534"", ""2781956756"", ""2688953208"", ""21213776"", ""25366515"", ""44369449"", ""17690405"", ""2956459355"", ""189917222"", ""1503342588"", ""23746494"", ""14827547"", ""19806962"", ""135578944"", ""97639418"", ""264893717"", ""602222524"", ""25103904"", ""2090971"", ""216657384"", ""380464015"", ""405614354"", ""20500113"", ""2710534934"", ""2800045906"", ""197366013"", ""508316850"", ""2883540693"", ""235672610"", ""703892664"", ""2866333263"", ""2248861878"", ""619005919"", ""18975270"", ""66367082"", ""2875150078"", ""199184303"", ""42719424"", ""44895863"", ""1118788734"", ""1694019936"", ""76367445"", ""2787245715"", ""2381678975"", ""68864629"", ""235968709"", ""2907999285"", ""2482672057"", ""20228338"", ""451548925"", ""2401584939"", ""96654457"", ""202054350"", ""27660372"", ""2856927247"", ""25982848"", ""2756014735"", ""51815697"", ""1918781300"", ""379426282"", ""30840745"", ""1488378090"", ""1716360103"", ""20835299"", ""180961394"", ""8233272"", ""448355007"", ""64205894"", ""2804651726"", ""316418225"", ""2193141103"", ""32923336"", ""2431628416"", ""270311216"", ""240926988"", ""2413596962"", ""268881676"", ""873349400"", ""2856401319"", ""240447482"", ""390141151"", ""70467062"", ""47746339"", ""1902427388"", ""2921805299"", ""2464329458"", ""555519097"", ""2511219523"", ""21919632"", ""83957393"", ""2276638962"", ""1137848995"", ""614326571"", ""72507401"", ""35216869"", ""488954078"", ""784235184"", ""2483432142"", ""1849767788"", ""20457003"", ""553564804"", ""106330685"", ""581457408"", ""134518138"", ""459250352"", ""544692927"", ""19388832"", ""505992048"", ""140980387"", ""248549872"", ""27347119"", ""742773276"", ""62591883"", ""1401723518"", ""1108625665"", ""16249747"", ""29191099"", ""257526485"", ""244390641"", ""2465254319"", ""2761808375"", ""20583129"", ""2336193672"", ""3064924947"", ""497407083"", ""319451767"", ""2964610828"", ""51866339"", ""1215797401"", ""281260988"", ""16925180"", ""414770799"", ""130102974"", ""296070902"", ""101532348"", ""608261964"", ""2817119726"", ""117789874"", ""71847995"", ""435358245"", ""187081193"", ""429456363"", ""139364011"", ""225071446"", ""94476810"", ""31609859"", ""136233117"", ""381546775"", ""1242171468"", ""747131683"", ""20625063"", ""1691006022"", ""18454415"", ""761370182"", ""390576798"", ""718460834"", ""254202621"", ""2559727307"", ""332672273"", ""542162326"", ""1112322350"", ""2714705660"", ""1251859722"", ""22352691"", ""1652769782"", ""2613433808"", ""312922265"", ""2338238148"", ""18619664"", ""20742461"", ""379483584"", ""14436082"", ""628038157"", ""384336759"", ""607311691"", ""2964507380"", ""77743276"", ""112532974"", ""29895366"", ""153379098"", ""2205336709"", ""1511964535"", ""2758534719"", ""67189705"", ""395462277"", ""1973316967"", ""19103793"", ""110602516"", ""2878347261"", ""626682905"", ""1410907584"", ""2949263322"", ""158783582"", ""1394537838"", ""2355289178"", ""222243630"", ""2339459613"", ""2740252511"", ""20974887"", ""2211318686"", ""1531789724"", ""60482694"", ""2852446116"", ""478402262"", ""168697045"", ""2738152820"", ""1671271333"", ""425851352"", ""1096564123"", ""235865079"", ""248939523"", ""175827858"", ""20022064"", ""371295497"", ""2475021115"", ""90826184"", ""180874183"", ""1615032439"", ""522531116"", ""472083714"", ""2560120714"", ""253755891"", ""2726767198"", ""246103"", ""1622518266"", ""39788599"", ""291978413"", ""454790617"", ""2931846855"", ""58213608"", ""59238101"", ""108092947"", ""21754019"", ""546475152"", ""2725373878"", ""2210712729"", ""19589595"", ""609405961"", ""2963069700"", ""240005288"", ""1068331230"", ""14774143"", ""246861241"", ""79524603"", ""18475293"", ""29311088"", ""18564297"", ""1561413559"", ""2564769330"", ""2370908751"", ""623834045"", ""620824016"", ""2173981217"", ""76313071"", ""15381080"", ""20423979"", ""929871013"", ""2291649770"", ""17663287"", ""3004689773"", ""2780754387"", ""2858886167"", ""2707488317"", ""225007415"", ""2387426773"", ""2697713994"", ""1135580682"", ""35128272"", ""2445651157"", ""44113831"", ""233885425"", ""14570530"", ""707502001"", ""77357640"", ""2903776139"", ""81142305"", ""2248782649"", ""359328460"", ""30357671"", ""163870539"", ""220139267"", ""47422543"", ""3028227929"", ""2448218247"", ""2580752990"", ""86459786"", ""239662704"", ""202788569"", ""188122863"", ""233473001"", ""61171601"", ""132480999"", ""306091916"", ""1040687791"", ""49259564"", ""1065104221"", ""2945865278"", ""168468750"", ""1193802997"", ""2922458602"", ""799899498"", ""2886603226"", ""2419629020"", ""826957206"", ""2647453177"", ""95524062"", ""15740635"", ""2866552454"", ""263313255"", ""1876428638"", ""35406370"", ""1234987687"", ""1129628557"", ""1879627087"", ""62884325"", ""28565698"", ""142356070"", ""45366600"", ""1013221658"", ""2163730665"", ""24095957"", ""1938260035"", ""813767851"", ""2407816763"", ""180790812"", ""2241006968"", ""373956741"", ""26849753"", ""2893553980"", ""2373783968"", ""214537558"", ""427766022"", ""144346429"", ""2292860563"", ""20137038"", ""55459259"", ""283388524"", ""20291023"", ""913223120"", ""416690465"", ""244162041"", ""238413353"", ""250270399"", ""2416840645"", ""557273215"", ""717866965"", ""147979662"", ""3968"", ""2806168694"", ""2885348567"", ""15512979"", ""21682115"", ""1041049706"", ""20301302"", ""373299956"", ""2605667304"", ""463760037"", ""255581365"", ""30829927"", ""95537281"", ""2437066352"", ""20978217"", ""191915936"", ""14715008"", ""569844526"", ""7657652"", ""2756142648"", ""96598403"", ""142015635"", ""55170621"", ""302830929"", ""1531558520"", ""37891446"", ""2703246275"", ""1606376976"", ""21393709"", ""120698898"", ""2883969854"", ""6067992"", ""705123059"", ""2493142851"", ""2495955023"", ""159784592"", ""27839828"", ""2902374881"", ""2597247175"", ""2731866714"", ""565696224"", ""281412221"", ""262662868"", ""2428542024"", ""2882331822"", ""526967683"", ""434424645"", ""74687496"", ""2147835768"", ""133476353"", ""1059286154"", ""2478614430"", ""1226575850"", ""347883924"", ""147618542"", ""103972238"", ""1141308715"", ""2332376737"", ""408882753"", ""222486998"", ""557294588"", ""272429324"", ""399232149"", ""1025784786"", ""26380423"", ""19874207"", ""247706800"", ""290375225"", ""286112742"", ""282894960"", ""19234768"", ""2710993402"", ""2570855601"", ""16573662"", ""15676020"", ""1617219788"", ""60848534"", ""461880145"", ""2566015532"", ""767504844"", ""2424718186"", ""103348497"", ""115977507"", ""1666310030"", ""90707701"", ""67101179"", ""1600937988"", ""113182685"", ""22110387"", ""616168832"", ""69340789"", ""1048567458"", ""757505629"", ""550795576"", ""2232500950"", ""20548283"", ""898259630"", ""202976767"", ""2370142041"", ""493152117"", ""1882527974"", ""2414809730"", ""2511071191"", ""925172484"", ""47582275"", ""1109948761"", ""14360516"", ""1036747494"", ""123442897"", ""1038235795"", ""27466695"", ""20161032"", ""221527320"", ""249415256"", ""227554159"", ""552579928"", ""379609476"", ""2157313633"", ""972281593"", ""322986734"", ""97883743"", ""27637361"", ""793001270"", ""194342938"", ""355079885"", ""795927228"", ""455724651"", ""21050329"", ""61125520"", ""1542767918"", ""2149973089"", ""142140156"", ""187513087"", ""2467057226"", ""2616159025"", ""20315768"", ""18251461"", ""342371700"", ""200424039"", ""2782041548"", ""2317110306"", ""244495300"", ""273465530"", ""459054329"", ""2859654628"", ""473472787"", ""31700422"", ""160966848"", ""381406069"", ""2409399655"", ""18096270"", ""25677647"", ""2384915342"", ""398404674"", ""2816374311"", ""2955528717"", ""435599745"", ""15088333"", ""122033106"", ""50958800"", ""2936694741"", ""780992342"", ""546394376"", ""254980102"", ""291721832"", ""445307763"", ""19915454"", ""25416508"", ""1963156207"", ""610028948"", ""2385431253"", ""401275875"", ""2889009596"", ""120472105"", ""2768705528"", ""19665815"", ""27864572"", ""2892573913"", ""1636321404"", ""742764410"", ""122301168"", ""332981989"", ""34905985"", ""182851656"", ""24571658"", ""36157190"", ""12468462"", ""1927566248"", ""49190123"", ""1644748944"", ""2780648743"", ""1400777041"", ""40579448"", ""211586289"", ""434988195"", ""476595616"", ""1357102304"", ""1205878502"", ""64081114"", ""245208974"", ""114085514"", ""49489453"", ""302497339"", ""1108518408"", ""2741550169"", ""165404608"", ""76841773"", ""1400157811"", ""1358502698"", ""2374840280"", ""23478806"", ""2851898024"", ""219705857"", ""236890779"", ""45851324"", ""176310317"", ""1730772744"", ""25551176"", ""14791513"", ""565651670"", ""587809589"", ""533067221"", ""141943905"", ""2524403078"", ""45786419"", ""18859128"", ""1193329008"", ""2873032111"", ""141377519"", ""451656800"", ""179608296"", ""923278088"", ""2449644567"", ""2274808086"", ""500410336"", ""410941069"", ""26146334"", ""419403303"", ""81873794"", ""397240541"", ""765941791"", ""314152984"", ""290478377"", ""2577578980"", ""357052523"", ""144831082"", ""626336990"", ""180527019"", ""190724454"", ""152212782"", ""2764465137"", ""2665396579"", ""126430378"", ""35339809"", ""154797069"", ""2781933553"", ""2260621981"", ""2273282888"", ""67052568"", ""1634366978"", ""62846638"", ""59162656"", ""1204338008"", ""28944707"", ""443748781"", ""896137904"", ""2777758020"", ""275450231"", ""2837612147"", ""549430116"", ""2461139754"", ""2966139254"", ""221310328"", ""442769138"", ""2576951394"", ""78506936"", ""99014337"", ""2252890903"", ""50270379"", ""1270339064"", ""20342055"", ""338288298"", ""130423813"", ""2745054880"", ""365399601"", ""518371618"", ""191869031"", ""1123075297"", ""14503715"", ""5402612"", ""78663641"", ""19917957"", ""15448383"", ""101445204"", ""1394262409"", ""97518063"", ""2756178532"", ""251347788"", ""1074987822"", ""31694460"", ""300663767"", ""125344265"", ""2256809998"", ""355393193"", ""306401857"", ""22585606"", ""20639175"", ""846871074"", ""2744928150"", ""60642483"", ""317356845"", ""61133754"", ""2969472993"", ""312639744"", ""2927428900"", ""74967096"", ""23153001"", ""41714782"", ""211280553"", ""137873483"", ""442988780"", ""548543882"", ""1085149063"", ""21886391"", ""235199409"", ""14071491"", ""326859237"", ""326432600"", ""1550449868"", ""1111970312"", ""953958546"", ""2956629112"", ""50377802"", ""27587119"", ""927818520"", ""385610485"", ""364168933"", ""21020020"", ""626091019"", ""20282201"", ""2253875563"", ""1430803813"", ""690003"", ""1102336567"", ""67244474"", ""2904342348"", ""1397708275"", ""18376398"", ""2702802443"", ""177002568"", ""2202481990"", ""141746297"", ""2530747861"", ""27401628"", ""328741551"", ""260008735"", ""2734300973"", ""2919190268"", ""1664844716"", ""282734379"", ""42424745"", ""118682314"", ""132971676"", ""19939104"", ""552176637"", ""2335375795"", ""906046717"", ""344155702"", ""2231402880"", ""16843033"", ""756895062"", ""116950145"", ""2315875827"", ""2893254815"", ""784543718"", ""128356728"", ""156884716"", ""407039471"", ""117094801"", ""21752699"", ""206962580"", ""235768083"", ""130456674"", ""819452814"", ""225832762"", ""296747351"", ""2794050150"", ""11132802"", ""2922582122"", ""2743131825""]",69,38,107
21213776,26,92.3076923076923,-0.29972020479348993,6643750.0,1,0.8461538461538461,"[""charliehebdo-all-rnr-threads"", ""ottawashooting-all-rnr-threads""]","[""5402612""]",22,4,26
246103,21,88.57142857142857,-0.20460929757072813,12427039.0,4,0.047619047619047616,"[""charliehebdo-all-rnr-threads"", ""ottawashooting-all-rnr-threads"", ""ferguson-all-rnr-threads""]","[""27966935"", ""635608354"", ""146218381"", ""5402612""]",1,20,21
575652263,7,115.28571428571429,-0.3962241155760629,1975643.0,2,0.8571428571428571,"[""charliehebdo-all-rnr-threads"", ""sydneysiege-all-rnr-threads""]","[""428333"", ""5402612""]",6,1,7
2513308740,19,103.05263157894737,-0.2930686034654316,12511500.0,4,0.15789473684210525,"[""charliehebdo-all-rnr-threads"", ""ottawashooting-all-rnr-threads"", ""ferguson-all-rnr-threads""]","[""6591312"", ""635608354"", ""742143"", ""17537467""]",3,16,19
258730076,11,119.72727272727273,-0.5488356135108254,2161790.0,6,0.45454545454545453,"[""charliehebdo-all-rnr-threads"", ""sydneysiege-all-rnr-threads""]","[""16973333"", ""868112707"", ""51241574"", ""380648579"", ""6017542"", ""6591312""]",5,6,11
5967972,12,99.25,-0.2569333662589391,12353213.0,5,0.16666666666666666,"[""charliehebdo-all-rnr-threads"", ""putinmissing-all-rnr-threads"", ""ottawashooting-all-rnr-threads"", ""sydneysiege-all-rnr-threads""]","[""52003080"", ""249339016"", ""6591312"", ""469509327"", ""374712154""]",2,10,12
909990571,6,54.0,-0.13794628779093424,2033985.0,5,0.5,"[""charliehebdo-all-rnr-threads"", ""sydneysiege-all-rnr-threads""]","[""48956231"", ""27831488"", ""243318995"", ""6591312"", ""174253648""]",3,3,6
142088047,16,123.625,-0.3243664987385273,12677168.0,5,0.0625,"[""charliehebdo-all-rnr-threads"", ""ferguson-all-rnr-threads""]","[""382376904"", ""780024367"", ""31135856"", ""130468394"", ""6591312""]",1,15,16
2799588421,18,120.77777777777777,-0.7047633296913571,2011200.0,8,0.3888888888888889,"[""charliehebdo-all-rnr-threads"", ""sydneysiege-all-rnr-threads""]","[""558040899"", ""49444292"", ""14138785"", ""22443725"", ""216299334"", ""501768982"", ""6591312"", ""2768501""]",7,11,18
47694347,23,98.34782608695652,-0.16002616934154346,13049449.0,7,0.782608695652174,"[""charliehebdo-all-rnr-threads"", ""sydneysiege-all-rnr-threads"", ""ferguson-all-rnr-threads""]","[""352036858"", ""254873869"", ""135604500"", ""2163076560"", ""495464885"", ""1716581"", ""6591312""]",18,5,23
87818409,48,113.27083333333333,-0.20689736430843672,13425464.0,457,0.25,"[""charliehebdo-all-rnr-threads"", ""germanwings-crash-all-rnr-threads"", ""ottawashooting-all-rnr-threads"", ""sydneysiege-all-rnr-threads""]","[""29664163"", ""856490520"", ""45326924"", ""264103932"", ""2236525585"", ""482589728"", ""109052230"", ""54817933"", ""753541968"", ""2449982929"", ""1503342588"", ""2332564189"", ""2842411782"", ""57271536"", ""2654277144"", ""51524529"", ""1407027576"", ""2848284893"", ""254809254"", ""27839828"", ""168828976"", ""2931725224"", ""1612388714"", ""59503113"", ""25268948"", ""388768535"", ""288545796"", ""267906861"", ""14499517"", ""279533332"", ""19376655"", ""293167675"", ""404932389"", ""51503938"", ""334752709"", ""28504076"", ""2434772232"", ""326089485"", ""23262069"", ""17818738"", ""547664351"", ""2487893052"", ""14839184"", ""570698436"", ""1323040010"", ""854659794"", ""196067428"", ""873168950"", ""479297318"", ""2668286088"", ""14315937"", ""2933943867"", ""191231615"", ""77922480"", ""1475561804"", ""204987610"", ""2560148358"", ""2485755817"", ""295781384"", ""929662333"", ""25054772"", ""29209261"", ""228417172"", ""196385864"", ""126038431"", ""2815093989"", ""2457759927"", ""90181058"", ""2840119379"", ""199931418"", ""261522787"", ""126042897"", ""56917394"", ""389491359"", ""60848534"", ""829758228"", ""150708769"", ""1713308120"", ""53337090"", ""2312163025"", ""1008816553"", ""376480596"", ""2967651153"", ""2147851824"", ""112009736"", ""227441287"", ""306275473"", ""2951665768"", ""125323374"", ""2891662632"", ""1931711646"", ""2582447855"", ""141508403"", ""17970914"", ""256358298"", ""2965768288"", ""2464274870"", ""348007190"", ""561427595"", ""16216894"", ""19111502"", ""387394180"", ""131921651"", ""1425949819"", ""2460352694"", ""2435278976"", ""1284917760"", ""14599507"", ""42386100"", ""979740954"", ""2888160041"", ""1528260655"", ""542385412"", ""1289251928"", ""1420323636"", ""1450791602"", ""1270747092"", ""2230031627"", ""22414818"", ""19906293"", ""1324362289"", ""2856401319"", ""221876750"", ""1150947134"", ""257923603"", ""2966500822"", ""1561720554"", ""2531955904"", ""920930858"", ""220091399"", ""2389345501"", ""302498850"", ""2853432347"", ""2961974674"", ""2956623902"", ""261093402"", ""2892439622"", ""2479471925"", ""1542767918"", ""22603110"", ""370689583"", ""551551599"", ""15557891"", ""2812004227"", ""304884944"", ""145923925"", ""322703767"", ""193927117"", ""273833877"", ""176778438"", ""176899041"", ""2586362810"", ""112838253"", ""1326863738"", ""365192857"", ""984662900"", ""305945752"", ""212717146"", ""2714511624"", ""2726126381"", ""1680403004"", ""2830477139"", ""14851837"", ""610972228"", ""248784419"", ""354917016"", ""2768731096"", ""296625287"", ""2919370809"", ""89303569"", ""144204669"", ""732568674"", ""1320144511"", ""2886586060"", ""342778302"", ""270561214"", ""149647740"", ""875931204"", ""1641042648"", ""518908974"", ""372488770"", ""363723508"", ""315244740"", ""1114675118"", ""63384915"", ""124728739"", ""1672770535"", ""264109963"", ""51806835"", ""167335325"", ""1666280082"", ""14843344"", ""2165235626"", ""1552702490"", ""204867882"", ""411297700"", ""2923845568"", ""609219686"", ""2464502209"", ""372212654"", ""256552585"", ""516898722"", ""600873514"", ""128917051"", ""1252741896"", ""491809032"", ""70352340"", ""20091891"", ""2734020596"", ""20045072"", ""481287686"", ""49102516"", ""210428830"", ""57260327"", ""153698624"", ""305035263"", ""1199119530"", ""2263434437"", ""166240890"", ""2859968618"", ""35793326"", ""148539057"", ""292424255"", ""155307961"", ""2174831179"", ""325234656"", ""2771542204"", ""156214046"", ""2780648743"", ""2937525600"", ""1538522869"", ""603758918"", ""2496651422"", ""165335229"", ""1728874453"", ""1215763321"", ""20318509"", ""422543588"", ""74520735"", ""1652769782"", ""2214510864"", ""351603593"", ""476385756"", ""2961649574"", ""1537590361"", ""137451762"", ""127946711"", ""2185117388"", ""837729878"", ""506198762"", ""43462866"", ""18660415"", ""14506760"", ""2842666967"", ""34408874"", ""853600206"", ""317061389"", ""233369352"", ""21744712"", ""713339565"", ""34263502"", ""1919496792"", ""35345306"", ""62871990"", ""121884948"", ""84081044"", ""946985178"", ""849824503"", ""19103793"", ""393745256"", ""2459958124"", ""592862818"", ""2609863675"", ""43895327"", ""436029388"", ""56114051"", ""546353513"", ""19944714"", ""2939147302"", ""531134841"", ""41366749"", ""469321753"", ""2882736641"", ""1305183318"", ""2461166612"", ""2705641155"", ""1632334700"", ""140157926"", ""2875761863"", ""478402262"", ""1100855744"", ""314674591"", ""214652121"", ""19042727"", ""547651065"", ""360784658"", ""376401206"", ""225937279"", ""542705314"", ""82639973"", ""789754716"", ""517656712"", ""19917147"", ""789396782"", ""493136102"", ""1518883244"", ""2882214527"", ""61305883"", ""572626879"", ""520011678"", ""305803563"", ""14441236"", ""1259945892"", ""249895896"", ""970947344"", ""369049413"", ""333071309"", ""46305181"", ""796740463"", ""58926990"", ""546381549"", ""243881533"", ""1148139996"", ""221310328"", ""190419437"", ""28292289"", ""3087276875"", ""868093868"", ""317723997"", ""2477686087"", ""75277106"", ""2813616447"", ""19921624"", ""257810638"", ""52860010"", ""2868283709"", ""12984"", ""249221120"", ""128544519"", ""103350059"", ""2771482487"", ""131158720"", ""435101906"", ""1784420365"", ""2381434507"", ""1656511472"", ""316017628"", ""61710880"", ""1014842906"", ""314324131"", ""337275831"", ""2921887150"", ""272418128"", ""250719704"", ""1956444433"", ""52495721"", ""473334881"", ""373157748"", ""30205212"", ""193632283"", ""2604216446"", ""113513587"", ""114962484"", ""2945865278"", ""607558024"", ""87126078"", ""3103740254"", ""36988181"", ""1085149063"", ""23196051"", ""1531290481"", ""29784999"", ""1020660620"", ""1348798826"", ""1572382556"", ""2291789575"", ""2681791235"", ""285269771"", ""2345950056"", ""2459278543"", ""1705444921"", ""254953689"", ""2220149282"", ""2700382110"", ""1389219462"", ""575839267"", ""2226815427"", ""212007177"", ""19812174"", ""724192020"", ""205766400"", ""24707919"", ""2969597465"", ""2245136625"", ""2828761788"", ""2161868057"", ""186651730"", ""221895330"", ""501381054"", ""160346049"", ""585024943"", ""20372829"", ""378293481"", ""45875630"", ""2821577173"", ""2496980478"", ""1358247523"", ""1436190714"", ""865283610"", ""204966358"", ""2698775634"", ""415196848"", ""484595690"", ""47095857"", ""129715930"", ""620367859"", ""2308597885"", ""358228162"", ""2959360301"", ""239019535"", ""1467424207"", ""2459467651"", ""22903724"", ""259197924"", ""467560802"", ""37095297"", ""272307823"", ""623180471"", ""12029502"", ""285898481"", ""106086641"", ""283895307"", ""75522401"", ""551131903"", ""36648285"", ""94323249"", ""63643079"", ""257943213"", ""90917823"", ""2788722909"", ""139659437"", ""44968373"", ""123416335"", ""2548063214"", ""2885348567"", ""18345755"", ""556196143"", ""33002429"", ""2966544387"", ""60862254"", ""231960651"", ""2687790696"", ""361846053"", ""2949326851"", ""2884168344"", ""1215445963"", ""439538662""]",12,36,48
868112707,25,118.76,-0.3752140736579895,2196406.0,257,0.56,"[""charliehebdo-all-rnr-threads"", ""sydneysiege-all-rnr-threads""]","[""16072089"", ""29524851"", ""413956149"", ""130601397"", ""526226529"", ""101681864"", ""612544994"", ""14809759"", ""2578182110"", ""2271909774"", ""45630580"", ""359013156"", ""362659950"", ""23189508"", ""28738491"", ""44597739"", ""160190079"", ""54194375"", ""628038157"", ""889893793"", ""498313904"", ""34408874"", ""49080531"", ""1089125664"", ""461344573"", ""810240614"", ""72588786"", ""2657844114"", ""608074953"", ""37513081"", ""2607189631"", ""75238099"", ""99618827"", ""307557334"", ""23153001"", ""176001756"", ""400621700"", ""22336312"", ""444830868"", ""1638408847"", ""15868782"", ""18461863"", ""9722742"", ""1259842226"", ""102284233"", ""2749296652"", ""16415799"", ""420447193"", ""1522169617"", ""188228623"", ""102579213"", ""1385677068"", ""305740111"", ""312705978"", ""59747689"", ""154238955"", ""33300564"", ""144553035"", ""1029179862"", ""60477982"", ""69277734"", ""1474332679"", ""54291658"", ""1324697617"", ""92706664"", ""34126592"", ""2324261167"", ""277065916"", ""123628014"", ""2504146428"", ""1375772810"", ""122115502"", ""153119220"", ""343964086"", ""178718143"", ""1343507365"", ""2474960144"", ""2894550962"", ""443036898"", ""18550598"", ""494512103"", ""500063944"", ""280473066"", ""208617216"", ""25389149"", ""1025399466"", ""244310651"", ""240846894"", ""29406737"", ""29616541"", ""25206663"", ""2426108804"", ""241567641"", ""191231615"", ""230184592"", ""306925261"", ""2451844692"", ""185287105"", ""418243137"", ""2690842873"", ""19750998"", ""274639464"", ""48076246"", ""379401533"", ""96778649"", ""168592906"", ""136773304"", ""173925687"", ""103079768"", ""14322902"", ""427783053"", ""457437029"", ""435290720"", ""1100855744"", ""125271017"", ""148063984"", ""215990333"", ""185992652"", ""329353102"", ""2563950688"", ""1442972869"", ""94360596"", ""23813725"", ""142236260"", ""16261635"", ""153132339"", ""1926877501"", ""2862349896"", ""97003915"", ""122934798"", ""1092729763"", ""202568095"", ""93055009"", ""381399271"", ""20421004"", ""370138478"", ""47681231"", ""18379848"", ""1030435626"", ""1010631494"", ""22413393"", ""2784290526"", ""60380920"", ""976527853"", ""531740899"", ""495085031"", ""408477161"", ""1731120762"", ""111749127"", ""779785580"", ""2953722153"", ""104966264"", ""43835707"", ""1314798422"", ""135467607"", ""57787295"", ""143136091"", ""377912738"", ""2832479888"", ""152407619"", ""2859958581"", ""81632884"", ""53350694"", ""55572666"", ""19016414"", ""130945204"", ""2464502209"", ""22341525"", ""532059203"", ""335323028"", ""2360990340"", ""202054350"", ""11051392"", ""2324410026"", ""23490130"", ""13108822"", ""1539267602"", ""54727574"", ""255180467"", ""703412659"", ""2901093911"", ""74490017"", ""37179759"", ""42971403"", ""22159616"", ""44400851"", ""1388108324"", ""437673995"", ""28838984"", ""889742886"", ""2484630409"", ""112463393"", ""296228025"", ""14784478"", ""51850888"", ""494822288"", ""725595571"", ""99847705"", ""521302666"", ""72194597"", ""733249254"", ""1676092712"", ""278059346"", ""156357436"", ""508278502"", ""85583894"", ""202740010"", ""2951439239"", ""17718621"", ""2163450864"", ""234695542"", ""28855043"", ""223183551"", ""148142945"", ""612493003"", ""79260733"", ""119068614"", ""222737495"", ""423941830"", ""1819391"", ""102692275"", ""2900148061"", ""150838582"", ""321402892"", ""295961078"", ""2780648743"", ""2234329771"", ""404353699"", ""32810337"", ""174365756"", ""16334480"", ""577943624"", ""434988195"", ""17893690"", ""19775606"", ""825402174"", ""361135947"", ""122294990"", ""1157743440"", ""67013524"", ""85761585"", ""288791109"", ""195059447"", ""250684398"", ""93817246"", ""1637725969"", ""1044160339"", ""113755825"", ""1656511472"", ""268821106"", ""2194468591"", ""31882493"", ""27201190"", ""258730076"", ""1559350598"", ""351433890"", ""1653834024""]",14,11,25
254873869,18,98.5,-0.24190927876366508,12670484.0,102,0.2222222222222222,"[""charliehebdo-all-rnr-threads"", ""sydneysiege-all-rnr-threads"", ""ferguson-all-rnr-threads""]","[""27966935"", ""1884326047"", ""246427738"", ""22424311"", ""728542435"", ""370274402"", ""52151517"", ""776413867"", ""19331819"", ""1126373551"", ""455639423"", ""101290258"", ""635426196"", ""481627671"", ""344387373"", ""508947078"", ""254873869"", ""296313827"", ""28557245"", ""228332540"", ""134617566"", ""1047537240"", ""443573208"", ""268662889"", ""226440623"", ""635338460"", ""177661775"", ""18945071"", ""135721233"", ""607656892"", ""73774016"", ""2537547075"", ""30489994"", ""1948147716"", ""64050202"", ""37002670"", ""73431630"", ""183474140"", ""873682453"", ""330116504"", ""38975663"", ""414869332"", ""16706677"", ""405023264"", ""20269240"", ""115912596"", ""2530186452"", ""630844174"", ""238542924"", ""16261116"", ""64689870"", ""2308059967"", ""354347089"", ""565936487"", ""2527213992"", ""48883571"", ""269016791"", ""546247827"", ""2288746260"", ""265660148"", ""758063641"", ""2604020096"", ""50221275"", ""48640401"", ""2462584339"", ""500868136"", ""2927507078"", ""467207917"", ""140315951"", ""64995587"", ""763723500"", ""518266498"", ""27482327"", ""75125737"", ""220812123"", ""878655300"", ""1492456590"", ""274132729"", ""41327145"", ""42791906"", ""546170976"", ""2225018173"", ""1913055090"", ""184570425"", ""269983326"", ""207548791"", ""26960113"", ""65874258"", ""71500077"", ""602767623"", ""167770844"", ""1374510187"", ""10482452"", ""47694347"", ""12531062"", ""56955600"", ""21479865"", ""244200716"", ""263691341"", ""28314327"", ""1421542783"", ""118613799""]",4,14,18
140980387,3,135.33333333333334,-0.7159423828125,2030403.0,2,1.0,"[""charliehebdo-all-rnr-threads"", ""sydneysiege-all-rnr-threads""]","[""2799960092"", ""5402612""]",3,0,3
368224044,5,86.6,-0.48051656484603883,5614643.0,3,0.8,"[""charliehebdo-all-rnr-threads"", ""putinmissing-all-rnr-threads""]","[""833057665"", ""793879086"", ""5402612""]",4,1,5
392958028,11,70.72727272727273,-0.19378464330326428,6793578.0,3,0.18181818181818182,"[""charliehebdo-all-rnr-threads"", ""ottawashooting-all-rnr-threads""]","[""407779393"", ""64643056"", ""5402612""]",2,9,11
2690842873,11,115.18181818181819,-0.5012165741486982,6575600.0,5,0.8181818181818182,"[""charliehebdo-all-rnr-threads"", ""germanwings-crash-all-rnr-threads""]","[""14173315"", ""868112707"", ""51241574"", ""380648579"", ""1367531""]",9,2,11
388156578,5,92.8,-0.5492361426353455,1992068.0,2,0.2,"[""charliehebdo-all-rnr-threads"", ""sydneysiege-all-rnr-threads""]","[""87416722"", ""58467371""]",1,4,5
23231169,3,100.0,-0.2594388922055562,2148416.0,1,1.0,"[""charliehebdo-all-rnr-threads"", ""sydneysiege-all-rnr-threads""]","[""87416722""]",3,0,3
16343974,35,121.51428571428572,-0.2977531620434352,13182841.0,377,0.37142857142857144,"[""charliehebdo-all-rnr-threads"", ""germanwings-crash-all-rnr-threads"", ""ottawashooting-all-rnr-threads"", ""sydneysiege-all-rnr-threads""]","[""60003258"", ""18565227"", ""2753139956"", ""598505996"", ""178330167"", ""1503342588"", ""2601925231"", ""853684008"", ""51524529"", ""2814530771"", ""441206039"", ""38551917"", ""2818634945"", ""94489129"", ""160327704"", ""384578824"", ""147181485"", ""564810855"", ""2755751021"", ""17408916"", ""37181214"", ""26994823"", ""388768535"", ""310150964"", ""49243929"", ""1570357327"", ""2966748485"", ""72227386"", ""183994113"", ""290790829"", ""21027167"", ""2683311420"", ""535811330"", ""821017873"", ""77025731"", ""508166970"", ""258991152"", ""2167816718"", ""78008029"", ""413649532"", ""2933943867"", ""2845925284"", ""193963770"", ""2584501496"", ""983701297"", ""361247001"", ""68772425"", ""153132339"", ""20133043"", ""279157541"", ""2922814893"", ""62155958"", ""2649991"", ""45307981"", ""303647815"", ""2843667729"", ""1130186383"", ""594976909"", ""25687273"", ""24417223"", ""47617232"", ""24136030"", ""784740127"", ""30827048"", ""2813305829"", ""2372775392"", ""2480055302"", ""334282215"", ""2626274968"", ""2888198099"", ""1851815635"", ""318044919"", ""16355445"", ""168815068"", ""52378463"", ""16925977"", ""27618518"", ""499756092"", ""113087476"", ""193397506"", ""1569448915"", ""966916507"", ""25341775"", ""17918114"", ""24923175"", ""180961394"", ""361725993"", ""1020681224"", ""1560951926"", ""130440304"", ""2828640809"", ""390421144"", ""562398035"", ""709077126"", ""1350371712"", ""2329541547"", ""88851341"", ""2654308451"", ""305572105"", ""2182624271"", ""83032558"", ""302590040"", ""584553605"", ""72588786"", ""123622674"", ""2533214386"", ""242738826"", ""1342067257"", ""445791130"", ""39646031"", ""551551599"", ""219467652"", ""2782303899"", ""40043449"", ""178359421"", ""195036383"", ""2869411497"", ""2457522827"", ""49383029"", ""2828200743"", ""338773489"", ""2326962189"", ""274187885"", ""25206663"", ""1862151403"", ""2587069633"", ""244032537"", ""286888215"", ""2720"", ""383906888"", ""2826421512"", ""1012085413"", ""65836867"", ""27180727"", ""283278170"", ""1435073588"", ""413799328"", ""300136686"", ""496762984"", ""416844269"", ""1941279354"", ""285706984"", ""2354583918"", ""19933791"", ""216582313"", ""97519068"", ""101791724"", ""953169685"", ""84292870"", ""76872101"", ""2175003230"", ""21794030"", ""547137296"", ""381212910"", ""481287686"", ""708427715"", ""223382695"", ""2203942282"", ""383453520"", ""1495284030"", ""125025920"", ""15427912"", ""9620482"", ""400849604"", ""2834418663"", ""319778079"", ""2374254228"", ""2471529011"", ""142838995"", ""223183551"", ""2771542204"", ""181380156"", ""458198372"", ""436263442"", ""25852384"", ""87081989"", ""1728874453"", ""2196140943"", ""277678549"", ""1397423635"", ""2458711182"", ""53523272"", ""17453775"", ""454158455"", ""2863817435"", ""543362261"", ""372464674"", ""2967147467"", ""17626165"", ""1729218318"", ""189118361"", ""2883877395"", ""68295834"", ""251533493"", ""1142891780"", ""19666838"", ""2864105789"", ""283575621"", ""1454249192"", ""1097630209"", ""17163691"", ""326873211"", ""37963405"", ""443899044"", ""1177491776"", ""2759203588"", ""2734291692"", ""19378696"", ""466465895"", ""2838141435"", ""30233384"", ""121711323"", ""2855561001"", ""105497418"", ""383506589"", ""361062854"", ""1198971475"", ""35889272"", ""286074326"", ""2875761863"", ""146794529"", ""319928236"", ""508020749"", ""811455733"", ""443945199"", ""574031250"", ""223911503"", ""2427186176"", ""564805917"", ""59729567"", ""287217860"", ""66592224"", ""212992600"", ""997345080"", ""1857091140"", ""405194953"", ""430101218"", ""76301615"", ""82054005"", ""372540460"", ""182006778"", ""102238015"", ""2728348725"", ""562236448"", ""59505872"", ""19592715"", ""398974774"", ""54172127"", ""2770006658"", ""487876567"", ""35051304"", ""108003115"", ""1479983648"", ""2646413934"", ""249869615"", ""217330049"", ""21572910"", ""546381549"", ""1145837502"", ""341089607"", ""405174559"", ""2370908751"", ""14473462"", ""178731620"", ""14070460"", ""2661038208"", ""219290582"", ""1321255268"", ""237674151"", ""630458713"", ""2605661089"", ""1267260163"", ""101445204"", ""379773568"", ""225072304"", ""476764926"", ""49324978"", ""36972878"", ""104114005"", ""15064815"", ""1637725969"", ""221711007"", ""22159006"", ""80651142"", ""195287600"", ""86683590"", ""235887538"", ""264125211"", ""2153574327"", ""1080276308"", ""416316757"", ""2940238558"", ""2441634745"", ""357081216"", ""15421689"", ""2484304264"", ""29784999"", ""270328651"", ""1348798826"", ""2541012268"", ""2500602652"", ""262878521"", ""1412522216"", ""351889336"", ""29588794"", ""285269771"", ""240786249"", ""55831225"", ""2459278543"", ""620979076"", ""394614759"", ""25472797"", ""21181417"", ""20301504"", ""330990433"", ""573773030"", ""224564319"", ""2902739806"", ""50092621"", ""2269619268"", ""2612152058"", ""885667550"", ""274017531"", ""562395756"", ""520401044"", ""393136967"", ""1854935118"", ""1657588597"", ""182438955"", ""2757723933"", ""2748656645"", ""2882796675"", ""1064312154"", ""160346049"", ""61548337"", ""150650920"", ""97863902"", ""2641657869"", ""458500208"", ""41930798"", ""16132734"", ""2354402125"", ""17614860"", ""587004727"", ""54727574"", ""1196986207"", ""585767199"", ""975212808"", ""280915300"", ""72383461"", ""2487719486"", ""39287768"", ""28971043"", ""823115"", ""1523383896"", ""113806395"", ""2962064392"", ""335058231"", ""1309728793"", ""562295945"", ""1660185151"", ""1866480170"", ""178888741"", ""2900148061"", ""1673784182"", ""139659437"", ""252728132"", ""23110102"", ""2885348567"", ""19018483"", ""2837858684"", ""571241678"", ""51109281"", ""2774516734"", ""864927037"", ""359125133"", ""42971403""]",13,22,35
383506589,2,140.0,-0.6908586621284485,1978969.0,2,1.0,"[""charliehebdo-all-rnr-threads"", ""sydneysiege-all-rnr-threads""]","[""20639175"", ""16343974""]",2,0,2
1038235795,27,48.629629629629626,-0.21812388190516718,6754974.0,14,0.37037037037037035,"[""charliehebdo-all-rnr-threads"", ""ottawashooting-all-rnr-threads"", ""sydneysiege-all-rnr-threads""]","[""21744712"", ""21749564"", ""15348883"", ""18101696"", ""25777812"", ""16834659"", ""3108351"", ""37881687"", ""64643056"", ""255753616"", ""22443725"", ""239964092"", ""258627226"", ""5402612""]",10,17,27
17316885,4,116.5,-0.10886210203170776,12509930.0,8,0.25,"[""charliehebdo-all-rnr-threads"", ""ferguson-all-rnr-threads""]","[""2874817799"", ""18963809"", ""490810700"", ""1994321"", ""15319103"", ""76755707"", ""590056506"", ""80130467""]",1,3,4
160547588,5,127.2,-0.25833491086959837,2210933.0,5,0.6,"[""charliehebdo-all-rnr-threads"", ""sydneysiege-all-rnr-threads""]","[""2434191967"", ""17152053"", ""1994321"", ""7587032"", ""428333""]",3,2,5
30657692,4,112.75,-0.5503308475017548,2009828.0,4,0.25,"[""charliehebdo-all-rnr-threads"", ""sydneysiege-all-rnr-threads""]","[""162304163"", ""55911799"", ""17537467"", ""7587032""]",1,3,4
72588786,16,101.875,-0.14314990118145943,13207283.0,14,0.5625,"[""charliehebdo-all-rnr-threads"", ""germanwings-crash-all-rnr-threads"", ""sydneysiege-all-rnr-threads"", ""putinmissing-all-rnr-threads"", ""ottawashooting-all-rnr-threads""]","[""122650202"", ""16973333"", ""868112707"", ""7587032"", ""2280470022"", ""380648579"", ""288755234"", ""87416722"", ""29465136"", ""25516222"", ""292777349"", ""9651232"", ""16343974"", ""283640557""]",9,7,16
364538685,2,38.5,0.07455527782440186,2006806.0,2,1.0,"[""charliehebdo-all-rnr-threads"", ""sydneysiege-all-rnr-threads""]","[""283640557"", ""954124423""]",2,0,2
2097571,50,130.24000000000004,-0.45597649693489073,19353763.0,533,0.44,"[""charliehebdo-all-rnr-threads"", ""germanwings-crash-all-rnr-threads"", ""sydneysiege-all-rnr-threads"", ""ottawashooting-all-rnr-threads"", ""ferguson-all-rnr-threads""]","[""24705078"", ""33857678"", ""99565215"", ""2226887111"", ""268866184"", ""1571338244"", ""1503342588"", ""2377159461"", ""1007221920"", ""39432465"", ""106326344"", ""2876345884"", ""259430544"", ""74477395"", ""1407027576"", ""2493142851"", ""563642632"", ""97639418"", ""58202652"", ""221985881"", ""139156158"", ""1885859976"", ""450991824"", ""2408660523"", ""140058214"", ""81216823"", ""2582649564"", ""147844528"", ""451980711"", ""313049114"", ""309401664"", ""2438901478"", ""2465122356"", ""27542588"", ""19329457"", ""834358303"", ""1676408161"", ""32829581"", ""16574787"", ""2208746299"", ""3068564240"", ""882053083"", ""2580641739"", ""2847087043"", ""2596628207"", ""712468253"", ""1932452484"", ""111268212"", ""21878262"", ""322434618"", ""570620958"", ""92940347"", ""1373637078"", ""2527375494"", ""2582427774"", ""2344304872"", ""2946026969"", ""45556215"", ""2840527639"", ""560501622"", ""356235103"", ""929662333"", ""495026442"", ""379137307"", ""103720918"", ""2815093989"", ""999806958"", ""90888044"", ""81032062"", ""337063382"", ""2607703608"", ""100690218"", ""15740357"", ""1371896744"", ""914056153"", ""2922814893"", ""62155958"", ""188289139"", ""1349360444"", ""59418279"", ""2962357869"", ""985580779"", ""2786765641"", ""2862936518"", ""747239540"", ""29769901"", ""479603297"", ""7137132"", ""92602577"", ""2155433046"", ""238031910"", ""372095233"", ""445483825"", ""17228176"", ""938517404"", ""158261628"", ""196746305"", ""93000133"", ""2774862714"", ""2279551026"", ""2828201097"", ""2394746518"", ""2231713834"", ""54882415"", ""96966077"", ""302425104"", ""2687742156"", ""2945871636"", ""180808943"", ""113087476"", ""3005762823"", ""2841546336"", ""465515000"", ""2769965322"", ""1678514384"", ""484798027"", ""468588961"", ""2943136821"", ""2404454630"", ""16373544"", ""1328181356"", ""1020681224"", ""1036747494"", ""445362852"", ""2157633218"", ""139921744"", ""21060878"", ""219465181"", ""108658230"", ""1134734004"", ""22518101"", ""31478813"", ""2231330071"", ""2892230170"", ""1693369224"", ""403248070"", ""2550296946"", ""2891842919"", ""408930110"", ""313522982"", ""1277563380"", ""11462742"", ""50014086"", ""2785975828"", ""2572794365"", ""257175583"", ""2856401319"", ""42338948"", ""111660074"", ""85585318"", ""1471168098"", ""287936121"", ""868157413"", ""302498850"", ""1031944087"", ""130598585"", ""19360575"", ""105169556"", ""2921805299"", ""852641460"", ""192896660"", ""939765391"", ""2476021071"", ""36033359"", ""391220786"", ""1423233282"", ""51597693"", ""2935809620"", ""479062189"", ""10524562"", ""393650551"", ""2755587187"", ""195036383"", ""2231300988"", ""2536517684"", ""205701512"", ""2565324261"", ""123628014"", ""255719937"", ""2733119619"", ""922859155"", ""377585860"", ""184280521"", ""728693527"", ""179607304"", ""269121169"", ""178205810"", ""2253798422"", ""1289263508"", ""84115683"", ""169103291"", ""459799727"", ""14183408"", ""552117307"", ""2244290414"", ""15559808"", ""2941036010"", ""230401252"", ""2890148002"", ""867326186"", ""354917016"", ""2171201828"", ""393752367"", ""830239452"", ""243846988"", ""46486398"", ""376876087"", ""2283416288"", ""1098782046"", ""32713767"", ""233225182"", ""62422838"", ""1062791150"", ""386282837"", ""501715190"", ""227629701"", ""79652576"", ""2898545532"", ""367810627"", ""2406682561"", ""586306101"", ""2936694741"", ""2444982048"", ""271002405"", ""276489319"", ""2712645206"", ""79860805"", ""605401945"", ""2557039222"", ""2168899640"", ""3032779234"", ""16408867"", ""2945576798"", ""2608956567"", ""289732005"", ""128917051"", ""2996770959"", ""1949828624"", ""2954793446"", ""2097571"", ""246799077"", ""302970029"", ""2768705528"", ""223382695"", ""2953266849"", ""197489159"", ""1495284030"", ""29515703"", ""2788944340"", ""2474915411"", ""291648228"", ""353147411"", ""2952261055"", ""38597062"", ""469148643"", ""1687518794"", ""737695472"", ""2699389549"", ""2705441792"", ""97573405"", ""951820453"", ""295058041"", ""2349210331"", ""2780648743"", ""2393539874"", ""903061315"", ""2307632874"", ""34156896"", ""161063168"", ""2756896089"", ""33626482"", ""2415809562"", ""1857982483"", ""36621824"", ""2370914096"", ""1130962261"", ""82660556"", ""244316090"", ""102151924"", ""45184962"", ""1952614448"", ""17639973"", ""591948005"", ""454761493"", ""63208520"", ""2848372747"", ""81965147"", ""2790346046"", ""1177749511"", ""420086613"", ""2323317829"", ""176315353"", ""2400408805"", ""2685086010"", ""1329199266"", ""66252879"", ""2584589105"", ""1935743647"", ""1123137259"", ""548073137"", ""20275809"", ""2420804794"", ""1546510892"", ""2762702188"", ""1539357480"", ""160336748"", ""240006049"", ""161026267"", ""2598250667"", ""2545851438"", ""2782318842"", ""529206033"", ""2198241673"", ""43050075"", ""84269667"", ""249228197"", ""65607742"", ""308174015"", ""2862196608"", ""923278088"", ""1967437080"", ""1945500001"", ""34600532"", ""1267436599"", ""25430337"", ""324492900"", ""447809119"", ""1639395961"", ""971611794"", ""2940041869"", ""330585234"", ""2508418672"", ""973646372"", ""1669391844"", ""101703108"", ""2852446116"", ""325090620"", ""54024434"", ""36442545"", ""538601381"", ""213785395"", ""615574745"", ""1100855744"", ""414650783"", ""1372692300"", ""359881870"", ""847315447"", ""59379065"", ""2294804946"", ""139849976"", ""2438787890"", ""1030435626"", ""284725682"", ""2354247799"", ""517656712"", ""88953653"", ""356846852"", ""594089874"", ""277464708"", ""440188066"", ""1047382416"", ""19922927"", ""1518883244"", ""100687954"", ""1004906407"", ""34853885"", ""27292034"", ""2891832976"", ""516531920"", ""2869304847"", ""1948811262"", ""18975311"", ""458085775"", ""33332251"", ""424342342"", ""6975782"", ""2684746102"", ""211944197"", ""472400004"", ""2724171849"", ""28046447"", ""389730216"", ""2453850531"", ""2495801377"", ""2415037446"", ""1726410222"", ""1198580988"", ""222195944"", ""503203687"", ""28292289"", ""132613108"", ""115434601"", ""358265713"", ""489103197"", ""14608411"", ""2284066573"", ""89391855"", ""420108261"", ""2800687803"", ""339113547"", ""16186635"", ""2783024943"", ""254536058"", ""328212690"", ""11267182"", ""2163097605"", ""2917387871"", ""569525110"", ""1243916652"", ""308249265"", ""2930855725"", ""1849407440"", ""21899941"", ""231430900"", ""1637725969"", ""25782006"", ""27004448"", ""501877020"", ""49329424"", ""1961752514"", ""920700558"", ""2723735572"", ""1080276308"", ""970088376"", ""287818006"", ""2251173986"", ""29238700"", ""471635296"", ""1695502676"", ""67148793"", ""270689893"", ""2363961183"", ""126223865"", ""19508842"", ""2945865278"", ""860616002"", ""746980435"", ""63780158"", ""44839384"", ""1085149063"", ""2919525786"", ""1925315930"", ""338829489"", ""417437781"", ""21330040"", ""1348798826"", ""2421592508"", ""2579312316"", ""64993534"", ""1419552835"", ""579306145"", ""535793481"", ""149208338"", ""1234987687"", ""427682076"", ""2713629013"", ""317463226"", ""607656892"", ""370463360"", ""1390652294"", ""2965096007"", ""23764053"", ""2785148344"", ""2727678915"", ""2344267592"", ""57852436"", ""2789454962"", ""946599224"", ""2656024189"", ""2881719169"", ""28103908"", ""371971651"", ""598736463"", ""446724878"", ""127819588"", ""626748749"", ""460862690"", ""287183523"", ""30094661"", ""750796585"", ""336732239"", ""56777504"", ""2440172357"", ""2824442646"", ""192659906"", ""2699921479"", ""2902946913"", ""179294405"", ""187993452"", ""282915121"", ""372875229"", ""799153915"", ""44774795"", ""1919930370"", ""1398673123"", ""346257734"", ""41523333"", ""714819229"", ""245464012"", ""17682422"", ""1589789317"", ""33545031"", ""73836614"", ""31014905"", ""302946952"", ""326878755"", ""2970740644"", ""2853256766"", ""71989913"", ""1346712139"", ""394050907"", ""317279748"", ""179803139"", ""172772700"", ""2806168694"", ""15382667"", ""2617194469"", ""79802631"", ""38609923"", ""221373945"", ""245039108"", ""1910381048"", ""1062498002"", ""2296443458"", ""50306637"", ""206287437"", ""1042113978"", ""605265426"", ""43726554"", ""2870908575"", ""2744496728"", ""37191569"", ""18892635""]",22,28,50
468588961,6,22.666666666666668,-0.0655915339787801,6740632.0,3,0.6666666666666666,"[""charliehebdo-all-rnr-threads"", ""germanwings-crash-all-rnr-threads""]","[""7744592"", ""2097571"", ""428333""]",4,2,6
15438913,30,118.9,-0.26234970092773435,6569338.0,291,0.43333333333333335,"[""charliehebdo-all-rnr-threads"", ""putinmissing-all-rnr-threads"", ""germanwings-crash-all-rnr-threads""]","[""245051131"", ""244033117"", ""1879283827"", ""114036618"", ""466442413"", ""1126782312"", ""2149722708"", ""2901964056"", ""2208892653"", ""189812607"", ""2237207690"", ""624726246"", ""2832122225"", ""241703966"", ""411098670"", ""1369778664"", ""964093010"", ""858704280"", ""464857068"", ""2301041090"", ""890578536"", ""1530805111"", ""49715388"", ""241721501"", ""333550143"", ""122262732"", ""463308992"", ""1230871339"", ""2170209896"", ""1198993620"", ""18142983"", ""1503342588"", ""181409722"", ""862218259"", ""2744419190"", ""18945060"", ""2464329458"", ""2898115168"", ""2635923037"", ""481295316"", ""2323317829"", ""422643002"", ""475124503"", ""78898625"", ""1418680116"", ""120788445"", ""2827604185"", ""499094647"", ""2945865278"", ""843565644"", ""540266049"", ""486776302"", ""2659646245"", ""137873483"", ""17984709"", ""167336760"", ""66696272"", ""310721799"", ""2696720661"", ""44299861"", ""557074171"", ""96540459"", ""20883153"", ""492529570"", ""57023952"", ""151651683"", ""216271468"", ""926128567"", ""2586531863"", ""178359421"", ""967275854"", ""1177491776"", ""1348798826"", ""310016294"", ""459557733"", ""324908191"", ""1193329008"", ""221728295"", ""1851878028"", ""70593494"", ""2962013132"", ""1893016729"", ""1003989258"", ""303691467"", ""243507410"", ""45568891"", ""505309269"", ""355342984"", ""30985485"", ""95445890"", ""551234726"", ""861763958"", ""319820407"", ""278466175"", ""1078601755"", ""769455"", ""570620958"", ""1969905162"", ""949918554"", ""1022707310"", ""30719601"", ""2858679020"", ""27347119"", ""2933943867"", ""23183433"", ""454127373"", ""898193300"", ""88851341"", ""560501622"", ""438601264"", ""20751477"", ""2838188061"", ""2271884777"", ""42095566"", ""388662779"", ""160244947"", ""894474812"", ""2812269630"", ""628638850"", ""194224213"", ""2952726741"", ""279982529"", ""65695658"", ""978739476"", ""132577759"", ""564805917"", ""55986798"", ""1648509805"", ""279788564"", ""2918085713"", ""112900133"", ""1109159233"", ""2886586060"", ""2159049399"", ""106211842"", ""83304544"", ""16090877"", ""90826184"", ""2445635994"", ""187109275"", ""873482893"", ""44864397"", ""719478714"", ""1030435626"", ""26122639"", ""17427729"", ""2332152543"", ""558772900"", ""23444554"", ""2878242790"", ""2900321062"", ""2215736377"", ""1546021448"", ""537670884"", ""37759549"", ""19837212"", ""442984709"", ""42569338"", ""122623123"", ""69032114"", ""281519746"", ""2972998455"", ""2862224447"", ""69160166"", ""117510407"", ""183135872"", ""2292797061"", ""2238559117"", ""51596151"", ""263234033"", ""811974643"", ""2828024478"", ""33630394"", ""2290463507"", ""2888296032"", ""2704810752"", ""508214922"", ""202324598"", ""2602391361"", ""2714200546"", ""2464502209"", ""2399391152"", ""467798112"", ""138123910"", ""1657809344"", ""703699774"", ""33332251"", ""128917051"", ""899439308"", ""1223352072"", ""64483216"", ""1949828624"", ""1097602477"", ""538765846"", ""847661712"", ""2569242274"", ""161177856"", ""18107651"", ""858586638"", ""2308935212"", ""463757815"", ""262654469"", ""30829833"", ""21626816"", ""558525106"", ""2721020333"", ""2297390541"", ""2204086600"", ""158170143"", ""22490737"", ""67137306"", ""2386895221"", ""2937111401"", ""2964775983"", ""530803101"", ""2501482932"", ""1041888420"", ""195743045"", ""1109067727"", ""865596252"", ""1173578298"", ""302425104"", ""266547371"", ""1495284030"", ""341089607"", ""352477710"", ""234345503"", ""32847698"", ""332846692"", ""20005071"", ""467792402"", ""27297014"", ""295905326"", ""15924775"", ""232481166"", ""426704897"", ""1533076988"", ""394256715"", ""2494601448"", ""38670249"", ""21109189"", ""419446856"", ""16020483"", ""16573162"", ""2552698171"", ""180961394"", ""290326947"", ""542854170"", ""22582096"", ""2674792003"", ""365399601"", ""1927566248"", ""48684811"", ""124652308"", ""2780648743"", ""112978661"", ""1355670361"", ""258003948"", ""89562706"", ""409210532"", ""13335922"", ""29964202"", ""2308743201"", ""1134734004"", ""827352452"", ""2917954106"", ""153971897"", ""863472282"", ""1168398920"", ""2723447534"", ""2381958271"", ""117071172"", ""1662249475"", ""890094763"", ""484614247"", ""847642303"", ""2201812604"", ""2752067759"", ""19965226"", ""431699467"", ""23024399"", ""463100232"", ""466228100"", ""382390673"", ""2714517152"", ""509086412"", ""732786332"", ""1457533488"", ""494501255"", ""2884168344"", ""56263368""]",13,17,30
16573662,14,119.78571428571429,-0.16233129160744802,2216449.0,4,0.5714285714285714,"[""charliehebdo-all-rnr-threads"", ""sydneysiege-all-rnr-threads""]","[""2799960092"", ""64643056"", ""1994321"", ""5402612""]",8,6,14
248317578,6,121.0,-0.49049586057662964,6573500.0,3,0.3333333333333333,"[""charliehebdo-all-rnr-threads"", ""germanwings-crash-all-rnr-threads""]","[""2280470022"", ""380648579"", ""5402612""]",2,4,6
2273282888,54,115.85185185185185,-0.4496445931770183,6851857.0,15,0.8148148148148148,"[""charliehebdo-all-rnr-threads"", ""ottawashooting-all-rnr-threads"", ""sydneysiege-all-rnr-threads""]","[""22129280"", ""16671007"", ""333205257"", ""20639175"", ""5402612"", ""16589206"", ""46078438"", ""1634077976"", ""6017542"", ""64643056"", ""16992416"", ""375721095"", ""1367531"", ""16834659"", ""2736449935""]",44,10,54
407279130,9,68.77777777777777,-0.0935900608698527,2021000.0,2,1.0,"[""charliehebdo-all-rnr-threads"", ""sydneysiege-all-rnr-threads""]","[""16031927"", ""5402612""]",9,0,9
2542439420,3,110.0,-0.577678898970286,7750104.0,3,0.6666666666666666,"[""charliehebdo-all-rnr-threads"", ""putinmissing-all-rnr-threads"", ""sydneysiege-all-rnr-threads""]","[""16710420"", ""711348452"", ""5402612""]",2,1,3
2851170553,32,121.96875000000003,-0.27593973465263844,2005367.0,5,0.15625,"[""charliehebdo-all-rnr-threads"", ""sydneysiege-all-rnr-threads""]","[""392317014"", ""147580943"", ""3108351"", ""6017542"", ""788524""]",5,27,32
1005257844,5,74.8,-0.17859721183776855,13220671.0,1,1.0,"[""charliehebdo-all-rnr-threads"", ""germanwings-crash-all-rnr-threads"", ""ottawashooting-all-rnr-threads"", ""sydneysiege-all-rnr-threads""]","[""6017542""]",5,0,5
2896291439,3,134.0,-0.47251729170481366,2053880.0,3,0.3333333333333333,"[""charliehebdo-all-rnr-threads"", ""sydneysiege-all-rnr-threads""]","[""612473"", ""130557513"", ""16567644""]",1,2,3
17984709,15,86.6,-0.3916627128918966,8595167.0,28,0.26666666666666666,"[""charliehebdo-all-rnr-threads"", ""germanwings-crash-all-rnr-threads"", ""sydneysiege-all-rnr-threads""]","[""2909294196"", ""2401156465"", ""180940997"", ""469485578"", ""472513258"", ""83391991"", ""12896172"", ""171802941"", ""711348452"", ""2900148061"", ""15438913"", ""52368836"", ""2843440568"", ""16372991"", ""153029181"", ""141424085"", ""62550901"", ""265645992"", ""17984709"", ""292777349"", ""54702689"", ""22993014"", ""339783846"", ""1627120838"", ""49038258"", ""1711450184"", ""2929175617"", ""25235151""]",4,11,15
564805917,4,100.75,-0.5324702262878418,2029614.0,3,0.75,"[""charliehebdo-all-rnr-threads"", ""sydneysiege-all-rnr-threads""]","[""1960878613"", ""15438913"", ""16343974""]",3,1,4
56263368,5,94.6,-0.4566241502761841,2014477.0,2,0.2,"[""charliehebdo-all-rnr-threads"", ""sydneysiege-all-rnr-threads""]","[""1960878613"", ""15438913""]",1,4,5
48684811,9,73.55555555555556,-0.40104060702853733,2190969.0,9,0.1111111111111111,"[""charliehebdo-all-rnr-threads"", ""sydneysiege-all-rnr-threads""]","[""16973333"", ""1662016292"", ""17537467"", ""22657914"", ""105173441"", ""15438913"", ""102420077"", ""16675569"", ""408200652""]",1,8,9
1134734004,9,56.333333333333336,-0.010599705908033583,8542585.0,8,0.3333333333333333,"[""charliehebdo-all-rnr-threads"", ""germanwings-crash-all-rnr-threads"", ""sydneysiege-all-rnr-threads""]","[""342894187"", ""2097571"", ""20402945"", ""3108351"", ""15438913"", ""43182702"", ""16012783"", ""15513604""]",3,6,9
216299334,7,113.42857142857143,-0.4281770246369498,12510518.0,96,0.42857142857142855,"[""charliehebdo-all-rnr-threads"", ""ferguson-all-rnr-threads""]","[""21292467"", ""1468686096"", ""42338948"", ""299872235"", ""540471408"", ""902528816"", ""1575138829"", ""241212449"", ""40250577"", ""14218930"", ""48153070"", ""14483260"", ""247689402"", ""5822902"", ""17763426"", ""35465336"", ""944044795"", ""60947221"", ""878809806"", ""1359524743"", ""2250739063"", ""49241754"", ""226142439"", ""49175023"", ""2399900268"", ""183399412"", ""122199037"", ""77801464"", ""25472797"", ""21888595"", ""105002809"", ""294543106"", ""289240165"", ""601222111"", ""8037402"", ""115601800"", ""295366985"", ""377440844"", ""620303492"", ""1541730973"", ""347473677"", ""127049815"", ""51673"", ""105404541"", ""75802352"", ""45446985"", ""2799588421"", ""33755453"", ""22044671"", ""19264063"", ""263592981"", ""1443335269"", ""121616820"", ""1362195312"", ""117742733"", ""237852586"", ""2383996381"", ""528837552"", ""2201702179"", ""560707426"", ""27670729"", ""20438413"", ""24218030"", ""326078926"", ""1368155952"", ""362200247"", ""2671784430"", ""280082481"", ""39336346"", ""19358185"", ""162351280"", ""125634800"", ""941528509"", ""110702840"", ""1717260037"", ""2962064392"", ""143918168"", ""28476628"", ""245455480"", ""167330764"", ""150469846"", ""283449334"", ""458861182"", ""876113958"", ""218706514"", ""1345738370"", ""15491840"", ""99239606"", ""376396367"", ""400110136"", ""287839361"", ""1120005338"", ""216299334"", ""23406091"", ""33950000"", ""52942909""]",3,4,7
2250739063,7,96.85714285714286,-0.06105405943734305,12549630.0,1,0.42857142857142855,"[""charliehebdo-all-rnr-threads"", ""ferguson-all-rnr-threads""]","[""216299334""]",3,4,7
1120005338,17,123.3529411764706,-0.34566862442914176,2012134.0,2,1.0,"[""charliehebdo-all-rnr-threads"", ""sydneysiege-all-rnr-threads""]","[""7587032"", ""216299334""]",17,0,17
876113958,13,102.23076923076923,-0.20324430557397696,2030570.0,2,1.0,"[""charliehebdo-all-rnr-threads"", ""sydneysiege-all-rnr-threads""]","[""21866939"", ""216299334""]",13,0,13
528837552,6,69.0,-0.2288681467374166,7505028.0,4,1.0,"[""charliehebdo-all-rnr-threads"", ""ottawashooting-all-rnr-threads"", ""ebola-essien-all-rnr-threads""]","[""1594903015"", ""87416722"", ""1262229906"", ""216299334""]",6,0,6
48153070,8,98.25,-0.4506555050611496,12671610.0,3,0.625,"[""charliehebdo-all-rnr-threads"", ""ferguson-all-rnr-threads""]","[""11265832"", ""19222164"", ""216299334""]",5,3,8
101445204,8,119.125,-0.4502328187227249,6572103.0,4,0.75,"[""charliehebdo-all-rnr-threads"", ""germanwings-crash-all-rnr-threads""]","[""16343974"", ""491631309"", ""87416722"", ""5402612""]",6,2,8
56363520,2,118.0,0.5402137041091919,1904732.0,2,0.5,"[""charliehebdo-all-rnr-threads"", ""sydneysiege-all-rnr-threads""]","[""16513349"", ""238575113""]",1,1,2
2381434507,5,80.0,-0.3882206916809082,2201413.0,4,0.4,"[""charliehebdo-all-rnr-threads"", ""sydneysiege-all-rnr-threads""]","[""17537467"", ""21998314"", ""87818409"", ""16513349""]",2,3,5
635608354,21,78.66666666666667,-0.13750807728086198,12288573.0,83,0.5238095238095238,"[""charliehebdo-all-rnr-threads"", ""putinmissing-all-rnr-threads"", ""ottawashooting-all-rnr-threads""]","[""626560889"", ""57811281"", ""286801248"", ""402203787"", ""19235973"", ""1395888583"", ""22600696"", ""172011818"", ""1098890888"", ""2857090698"", ""2513308740"", ""2474400055"", ""2400191280"", ""1643659700"", ""175394179"", ""28787718"", ""454763324"", ""246574430"", ""2823698761"", ""2233662300"", ""635608354"", ""2559432516"", ""2869647063"", ""77618112"", ""2804017770"", ""941746616"", ""249053749"", ""2491845824"", ""2372174178"", ""2314068637"", ""1256370990"", ""16870451"", ""16513349"", ""257221975"", ""70650435"", ""427495215"", ""2805030041"", ""17078422"", ""1655863890"", ""48132940"", ""15407637"", ""16941663"", ""28740858"", ""246103"", ""2438862516"", ""59839020"", ""319838859"", ""456832462"", ""275003449"", ""24184018"", ""2294469764"", ""361405039"", ""1904337014"", ""43534206"", ""2213157290"", ""20905953"", ""233227011"", ""20691016"", ""938073079"", ""41834289"", ""254806449"", ""529711774"", ""63497561"", ""308069341"", ""774442856"", ""234155392"", ""1084264573"", ""68168693"", ""2415072836"", ""788018329"", ""19823618"", ""2595249908"", ""196724330"", ""2256985338"", ""159911529"", ""1365618002"", ""980818910"", ""16750845"", ""369424853"", ""2828391861"", ""157437355"", ""2174436993"", ""2230023258""]",11,10,21
191231615,10,117.4,-0.36688177585601806,6821102.0,5,0.6,"[""charliehebdo-all-rnr-threads"", ""ottawashooting-all-rnr-threads"", ""sydneysiege-all-rnr-threads""]","[""868112707"", ""87818409"", ""51241574"", ""380648579"", ""15012486""]",6,4,10
54194375,3,113.0,-0.40516845385233563,2147383.0,3,0.3333333333333333,"[""charliehebdo-all-rnr-threads"", ""sydneysiege-all-rnr-threads""]","[""868112707"", ""153029181"", ""17995040""]",1,2,3
725595571,3,83.33333333333333,-0.6167238354682922,12513026.0,3,0.6666666666666666,"[""charliehebdo-all-rnr-threads"", ""ottawashooting-all-rnr-threads"", ""ferguson-all-rnr-threads""]","[""759251"", ""868112707"", ""337801323""]",2,1,3
16887175,8,131.75,-0.5235953852534294,6756038.0,46,0.625,"[""charliehebdo-all-rnr-threads"", ""germanwings-crash-all-rnr-threads""]","[""69101065"", ""234952070"", ""761465239"", ""211809624"", ""2900288385"", ""1701374971"", ""47664722"", ""80870096"", ""2932869688"", ""178593058"", ""18142983"", ""613422603"", ""53219079"", ""3028141931"", ""449998703"", ""44753321"", ""2231418675"", ""169609704"", ""1198746512"", ""437562870"", ""1382894354"", ""29082276"", ""921217862"", ""84798933"", ""402669096"", ""827352452"", ""83053151"", ""141506745"", ""823883521"", ""192295616"", ""1963598808"", ""1098916598"", ""2915986449"", ""2967593273"", ""2888018411"", ""16181232"", ""615069597"", ""1153906440"", ""2167956478"", ""1509803635"", ""2850717933"", ""1348798826"", ""281591919"", ""363082301"", ""120722862"", ""2857747756""]",5,3,8
14293310,16,94.3125,-0.4607537947595119,8585148.0,217,0.3125,"[""charliehebdo-all-rnr-threads"", ""germanwings-crash-all-rnr-threads"", ""sydneysiege-all-rnr-threads""]","[""2961649574"", ""49003874"", ""1359118608"", ""1332220207"", ""118384061"", ""2570646097"", ""34882190"", ""221876750"", ""326140439"", ""2782806799"", ""2915660732"", ""2489718932"", ""20564116"", ""39040427"", ""388459030"", ""1086019988"", ""28353910"", ""1160280464"", ""612552091"", ""104256824"", ""58439696"", ""29177565"", ""481232044"", ""628038157"", ""2311817771"", ""121880798"", ""400195162"", ""133912207"", ""30716605"", ""114962484"", ""961490532"", ""2827613550"", ""4489651"", ""206078169"", ""1378109503"", ""1585970245"", ""2945865278"", ""2223008040"", ""189632005"", ""24376679"", ""2862600845"", ""84793086"", ""416044899"", ""180360031"", ""215202696"", ""2919525786"", ""810458478"", ""259311922"", ""67715492"", ""34346897"", ""2227039908"", ""66111699"", ""122129206"", ""1561843340"", ""103276693"", ""1348798826"", ""46899351"", ""24216455"", ""153480754"", ""284259463"", ""461862512"", ""1844296711"", ""2855109985"", ""38338246"", ""83778308"", ""38499263"", ""923278088"", ""89502079"", ""70578323"", ""2456785898"", ""53448694"", ""729098486"", ""2160285660"", ""268643072"", ""283771431"", ""283917786"", ""102364880"", ""28875505"", ""2187516904"", ""28837388"", ""842665220"", ""503613785"", ""10174622"", ""24655343"", ""2511606138"", ""2445994056"", ""427402721"", ""323179399"", ""2875761863"", ""354917016"", ""2171201828"", ""51090242"", ""2932422959"", ""186923886"", ""2800992858"", ""2884173593"", ""824915659"", ""270588444"", ""456741823"", ""628643658"", ""2230861970"", ""285219783"", ""81578378"", ""20727451"", ""2536239668"", ""759883658"", ""543938245"", ""303742972"", ""893357550"", ""517656712"", ""5753482"", ""49948272"", ""503441413"", ""35174226"", ""534685142"", ""2936694741"", ""212686176"", ""78837703"", ""2570962548"", ""1518883244"", ""157798678"", ""79187514"", ""106312179"", ""2808218208"", ""18235667"", ""34698912"", ""14709531"", ""1952274836"", ""101165898"", ""12443132"", ""2810343200"", ""567337143"", ""263767485"", ""146768792"", ""399639379"", ""28752392"", ""343916713"", ""2874821464"", ""41074758"", ""169966568"", ""246799077"", ""165452438"", ""426275455"", ""134839975"", ""568256869"", ""15990680"", ""325999704"", ""2201464242"", ""534002956"", ""379069495"", ""2802294698"", ""2840105555"", ""1253400242"", ""53906520"", ""507561137"", ""171470035"", ""22825695"", ""2370908751"", ""356384998"", ""63031192"", ""305035263"", ""75542389"", ""2922829959"", ""2751892173"", ""377798523"", ""297821885"", ""168210897"", ""1658359346"", ""1022590015"", ""246458133"", ""89510574"", ""34217911"", ""1445088373"", ""18812134"", ""395895021"", ""15730804"", ""23626411"", ""1018134607"", ""260786433"", ""593488590"", ""34543866"", ""24644596"", ""2520971602"", ""2804841391"", ""786579397"", ""228891934"", ""192517565"", ""568389907"", ""2786013397"", ""74264257"", ""1528260655"", ""2837858684"", ""113328047"", ""2224117741"", ""603758918"", ""102149847"", ""965222149"", ""21762025"", ""18162957"", ""1546194625"", ""1026022232"", ""31694460"", ""337959833"", ""1216534111"", ""606866658"", ""2217283489"", ""46818339"", ""2731994450"", ""262940385"", ""52620509"", ""37665375"", ""128932090"", ""444748548"", ""32223065"", ""348706145"", ""310980375"", ""2308920457""]",5,11,16
1856237718,5,61.8,-0.13727180957794188,8715285.0,4,0.8,"[""charliehebdo-all-rnr-threads"", ""germanwings-crash-all-rnr-threads"", ""sydneysiege-all-rnr-threads""]","[""2280470022"", ""3108351"", ""268676434"", ""5402612""]",4,1,5
2866333263,20,106.4,-0.5167310088872907,6572245.0,2,0.95,"[""charliehebdo-all-rnr-threads"", ""germanwings-crash-all-rnr-threads""]","[""142614009"", ""5402612""]",19,1,20
206962580,14,113.85714285714286,-0.326821893453598,6640514.0,3,0.35714285714285715,"[""charliehebdo-all-rnr-threads"", ""ottawashooting-all-rnr-threads"", ""sydneysiege-all-rnr-threads""]","[""14173315"", ""373783051"", ""5402612""]",5,9,14
48088248,2,38.5,-0.025243163108825684,6576893.0,2,0.5,"[""charliehebdo-all-rnr-threads"", ""germanwings-crash-all-rnr-threads""]","[""15108702"", ""5402612""]",1,1,2
23301881,2,120.0,-0.14652857184410095,1987759.0,2,0.5,"[""charliehebdo-all-rnr-threads"", ""sydneysiege-all-rnr-threads""]","[""255753616"", ""17152053""]",1,1,2
456806183,2,123.5,-0.5766380727291107,12517883.0,2,1.0,"[""charliehebdo-all-rnr-threads"", ""ferguson-all-rnr-threads""]","[""18643437"", ""17152053""]",2,0,2
2750347930,5,115.2,-0.380218505859375,2033725.0,5,0.2,"[""charliehebdo-all-rnr-threads"", ""sydneysiege-all-rnr-threads""]","[""1877831"", ""17152053"", ""14511951"", ""38291055"", ""818212956""]",1,4,5
115125517,5,42.8,0.04340238571166992,6634768.0,5,0.2,"[""charliehebdo-all-rnr-threads"", ""ottawashooting-all-rnr-threads""]","[""17152053"", ""49946953"", ""16900353"", ""10313752"", ""20748745""]",1,4,5
2464329458,14,137.07142857142853,-0.4119759883199419,6819707.0,6,0.42857142857142855,"[""charliehebdo-all-rnr-threads"", ""ottawashooting-all-rnr-threads""]","[""16973333"", ""15108702"", ""15438913"", ""64643056"", ""83638901"", ""5402612""]",6,8,14
2886586060,84,109.25,0.07533913566952666,2186203.0,48,0.09523809523809523,"[""charliehebdo-all-rnr-threads"", ""sydneysiege-all-rnr-threads""]","[""367044023"", ""44089820"", ""9609632"", ""88210310"", ""2324408143"", ""28785486"", ""952112047"", ""22479281"", ""498086229"", ""338968305"", ""2768501"", ""392317014"", ""16973333"", ""20678866"", ""122195535"", ""14123751"", ""242314631"", ""350341283"", ""85794542"", ""308439963"", ""14485018"", ""15438913"", ""506429053"", ""153029181"", ""170998795"", ""35466620"", ""788524"", ""806133"", ""87818409"", ""16807528"", ""7587032"", ""26012202"", ""2163076560"", ""15084853"", ""64643056"", ""14095052"", ""24127595"", ""375721095"", ""16675569"", ""271413771"", ""954124423"", ""21749564"", ""607946179"", ""21548431"", ""3108351"", ""15754281"", ""373024636"", ""16170253""]",8,76,84
51241574,54,112.03703703703704,-0.49454210974552004,13432983.0,657,0.6666666666666666,"[""charliehebdo-all-rnr-threads"", ""germanwings-crash-all-rnr-threads"", ""ottawashooting-all-rnr-threads"", ""sydneysiege-all-rnr-threads""]","[""997444831"", ""350129163"", ""155422100"", ""2323975734"", ""524557004"", ""2462310905"", ""19819752"", ""34861316"", ""2369482951"", ""1503342588"", ""340441440"", ""67706546"", ""2375182814"", ""2478979537"", ""1902419071"", ""18660448"", ""79284431"", ""2788975302"", ""1407027576"", ""51310976"", ""158308004"", ""1382070258"", ""2707815410"", ""412549497"", ""18993263"", ""26679552"", ""17592890"", ""298974112"", ""2523783230"", ""874885435"", ""551545204"", ""388768535"", ""135472625"", ""1023590286"", ""16574787"", ""714248515"", ""126251412"", ""116675636"", ""2525635410"", ""407464980"", ""2538970826"", ""22450386"", ""24208750"", ""33676358"", ""392398746"", ""2596804566"", ""379012209"", ""872237388"", ""183767935"", ""2883972239"", ""268643072"", ""36998358"", ""1951936646"", ""16035931"", ""289264257"", ""1048388748"", ""1637085410"", ""474309032"", ""249016891"", ""21238841"", ""33182341"", ""25346700"", ""191231615"", ""178604994"", ""281679641"", ""898868323"", ""66983426"", ""193963770"", ""444225252"", ""2892277057"", ""2560148358"", ""2717034139"", ""1393502275"", ""1897878427"", ""929662333"", ""34149316"", ""459096031"", ""39930604"", ""542349266"", ""153166339"", ""148063984"", ""874824648"", ""3053960740"", ""20753311"", ""168820035"", ""254163854"", ""157506702"", ""221105224"", ""362201057"", ""153132339"", ""114522479"", ""1285944709"", ""1637236532"", ""800554962"", ""1072071295"", ""307374919"", ""2192794098"", ""2401156465"", ""76850899"", ""322934616"", ""19467167"", ""1551416964"", ""14194743"", ""583142443"", ""26487082"", ""78011223"", ""16531768"", ""2875953113"", ""94592563"", ""2736151545"", ""265336081"", ""202054350"", ""271393276"", ""15246579"", ""44532336"", ""1273480106"", ""2856927247"", ""2447279666"", ""69340789"", ""2149480427"", ""110845965"", ""342648845"", ""144031017"", ""30632513"", ""526631013"", ""48241518"", ""1534295472"", ""2697460284"", ""309756016"", ""2148900003"", ""266547371"", ""507561137"", ""410271337"", ""2945871636"", ""280012815"", ""1315224110"", ""2160518824"", ""17446493"", ""253615698"", ""1047442021"", ""66776239"", ""1547072761"", ""282054527"", ""1663914396"", ""16063128"", ""71443409"", ""2842123493"", ""226997507"", ""717791498"", ""294302230"", ""428311146"", ""24211577"", ""325726862"", ""185762351"", ""1238828334"", ""1129769750"", ""617434038"", ""2564289443"", ""225503094"", ""156585522"", ""132512167"", ""626942727"", ""238814560"", ""361135947"", ""32201297"", ""947122904"", ""35232225"", ""19651918"", ""75139609"", ""18042484"", ""11462742"", ""42624958"", ""262251203"", ""862888680"", ""292671486"", ""118691658"", ""721092824"", ""55813277"", ""2578182110"", ""559709206"", ""2601685062"", ""2884005748"", ""2966409519"", ""47358070"", ""6329712"", ""199601800"", ""123622674"", ""41410702"", ""144323626"", ""479844427"", ""567784447"", ""2892439622"", ""839374087"", ""1606394300"", ""204844864"", ""2149973089"", ""142140156"", ""37375028"", ""244497319"", ""703695468"", ""492529570"", ""606372202"", ""25650637"", ""51954829"", ""32365573"", ""22717923"", ""22380805"", ""18294906"", ""449271122"", ""123628014"", ""133931350"", ""29186320"", ""18004191"", ""2754393364"", ""2835908317"", ""392996036"", ""385038955"", ""15197359"", ""23410143"", ""1387046798"", ""17618786"", ""499696436"", ""2495613440"", ""2938592060"", ""302903787"", ""2969487896"", ""2260483450"", ""14317166"", ""243419169"", ""354917016"", ""61169372"", ""17869094"", ""1108499101"", ""2762126677"", ""462248644"", ""69171795"", ""15409034"", ""50059964"", ""369769807"", ""7076492"", ""23904131"", ""236132475"", ""22298467"", ""1061029789"", ""2349644574"", ""18653296"", ""2851263210"", ""35992459"", ""75896584"", ""122592785"", ""127084941"", ""219019625"", ""61536684"", ""993203154"", ""1049528328"", ""316247887"", ""1666280082"", ""2258176628"", ""279200024"", ""27407592"", ""14357925"", ""325375034"", ""33625320"", ""97519068"", ""140280146"", ""19009248"", ""387516768"", ""42590897"", ""1095548593"", ""43772839"", ""22702661"", ""465482279"", ""287527032"", ""2325214996"", ""67623033"", ""128917051"", ""203788113"", ""64233540"", ""1220360485"", ""2768705528"", ""179457781"", ""109996784"", ""971413766"", ""13361042"", ""28245169"", ""392445178"", ""2665155240"", ""2276952018"", ""46991806"", ""25122847"", ""1646838848"", ""2880946010"", ""2840829605"", ""142002847"", ""52940249"", ""20026746"", ""481326300"", ""18259219"", ""23716270"", ""229743093"", ""454828248"", ""51613169"", ""2656846536"", ""2791227919"", ""30323727"", ""561985218"", ""102935384"", ""262486400"", ""180853802"", ""754038805"", ""2494290523"", ""133353171"", ""1464539556"", ""38388392"", ""69232915"", ""1062333396"", ""2149815079"", ""312693640"", ""81061134"", ""269568454"", ""32223065"", ""171386057"", ""2685015253"", ""525853153"", ""10335162"", ""249362999"", ""107031620"", ""2149231188"", ""29063926"", ""1111282914"", ""736914727"", ""2361372481"", ""48124610"", ""485245794"", ""2215260181"", ""498294115"", ""108173110"", ""341037442"", ""628038157"", ""95833119"", ""45708598"", ""75797367"", ""18945060"", ""3020434026"", ""484947415"", ""2400408805"", ""67864420"", ""608534227"", ""613623369"", ""341476052"", ""2491634121"", ""563740777"", ""437584584"", ""15978136"", ""165854435"", ""326609155"", ""861712795"", ""317433937"", ""25783616"", ""2835363378"", ""436945255"", ""2168889209"", ""245693716"", ""69605340"", ""53396652"", ""221855426"", ""26492575"", ""329890902"", ""193336404"", ""426347585"", ""34126592"", ""147128397"", ""1503164911"", ""359015191"", ""2727419193"", ""19563837"", ""21160098"", ""1258145024"", ""22115327"", ""239973813"", ""404095330"", ""2413476704"", ""923278088"", ""1483942572"", ""521035761"", ""1323603420"", ""1901486658"", ""26607638"", ""531134841"", ""37896521"", ""13524672"", ""1415442320"", ""385752882"", ""56422174"", ""16883947"", ""30159948"", ""23261635"", ""120109311"", ""2690842873"", ""240279011"", ""15617140"", ""2962507555"", ""2879347021"", ""403932208"", ""322688820"", ""19952601"", ""17876008"", ""2536796111"", ""92701206"", ""33576349"", ""25440865"", ""232561295"", ""2587656930"", ""1030435626"", ""252978405"", ""271074952"", ""580575948"", ""2360490967"", ""265044432"", ""2278266746"", ""2600071410"", ""291978413"", ""2543856762"", ""1310820734"", ""17696159"", ""110440287"", ""1163006736"", ""1590983792"", ""320810597"", ""18970657"", ""28654635"", ""24138795"", ""2869304847"", ""1063008193"", ""479120161"", ""131877198"", ""2833227409"", ""1705647254"", ""594389594"", ""120233447"", ""1010456808"", ""19389956"", ""20154627"", ""719312498"", ""10929352"", ""81351491"", ""969021517"", ""54931711"", ""31182714"", ""2545601317"", ""16940343"", ""297106603"", ""701279630"", ""1853914981"", ""176708451"", ""24570419"", ""71277067"", ""15381080"", ""1166392885"", ""18501635"", ""2881295272"", ""635638695"", ""415081000"", ""40513258"", ""1252796688"", ""466234992"", ""1123075297"", ""80817644"", ""93770913"", ""2901653558"", ""2571860615"", ""18712930"", ""1700631456"", ""137107148"", ""26502740"", ""45840741"", ""2666466445"", ""14189557"", ""204355964"", ""217488042"", ""102149847"", ""508741229"", ""1059040274"", ""14326420"", ""1176575808"", ""542813993"", ""122294990"", ""193150198"", ""2711678270"", ""31694460"", ""2903776139"", ""152351502"", ""1637725969"", ""836209867"", ""1569425222"", ""370775638"", ""120275207"", ""2723735572"", ""2571766333"", ""147631173"", ""21130327"", ""1965390450"", ""36836312"", ""150156884"", ""1203630506"", ""259630649"", ""536102733"", ""34002867"", ""258069206"", ""14392960"", ""355292809"", ""321147022"", ""392459453"", ""2173507532"", ""437671978"", ""266860309"", ""15233296"", ""435378855"", ""23153001"", ""541658852"", ""25985010"", ""97450466"", ""2493987576"", ""2935553688"", ""993946728"", ""29870604"", ""1085149063"", ""1651286821"", ""17297649"", ""262293426"", ""300590803"", ""1348798826"", ""144560087"", ""825801150"", ""212924513"", ""1626769435"", ""1084735669"", ""37425092"", ""1341799256"", ""2426855263"", ""139586799"", ""199149993"", ""2450194945"", ""289981406"", ""62307625"", ""130717266"", ""256025957"", ""57040956"", ""81965252"", ""46670486"", ""117692975"", ""2832368186"", ""1905195793"", ""326466265"", ""14641111"", ""394175453"", ""67166094"", ""988990854"", ""96626292"", ""351527166"", ""39420471"", ""97458870"", ""455844579"", ""190274029"", ""2410765508"", ""245659018"", ""71604847"", ""551137006"", ""2942914637"", ""395076910"", ""2663115926"", ""104783906"", ""22336731"", ""19581053"", ""478157435"", ""128801909"", ""256330686"", ""921216746"", ""1173297186"", ""227090398"", ""2163152038"", ""17832938"", ""533753630"", ""262550579"", ""26165656"", ""29626167"", ""1529092069"", ""2734300973"", ""534685142"", ""256505832"", ""606863155"", ""2707909225"", ""2824442646"", ""203465297"", ""2838852723"", ""19321357"", ""309308460"", ""2256976260"", ""1662562928"", ""63572304"", ""2433924142"", ""268031972"", ""799153915"", ""371951368"", ""2396533820"", ""192607588"", ""48310336"", ""255180467"", ""233697162"", ""201416028"", ""1138559328"", ""28096660"", ""2959360301"", ""392288172"", ""337130991"", ""34008859"", ""312242408"", ""585071988"", ""21872222"", ""1090029468"", ""555977337"", ""226311830"", ""183353672"", ""92922276"", ""50793235"", ""41763374"", ""407051392"", ""2549223338"", ""257703040"", ""179324508"", ""29234432"", ""19050376"", ""2900148061"", ""2176520681"", ""597244003"", ""52571657"", ""515467876"", ""230348811"", ""590543757"", ""2252226043"", ""80791048"", ""79880180"", ""703306700"", ""434552787"", ""9507342"", ""195059447"", ""26682251"", ""368210559"", ""23331917"", ""2763525809"", ""937655960"", ""24540377"", ""258730076"", ""738723848"", ""59407110"", ""18892635"", ""546490867""]",36,18,54
31694460,18,84.77777777777776,-0.17529864112536112,2849180.0,11,0.6111111111111112,"[""charliehebdo-all-rnr-threads"", ""sydneysiege-all-rnr-threads""]","[""47624589"", ""14293310"", ""1994321"", ""51241574"", ""46335511"", ""807095"", ""501768982"", ""1960878613"", ""36412963"", ""464854839"", ""5402612""]",11,7,18
2707815410,73,113.87671232876713,-0.541944011433484,2209448.0,7,0.4520547945205479,"[""charliehebdo-all-rnr-threads"", ""sydneysiege-all-rnr-threads""]","[""69231187"", ""22369602"", ""40962194"", ""7587032"", ""51241574"", ""18576537"", ""428333""]",33,40,73
1905195793,3,117.66666666666667,-0.13197998205820718,13049036.0,3,0.6666666666666666,"[""charliehebdo-all-rnr-threads"", ""germanwings-crash-all-rnr-threads"", ""ottawashooting-all-rnr-threads""]","[""51241574"", ""23937894"", ""15513604""]",2,1,3
2566535282,35,105.22857142857143,-0.36525523832866125,13379523.0,112,0.7142857142857143,"[""charliehebdo-all-rnr-threads"", ""germanwings-crash-all-rnr-threads"", ""sydneysiege-all-rnr-threads"", ""putinmissing-all-rnr-threads"", ""ottawashooting-all-rnr-threads""]","[""465446237"", ""2595716271"", ""160616292"", ""1023979585"", ""48429657"", ""20823571"", ""727547028"", ""2846001693"", ""1060886490"", ""38874650"", ""99270811"", ""546838312"", ""2916544419"", ""26679552"", ""16634289"", ""376894070"", ""88238377"", ""27907919"", ""482408064"", ""23943793"", ""18775094"", ""2159787988"", ""2780946635"", ""1036756046"", ""2941652236"", ""221459431"", ""1022583368"", ""2768501"", ""36036060"", ""65616414"", ""19527910"", ""1449766904"", ""2858679020"", ""2582427774"", ""919185432"", ""22957980"", ""185287105"", ""133787157"", ""344069598"", ""17413242"", ""473317256"", ""2763681331"", ""2790589639"", ""24156429"", ""282265521"", ""2862337006"", ""23666260"", ""2920819074"", ""73714634"", ""2608834147"", ""896400632"", ""339847349"", ""142143785"", ""224185541"", ""1621004814"", ""175827858"", ""1511205571"", ""29437660"", ""450202935"", ""23055689"", ""10715902"", ""29062438"", ""1406238908"", ""20150758"", ""321804063"", ""469429074"", ""349249475"", ""947913702"", ""16525194"", ""22240612"", ""2800549223"", ""148918646"", ""65481741"", ""303896480"", ""16591979"", ""7587032"", ""12153682"", ""562372370"", ""45767079"", ""2484630409"", ""1139254410"", ""21548431"", ""1330155252"", ""1475403872"", ""1931711646"", ""118226008"", ""107586950"", ""246130881"", ""2457848568"", ""2915130167"", ""2829195081"", ""246458133"", ""388896551"", ""1299769218"", ""2173784256"", ""6754922"", ""395895021"", ""110545523"", ""83806184"", ""35329451"", ""536405707"", ""376779852"", ""1705685203"", ""332943925"", ""15818705"", ""292777349"", ""535093370"", ""64762814"", ""17679507"", ""23513263"", ""253982809"", ""2561732154""]",25,10,35
418854161,12,95.33333333333333,-0.2884956995646159,2031787.0,4,0.25,"[""charliehebdo-all-rnr-threads"", ""sydneysiege-all-rnr-threads""]","[""428140124"", ""1626294277"", ""1299769218"", ""14569869""]",3,9,12
469509327,4,134.75,-0.2805723249912262,6649029.0,53,0.75,"[""charliehebdo-all-rnr-threads"", ""ottawashooting-all-rnr-threads""]","[""245051131"", ""297967623"", ""248764392"", ""119130178"", ""59471660"", ""228713457"", ""38172714"", ""37891446"", ""2565605114"", ""830674884"", ""2908504576"", ""109086019"", ""6692952"", ""150986554"", ""180961394"", ""192359034"", ""34671651"", ""478374335"", ""84396989"", ""235768894"", ""69031247"", ""277617233"", ""772198776"", ""2720366292"", ""2258107124"", ""49240244"", ""80601301"", ""624557599"", ""79802631"", ""284579333"", ""2780784711"", ""1048468734"", ""58768691"", ""81915797"", ""551551599"", ""460376715"", ""332047613"", ""5967972"", ""600114618"", ""2940594839"", ""18200615"", ""124591837"", ""17945610"", ""31073943"", ""300549002"", ""1348798826"", ""2761320736"", ""293607250"", ""20776772"", ""1913385001"", ""2815473183"", ""2301320077"", ""1551594134""]",3,1,4
624557599,6,90.66666666666667,-0.45683536926905316,2113442.0,6,0.3333333333333333,"[""charliehebdo-all-rnr-threads"", ""sydneysiege-all-rnr-threads""]","[""7587032"", ""210556794"", ""373783051"", ""18643437"", ""469509327"", ""136359464""]",2,4,6
245051131,10,92.0,-0.4884906768798828,12356923.0,7,0.4,"[""charliehebdo-all-rnr-threads"", ""ottawashooting-all-rnr-threads"", ""ferguson-all-rnr-threads""]","[""16721461"", ""16076032"", ""7587032"", ""19259102"", ""15438913"", ""469509327"", ""174253648""]",4,6,10
18200615,5,89.2,-0.26221762895584105,1991880.0,4,0.2,"[""charliehebdo-all-rnr-threads"", ""sydneysiege-all-rnr-threads""]","[""37881687"", ""469509327"", ""367709007"", ""20052487""]",1,4,5
14138785,13,127.07692307692308,-0.4619037463114812,6820193.0,124,0.5384615384615384,"[""charliehebdo-all-rnr-threads"", ""ottawashooting-all-rnr-threads"", ""sydneysiege-all-rnr-threads""]","[""2720168195"", ""2586346172"", ""622787201"", ""303642405"", ""210684851"", ""2793506633"", ""232575227"", ""22442431"", ""1503342588"", ""398195463"", ""516177839"", ""2814530771"", ""2345904062"", ""47726591"", ""200347509"", ""751363842"", ""2898115168"", ""295510001"", ""2945865278"", ""252476992"", ""160450335"", ""130121760"", ""19498310"", ""595659014"", ""1598406114"", ""1348798826"", ""75854948"", ""408613702"", ""93957129"", ""242175794"", ""2780946635"", ""2657669424"", ""1196838541"", ""1688761314"", ""362973399"", ""523308170"", ""2508509588"", ""121045694"", ""2461872043"", ""2204192636"", ""20319497"", ""413649532"", ""2933943867"", ""2299784480"", ""173720699"", ""15906702"", ""19898890"", ""2779061739"", ""142791289"", ""2663115926"", ""15015660"", ""26760060"", ""520401044"", ""43412564"", ""71998147"", ""25941064"", ""2799588421"", ""105134895"", ""2922814893"", ""475877287"", ""518651331"", ""19650101"", ""2781850756"", ""222413993"", ""2769721226"", ""167796251"", ""1403598307"", ""67843616"", ""437488579"", ""275579359"", ""49950180"", ""66504345"", ""2350202551"", ""103396243"", ""14689108"", ""2573332596"", ""72613897"", ""1299846277"", ""19592715"", ""2761630999"", ""29477150"", ""1310442025"", ""2433991588"", ""2878172763"", ""38133247"", ""255062000"", ""112220804"", ""10771082"", ""416885753"", ""129024290"", ""88895058"", ""2768705528"", ""2920466306"", ""22096507"", ""1927127695"", ""122094557"", ""2555842460"", ""2663332989"", ""259283033"", ""398656009"", ""2431337174"", ""162452809"", ""2528078443"", ""26461628"", ""402826193"", ""90856011"", ""576386939"", ""1020681224"", ""2674792003"", ""193252755"", ""1536949735"", ""188681444"", ""361135947"", ""85761585"", ""541279160"", ""2286973112"", ""90367713"", ""15963113"", ""853322204"", ""20046754"", ""311198407"", ""572821320"", ""2722429967"", ""250267964""]",7,6,13
19898890,12,113.75,-0.3121011604865392,2030971.0,9,0.5,"[""charliehebdo-all-rnr-threads"", ""sydneysiege-all-rnr-threads""]","[""2768501"", ""55911799"", ""21749564"", ""14138785"", ""21548431"", ""23055689"", ""37881687"", ""16675569"", ""16834659""]",6,6,12
2695178941,7,79.0,0.2400738341467721,2236778.0,6,0.42857142857142855,"[""charliehebdo-all-rnr-threads"", ""sydneysiege-all-rnr-threads""]","[""392317014"", ""21749564"", ""93766096"", ""85794542"", ""110827653"", ""258627226""]",3,4,7
1007575651,4,86.0,-0.34226401150226593,2027502.0,2,1.0,"[""charliehebdo-all-rnr-threads"", ""sydneysiege-all-rnr-threads""]","[""392317014"", ""956604620""]",4,0,4
73152491,4,89.5,-0.7390472739934921,6652316.0,3,0.5,"[""charliehebdo-all-rnr-threads"", ""ottawashooting-all-rnr-threads""]","[""392317014"", ""19292807"", ""19038934""]",2,2,4
16012783,11,114.0,-0.49796521121805365,12837231.0,90,0.36363636363636365,"[""charliehebdo-all-rnr-threads"", ""sydneysiege-all-rnr-threads"", ""ferguson-all-rnr-threads""]","[""21755936"", ""2912912646"", ""131291112"", ""891449460"", ""1503342588"", ""137723363"", ""2351339382"", ""118737912"", ""1719561684"", ""540903074"", ""411472790"", ""2926388692"", ""15557891"", ""52369879"", ""317401345"", ""2354273942"", ""1531290481"", ""20826640"", ""35638101"", ""251922027"", ""505264447"", ""2833112643"", ""2516181758"", ""24406734"", ""452172857"", ""307195603"", ""17010163"", ""12007192"", ""33839296"", ""1232348810"", ""16012783"", ""225971365"", ""2327911741"", ""460513085"", ""20025948"", ""2692604376"", ""1888521882"", ""298608719"", ""198095537"", ""17945610"", ""441333646"", ""1216401157"", ""2400494857"", ""28839148"", ""2922814893"", ""1328796752"", ""17230720"", ""2481086832"", ""517656712"", ""2221921292"", ""606412111"", ""60811364"", ""82713153"", ""793999634"", ""558969189"", ""300773836"", ""2464502209"", ""1921520767"", ""917497788"", ""17400044"", ""2242421732"", ""97338211"", ""270592010"", ""42055251"", ""94212396"", ""1220360485"", ""1098424219"", ""148164669"", ""194619305"", ""1151095778"", ""221615955"", ""715194083"", ""2306066390"", ""539104576"", ""336263077"", ""18142778"", ""2388075212"", ""171393117"", ""127632704"", ""2296730443"", ""32168892"", ""14705053"", ""2555133884"", ""1134734004"", ""42481188"", ""165335229"", ""17903466"", ""1738231"", ""16074930"", ""1561412683""]",4,7,11
460513085,2,138.0,-0.7904976606369019,6650844.0,2,1.0,"[""charliehebdo-all-rnr-threads"", ""ottawashooting-all-rnr-threads""]","[""16012783"", ""17469289""]",2,0,2
1225414310,3,96.66666666666667,-0.19251505533854166,12592558.0,3,0.3333333333333333,"[""charliehebdo-all-rnr-threads"", ""ferguson-all-rnr-threads""]","[""148653311"", ""17537467"", ""3108351""]",1,2,3
90888044,18,88.0,-0.2871733473406898,12712571.0,7,0.1111111111111111,"[""charliehebdo-all-rnr-threads"", ""sydneysiege-all-rnr-threads"", ""ferguson-all-rnr-threads""]","[""14173315"", ""148653311"", ""2097571"", ""87416722"", ""43182702"", ""7768402"", ""2680112214""]",2,16,18
23189508,6,134.0,-0.6359106401602427,2193234.0,6,0.6666666666666666,"[""charliehebdo-all-rnr-threads"", ""sydneysiege-all-rnr-threads""]","[""868112707"", ""1994321"", ""15108702"", ""380648579"", ""203123011"", ""2768501""]",4,2,6
34126592,17,113.17647058823529,-0.4095383637091693,6822136.0,7,0.6470588235294118,"[""charliehebdo-all-rnr-threads"", ""ottawashooting-all-rnr-threads"", ""sydneysiege-all-rnr-threads""]","[""31540671"", ""868112707"", ""51241574"", ""380648579"", ""3108351"", ""1367531"", ""409941587""]",11,6,17
123628014,15,127.46666666666667,-0.5108104387919108,13211075.0,7,0.8,"[""charliehebdo-all-rnr-threads"", ""germanwings-crash-all-rnr-threads"", ""ottawashooting-all-rnr-threads""]","[""868112707"", ""1652541"", ""51241574"", ""2097571"", ""807095"", ""428333"", ""5402612""]",12,3,15
1470299497,3,103.33333333333333,-0.4769522150357564,2025863.0,2,0.3333333333333333,"[""charliehebdo-all-rnr-threads"", ""sydneysiege-all-rnr-threads""]","[""140222976"", ""60937837""]",1,2,3
374712154,18,104.38888888888889,-0.2906619608402252,2210335.0,155,0.1111111111111111,"[""charliehebdo-all-rnr-threads"", ""sydneysiege-all-rnr-threads""]","[""42400054"", ""554252009"", ""2569354831"", ""2366083352"", ""591200125"", ""2830085132"", ""2214032103"", ""104616554"", ""102837987"", ""1856297318"", ""750440557"", ""523541134"", ""270689893"", ""2194470846"", ""88993731"", ""267386083"", ""2737956670"", ""2957163159"", ""2797647158"", ""2864105789"", ""1659942950"", ""1312219752"", ""336043194"", ""528907209"", ""156579343"", ""270303656"", ""104962266"", ""253148061"", ""524901955"", ""874990958"", ""324908191"", ""2829408083"", ""2759479710"", ""748805203"", ""187579804"", ""82539274"", ""990792691"", ""2548775964"", ""2861194665"", ""759054781"", ""755864660"", ""2544931616"", ""2457906037"", ""119790673"", ""472273612"", ""705821096"", ""84363967"", ""161646128"", ""621025433"", ""100366853"", ""60923128"", ""111475151"", ""2873005749"", ""47893477"", ""815819714"", ""393257551"", ""2378914268"", ""220335529"", ""778442436"", ""1620882618"", ""30489994"", ""1475561804"", ""544648929"", ""180691558"", ""2584501496"", ""1107096824"", ""1447501958"", ""1678517864"", ""149635489"", ""253718295"", ""76424015"", ""2551560350"", ""849774307"", ""519738120"", ""305134471"", ""797883"", ""629346699"", ""361871176"", ""2367650918"", ""2393898518"", ""1035143899"", ""44114927"", ""136039190"", ""15363272"", ""2376076501"", ""1724090454"", ""139876129"", ""1365890029"", ""1556259307"", ""1425201744"", ""2917355331"", ""281519746"", ""433092233"", ""47169273"", ""186402166"", ""2256850213"", ""33954990"", ""19590168"", ""172460337"", ""374712154"", ""1549066418"", ""44624022"", ""99929054"", ""408771028"", ""340279079"", ""2881721902"", ""426561297"", ""1425756199"", ""2586821739"", ""2952225639"", ""2854605922"", ""2412475357"", ""22490737"", ""5967972"", ""2933518570"", ""383486561"", ""2867085759"", ""950435708"", ""334403035"", ""417370448"", ""60015068"", ""26130987"", ""1921393303"", ""1676080584"", ""136486687"", ""1094958918"", ""2430012790"", ""261717097"", ""2328203634"", ""141184615"", ""2518908922"", ""390045810"", ""2249103743"", ""129960806"", ""130831261"", ""609610787"", ""1464666841"", ""2850250030"", ""2782657000"", ""433366025"", ""439987707"", ""78683199"", ""2499739573"", ""2881512375"", ""310178659"", ""180911295"", ""224820157"", ""823883521"", ""588726199"", ""183114110"", ""2304559924"", ""368202813"", ""268940576"", ""249419244"", ""2254379702""]",2,16,18
253148061,4,90.75,-0.21049804985523224,2198355.0,3,0.5,"[""charliehebdo-all-rnr-threads"", ""sydneysiege-all-rnr-threads""]","[""35466620"", ""19017675"", ""374712154""]",2,2,4
2376076501,14,90.5,-0.37590532643454416,2037272.0,3,1.0,"[""charliehebdo-all-rnr-threads"", ""sydneysiege-all-rnr-threads""]","[""742143"", ""64643056"", ""374712154""]",14,0,14
2686106365,8,95.625,-0.4432923272252083,2171348.0,7,0.5,"[""charliehebdo-all-rnr-threads"", ""sydneysiege-all-rnr-threads""]","[""220416676"", ""41789292"", ""16589206"", ""142375993"", ""18424289"", ""23055689"", ""64643056""]",4,4,8
788524,12,118.16666666666667,-0.13730333745479584,8554625.0,88,0.3333333333333333,"[""charliehebdo-all-rnr-threads"", ""germanwings-crash-all-rnr-threads"", ""sydneysiege-all-rnr-threads""]","[""272418128"", ""2856401319"", ""42338948"", ""84589989"", ""1080276308"", ""2578182110"", ""2511055330"", ""2178108763"", ""33468844"", ""1503342588"", ""386471045"", ""1701017059"", ""68020024"", ""317061389"", ""709262744"", ""345521045"", ""706914554"", ""12716032"", ""19831119"", ""25861408"", ""34103099"", ""386237033"", ""1096498950"", ""195036383"", ""2960208454"", ""505963188"", ""88455747"", ""2511203866"", ""180901428"", ""479841900"", ""136275253"", ""473948423"", ""19388832"", ""438269774"", ""15446865"", ""217158737"", ""25472797"", ""25512893"", ""82584691"", ""560501622"", ""703412466"", ""157217875"", ""309250376"", ""34438002"", ""2468306143"", ""2875761863"", ""244797164"", ""58552429"", ""279222734"", ""38445526"", ""2886586060"", ""1181431722"", ""1415648214"", ""2391593528"", ""414138120"", ""41108256"", ""2878242790"", ""722179561"", ""2906484513"", ""2264626602"", ""2437743015"", ""215303514"", ""802780646"", ""2464502209"", ""482186096"", ""558982443"", ""250485228"", ""66446988"", ""192830996"", ""18320185"", ""48843015"", ""1477840074"", ""2851170553"", ""1620303576"", ""2370908751"", ""2245441478"", ""280414048"", ""347866658"", ""1023541333"", ""32351459"", ""202141861"", ""20436360"", ""17206650"", ""255419444"", ""109535417"", ""105575933"", ""107497031"", ""23742736""]",4,8,12
2856401319,16,58.6875,0.8544922918081284,2200481.0,12,0.625,"[""charliehebdo-all-rnr-threads"", ""sydneysiege-all-rnr-threads""]","[""16973333"", ""5402612"", ""1717464030"", ""2097571"", ""2799960092"", ""2467791"", ""742143"", ""788524"", ""87818409"", ""47289823"", ""1123128290"", ""24506246""]",10,6,16
2888296032,9,86.66666666666667,-0.31471215354071724,1857983.0,4,0.1111111111111111,"[""charliehebdo-all-rnr-threads"", ""sydneysiege-all-rnr-threads""]","[""818212956"", ""15438913"", ""14700316"", ""14569869""]",1,8,9
921217862,15,80.13333333333331,-0.12425124247868856,6774189.0,4,0.9333333333333333,"[""charliehebdo-all-rnr-threads"", ""germanwings-crash-all-rnr-threads""]","[""16887175"", ""209176493"", ""210556794"", ""14569869""]",14,1,15
1234987687,28,75.17857142857142,-0.11188369137900216,2183646.0,10,0.25,"[""charliehebdo-all-rnr-threads"", ""sydneysiege-all-rnr-threads""]","[""14173315"", ""16973333"", ""7587032"", ""2097571"", ""807095"", ""14569869"", ""87416722"", ""742143"", ""2461887810"", ""5402612""]",7,21,28
325234656,42,96.50000000000003,-0.21181602705092656,12625236.0,11,0.11904761904761904,"[""charliehebdo-all-rnr-threads"", ""ottawashooting-all-rnr-threads"", ""ferguson-all-rnr-threads"", ""sydneysiege-all-rnr-threads""]","[""196994616"", ""483930658"", ""405743388"", ""141084952"", ""128216887"", ""53503202"", ""47448886"", ""15754281"", ""64643056"", ""34713362"", ""87818409""]",5,37,42
2461887810,10,111.9,-0.2645142138004303,6563139.0,103,0.2,"[""charliehebdo-all-rnr-threads"", ""germanwings-crash-all-rnr-threads""]","[""424210801"", ""569844526"", ""2279460956"", ""41232107"", ""2331193790"", ""2753139956"", ""205674104"", ""16663691"", ""2863136065"", ""2690444383"", ""181409722"", ""15253950"", ""469123571"", ""118737912"", ""321325544"", ""246344957"", ""1900639207"", ""14589287"", ""202007411"", ""496250143"", ""192576099"", ""328651689"", ""728007211"", ""16865661"", ""2248888893"", ""14121942"", ""2915138085"", ""1267085329"", ""345613431"", ""2858149972"", ""129982796"", ""2907646738"", ""1234987687"", ""228371144"", ""398103679"", ""25083690"", ""749363773"", ""2459278543"", ""38313468"", ""96309117"", ""2601585061"", ""2933943867"", ""299810381"", ""103833985"", ""517892482"", ""510996222"", ""63123365"", ""979536967"", ""313381710"", ""572838168"", ""268422365"", ""302591092"", ""1715676188"", ""23261825"", ""123819078"", ""2922814893"", ""49948272"", ""250313712"", ""53363343"", ""2690144502"", ""268982264"", ""2545788513"", ""1960426465"", ""40067735"", ""76702224"", ""2788131667"", ""2182289077"", ""325739748"", ""358266568"", ""551249407"", ""2826624542"", ""1252905090"", ""2734350850"", ""209006288"", ""579673145"", ""23410233"", ""264353249"", ""47692485"", ""39440211"", ""2959209283"", ""18848237"", ""402495088"", ""1186075405"", ""2235108830"", ""16346794"", ""2172659323"", ""2484640106"", ""302014943"", ""51708041"", ""2780648743"", ""1381183638"", ""34899435"", ""33953058"", ""58263099"", ""39215111"", ""174413779"", ""275561017"", ""2878291662"", ""20794142"", ""95191831"", ""1589413621"", ""193667532"", ""46923727""]",2,8,10
95191831,2,134.0,-0.5653385818004608,1974714.0,2,1.0,"[""charliehebdo-all-rnr-threads"", ""sydneysiege-all-rnr-threads""]","[""126629610"", ""2461887810""]",2,0,2
299810381,16,81.0,-0.11984068900346756,12686068.0,4,0.3125,"[""charliehebdo-all-rnr-threads"", ""ottawashooting-all-rnr-threads"", ""ferguson-all-rnr-threads""]","[""15956067"", ""292777349"", ""87416722"", ""2461887810""]",5,11,16
1184253228,6,100.16666666666667,-0.5610393782456716,1991171.0,3,0.3333333333333333,"[""charliehebdo-all-rnr-threads"", ""sydneysiege-all-rnr-threads""]","[""46078438"", ""87416722"", ""7587032""]",2,4,6
125344265,12,48.0,0.0277011642853419,8558410.0,6,0.3333333333333333,"[""charliehebdo-all-rnr-threads"", ""germanwings-crash-all-rnr-threads"", ""sydneysiege-all-rnr-threads""]","[""7587032"", ""807095"", ""759251"", ""742143"", ""1598644159"", ""5402612""]",4,8,12
21181417,2,117.0,-0.6220763921737671,1974866.0,2,1.0,"[""charliehebdo-all-rnr-threads"", ""sydneysiege-all-rnr-threads""]","[""16343974"", ""7587032""]",2,0,2
248784419,3,130.0,-0.3319013516108195,2001584.0,3,0.6666666666666666,"[""charliehebdo-all-rnr-threads"", ""sydneysiege-all-rnr-threads""]","[""28785486"", ""87818409"", ""16973333""]",2,1,3
600873514,20,121.45,-0.13074360191822051,2083089.0,2,0.05,"[""charliehebdo-all-rnr-threads"", ""sydneysiege-all-rnr-threads""]","[""71491041"", ""87818409""]",1,19,20
125323374,8,110.0,-0.40722930431365967,2028357.0,6,0.5,"[""charliehebdo-all-rnr-threads"", ""sydneysiege-all-rnr-threads""]","[""136658558"", ""238575113"", ""1855737487"", ""99238190"", ""129673790"", ""87818409""]",4,4,8
9199732,2,85.0,-0.08534842729568481,2016813.0,2,0.5,"[""charliehebdo-all-rnr-threads"", ""sydneysiege-all-rnr-threads""]","[""583697870"", ""2832527047""]",1,1,2
428333,60,125.41666666666669,-0.39977088967959085,13215777.0,792,0.65,"[""charliehebdo-all-rnr-threads"", ""germanwings-crash-all-rnr-threads"", ""ottawashooting-all-rnr-threads"", ""sydneysiege-all-rnr-threads""]","[""217055331"", ""18406193"", ""18108896"", ""228934489"", ""68320959"", ""575652263"", ""31370199"", ""768001130"", ""3028982049"", ""2967374193"", ""431421432"", ""2919219079"", ""605484104"", ""67706546"", ""5407582"", ""2387342700"", ""994773456"", ""1641012284"", ""114356391"", ""2270967824"", ""43521065"", ""33934323"", ""216917651"", ""17872080"", ""1056137328"", ""719716787"", ""235542898"", ""1407027576"", ""894883957"", ""2707815410"", ""254809254"", ""2820614454"", ""260828558"", ""2710733892"", ""110178536"", ""163414935"", ""1354971534"", ""471374343"", ""2882331822"", ""22529583"", ""2408067523"", ""1001874828"", ""1085491908"", ""331441395"", ""27639450"", ""1853637906"", ""162200800"", ""1483107697"", ""28504076"", ""1059286154"", ""2951111030"", ""94620112"", ""382772322"", ""2951344544"", ""2727937091"", ""2883972239"", ""94215989"", ""2614001430"", ""66895104"", ""1798194530"", ""143008727"", ""86031047"", ""1265677226"", ""232339766"", ""51997305"", ""2820669229"", ""2579863970"", ""322434618"", ""2867963191"", ""284680316"", ""2945042578"", ""41379801"", ""116051125"", ""1403764388"", ""2968810462"", ""460100728"", ""21719375"", ""2913196902"", ""13621362"", ""560501622"", ""592214012"", ""2560148358"", ""183114838"", ""2717034139"", ""18456360"", ""374543355"", ""929662333"", ""582379772"", ""899132934"", ""1401778878"", ""286112742"", ""2948856917"", ""266314455"", ""495984234"", ""153132339"", ""2954397523"", ""404859043"", ""2253741236"", ""2888060275"", ""377830295"", ""2928799080"", ""2892535205"", ""160547588"", ""333376270"", ""18628452"", ""2149120531"", ""2200208405"", ""711299852"", ""1649299933"", ""20965558"", ""59418279"", ""2889166382"", ""2899190458"", ""296614018"", ""34195205"", ""384017156"", ""240963660"", ""1323622694"", ""270632278"", ""258185657"", ""15561173"", ""50791051"", ""2940673723"", ""23659772"", ""2914095258"", ""344633710"", ""23173171"", ""1387709084"", ""49012188"", ""1400503214"", ""503580426"", ""591216069"", ""247984055"", ""282679800"", ""308766861"", ""150354744"", ""25653324"", ""1273480106"", ""213765161"", ""93000133"", ""1581252644"", ""433683299"", ""12153682"", ""255062000"", ""1953894126"", ""35517835"", ""192345792"", ""21009409"", ""456770213"", ""538607487"", ""2905376702"", ""2734465158"", ""86258834"", ""211466761"", ""2924214902"", ""2410469222"", ""1712159514"", ""2387369952"", ""2781592756"", ""555105566"", ""49831617"", ""1426347235"", ""2802014210"", ""13514302"", ""2299796699"", ""33914324"", ""453889433"", ""2769965322"", ""78778106"", ""1268384670"", ""468588961"", ""15787301"", ""25777686"", ""275682303"", ""180610640"", ""436160255"", ""2901750487"", ""2923601265"", ""1145247918"", ""403650696"", ""237095026"", ""1287354133"", ""5527802"", ""551515241"", ""238079492"", ""448355007"", ""29625450"", ""909185120"", ""120604845"", ""62946795"", ""2759357020"", ""274555846"", ""960825300"", ""18895196"", ""15486163"", ""226299861"", ""560326682"", ""541478566"", ""2774004135"", ""2957550943"", ""2493254086"", ""721014331"", ""47321124"", ""266214752"", ""918189576"", ""45974394"", ""495504874"", ""571680764"", ""25716701"", ""114560986"", ""343313301"", ""1150947134"", ""2578182110"", ""2851940892"", ""21004719"", ""951666278"", ""2483778283"", ""2797947636"", ""885822013"", ""1220742698"", ""356761170"", ""36033359"", ""2918668893"", ""540903074"", ""197351686"", ""546838312"", ""18978131"", ""2277151613"", ""1531347600"", ""128750531"", ""532018404"", ""437325585"", ""1547659670"", ""1070776237"", ""1600512696"", ""2807631246"", ""62936951"", ""242503872"", ""2318100722"", ""490112666"", ""2459845898"", ""356363837"", ""604838152"", ""2957564108"", ""22117813"", ""2924381315"", ""83463984"", ""20349790"", ""33823442"", ""123628014"", ""551580888"", ""8529412"", ""153614255"", ""436386926"", ""14364132"", ""589478737"", ""366920223"", ""1966130994"", ""245430783"", ""476853918"", ""2386276291"", ""2851551783"", ""101061732"", ""370113873"", ""2393429750"", ""46516447"", ""273465530"", ""5698002"", ""610448169"", ""298831926"", ""362682630"", ""405239489"", ""2920397503"", ""1852665702"", ""19477339"", ""632273490"", ""28586114"", ""278892288"", ""2748975280"", ""578550086"", ""2968442806"", ""83011949"", ""473472787"", ""80384548"", ""16249747"", ""633904501"", ""220981466"", ""244172414"", ""1378497379"", ""811987292"", ""2841464847"", ""1090948867"", ""2926384805"", ""527922389"", ""1062791150"", ""15540840"", ""274955258"", ""2384915342"", ""575893546"", ""2651807532"", ""31618419"", ""457408608"", ""17716401"", ""2820655370"", ""395175296"", ""1639380054"", ""372731520"", ""303548069"", ""45743399"", ""69032114"", ""222519523"", ""43835707"", ""276489319"", ""1595364620"", ""633599209"", ""423625300"", ""185274610"", ""324313635"", ""21983078"", ""17807907"", ""2746599417"", ""413256383"", ""485195363"", ""2498244122"", ""2844824016"", ""2739065282"", ""2295911619"", ""128917051"", ""2511764838"", ""2390675047"", ""516081144"", ""465064228"", ""2882386301"", ""2914447077"", ""73312315"", ""2768705528"", ""2550993804"", ""48514726"", ""130481825"", ""290919192"", ""17456631"", ""71632557"", ""28245169"", ""31219247"", ""851808528"", ""94476810"", ""60409406"", ""1062043729"", ""1111570514"", ""2736950783"", ""580250594"", ""535861270"", ""835704205"", ""311871892"", ""93015846"", ""124059210"", ""61549431"", ""135744132"", ""2916313959"", ""27443402"", ""1228429238"", ""567039350"", ""2599011133"", ""1668273642"", ""2252446281"", ""2183631739"", ""2844840980"", ""915381872"", ""399849293"", ""570878432"", ""2352483608"", ""174365756"", ""217628587"", ""16790082"", ""2953034384"", ""2431028329"", ""245078422"", ""83937568"", ""28096105"", ""2871103216"", ""1498965000"", ""455387087"", ""2463405720"", ""165335229"", ""22341211"", ""24708058"", ""305294287"", ""471130203"", ""334387917"", ""20228905"", ""2750309806"", ""2313132087"", ""15688765"", ""2885208507"", ""2881596451"", ""26111686"", ""2235666071"", ""1484007385"", ""326801831"", ""133496245"", ""2961649574"", ""581498468"", ""548597565"", ""376208743"", ""22583725"", ""104342504"", ""372464674"", ""15507696"", ""46363353"", ""17925470"", ""2215260181"", ""18142983"", ""498052677"", ""246494723"", ""19106885"", ""1023979585"", ""534470277"", ""851896567"", ""22516770"", ""2709280134"", ""278260486"", ""2391414056"", ""956333360"", ""61431442"", ""14401607"", ""270344378"", ""607311691"", ""2223008040"", ""30566879"", ""554800351"", ""617496223"", ""38506895"", ""32637134"", ""400839033"", ""631763272"", ""495396825"", ""2942756176"", ""199654709"", ""1546510892"", ""2956905160"", ""287125448"", ""68397297"", ""2883071500"", ""60656013"", ""2762702188"", ""2153254021"", ""244311410"", ""2835363378"", ""25783616"", ""251124675"", ""1530671437"", ""841460840"", ""64657863"", ""602748238"", ""200641413"", ""290459241"", ""429655417"", ""109986058"", ""193316623"", ""574068411"", ""2903328589"", ""3080470757"", ""263168815"", ""889283192"", ""2864052523"", ""249665279"", ""581956893"", ""271269141"", ""162505514"", ""816602323"", ""2593942390"", ""1531789724"", ""42802846"", ""229914862"", ""18262462"", ""327419172"", ""2322774504"", ""381925289"", ""2852446116"", ""2789153572"", ""14088487"", ""1374856999"", ""362069743"", ""2855452792"", ""24435341"", ""2841880077"", ""52858746"", ""13002422"", ""1282451174"", ""2933268905"", ""2490441158"", ""168292606"", ""2290894069"", ""58341062"", ""465060909"", ""32486745"", ""1339028496"", ""28779194"", ""1638700044"", ""2238236755"", ""476489992"", ""296565875"", ""1030435626"", ""252978405"", ""22949556"", ""2423599832"", ""2966758517"", ""2939151633"", ""277199547"", ""574078070"", ""101455388"", ""361342191"", ""1882846454"", ""1527156632"", ""230314591"", ""2672830001"", ""255269261"", ""263372653"", ""1074177096"", ""84135023"", ""2738332984"", ""220911561"", ""22231090"", ""41142917"", ""84395388"", ""17051492"", ""1380817154"", ""225158916"", ""135342947"", ""392850275"", ""413532500"", ""113140158"", ""10929352"", ""2373363316"", ""1007547482"", ""2489876530"", ""30558459"", ""183963324"", ""159326487"", ""1226405322"", ""568658436"", ""2370908751"", ""2851495712"", ""1656323702"", ""97385791"", ""395700090"", ""43452377"", ""2252890903"", ""1722891991"", ""2962767400"", ""506531851"", ""19833480"", ""1132256414"", ""125570941"", ""22785299"", ""2770526415"", ""2745054880"", ""705041041"", ""34037126"", ""706591231"", ""46457211"", ""16799679"", ""18373162"", ""2840615938"", ""15448383"", ""14066645"", ""567326156"", ""425927063"", ""353872437"", ""262062797"", ""50715179"", ""908892343"", ""83421448"", ""308405974"", ""964564261"", ""120624301"", ""2927951094"", ""422630890"", ""1401796688"", ""1091725316"", ""75570359"", ""370775638"", ""315563199"", ""201830233"", ""1723392776"", ""1683759440"", ""2723735572"", ""2848495516"", ""49129524"", ""271464960"", ""54382716"", ""2847568642"", ""2895190942"", ""80870096"", ""19746413"", ""41542221"", ""2822334048"", ""22255757"", ""961195663"", ""153320499"", ""57685967"", ""2310813366"", ""1598745301"", ""989861202"", ""198945680"", ""221313465"", ""23153001"", ""302835484"", ""94521037"", ""23163280"", ""2247784187"", ""302545205"", ""15237651"", ""2825162425"", ""42441337"", ""2779009591"", ""49594954"", ""1337411749"", ""29870604"", ""1085149063"", ""908308074"", ""2869447347"", ""635531001"", ""546007788"", ""19009612"", ""484928307"", ""349695893"", ""2820517345"", ""1454291318"", ""256777394"", ""6107292"", ""197281871"", ""581498356"", ""549181612"", ""2222065434"", ""2839980607"", ""27613671"", ""72732893"", ""1897230871"", ""2826262117"", ""1303697892"", ""1401990523"", ""1380691543"", ""2287441302"", ""37425092"", ""51638400"", ""2532068489"", ""159113248"", ""377784434"", ""2801729758"", ""23598656"", ""189471696"", ""73984296"", ""40265608"", ""69670513"", ""1129948747"", ""607656892"", ""2459278543"", ""552311939"", ""17909802"", ""279458880"", ""2672853774"", ""2775459239"", ""142348663"", ""16394834"", ""2615230232"", ""2896594581"", ""34628686"", ""1717385322"", ""2908632329"", ""427402721"", ""16672155"", ""2233538694"", ""24156429"", ""2410765508"", ""2962020892"", ""26282817"", ""426740892"", ""885667550"", ""1405804914"", ""279788564"", ""249758109"", ""86622558"", ""2278261981"", ""587383223"", ""2875187686"", ""23731228"", ""287183523"", ""417245795"", ""2859219236"", ""479107251"", ""38392608"", ""65626531"", ""2649962737"", ""2880204155"", ""21492478"", ""40686646"", ""52852023"", ""409612069"", ""23280163"", ""2388191276"", ""2824442646"", ""233931728"", ""514718176"", ""14148401"", ""500618656"", ""263591595"", ""16105433"", ""237060482"", ""129456715"", ""2567764124"", ""465790247"", ""25090561"", ""495590449"", ""1719920148"", ""480410734"", ""538765846"", ""356955115"", ""2573215164"", ""625802134"", ""54727574"", ""119929804"", ""706219970"", ""238080130"", ""148516959"", ""42499580"", ""722482357"", ""522667670"", ""2903518905"", ""258613949"", ""203957869"", ""378973056"", ""2256170946"", ""2204367110"", ""16737566"", ""52088553"", ""2232898030"", ""2820662814"", ""599875685"", ""348234872"", ""49612919"", ""930963812"", ""155555466"", ""2854290994"", ""324543615"", ""2276289300"", ""20684877"", ""14251590"", ""232768146"", ""760009814"", ""34683698"", ""2814335771"", ""2766825913"", ""948960408"", ""238413353"", ""111973640"", ""475339954"", ""22149851"", ""366828438"", ""245051629"", ""388058926"", ""41404457"", ""2713561860"", ""118552439"", ""10511132"", ""32528255"", ""1460949097"", ""2152009104"", ""2892268329"", ""2820425244"", ""1541231959"", ""1021042393"", ""71566083"", ""863113304"", ""116263410"", ""1713200654"", ""1447605738"", ""41422666"", ""566914371"", ""79802631"", ""49793399"", ""346733298"", ""117631162"", ""2711627775"", ""15844512"", ""109360656"", ""2153036188"", ""40525902"", ""21725560"", ""36929868"", ""80417844"", ""26810243""]",39,21,60
197351686,3,65.33333333333333,-0.17535694440205893,2029979.0,3,0.6666666666666666,"[""charliehebdo-all-rnr-threads"", ""sydneysiege-all-rnr-threads""]","[""1630896181"", ""5402612"", ""428333""]",2,1,3
22583725,7,96.85714285714286,0.1345814381326948,6640750.0,3,0.8571428571428571,"[""charliehebdo-all-rnr-threads"", ""ottawashooting-all-rnr-threads"", ""sydneysiege-all-rnr-threads""]","[""18144581"", ""22129280"", ""428333""]",6,1,7
540903074,16,117.125,-0.4893976151943207,6818163.0,9,0.5625,"[""charliehebdo-all-rnr-threads"", ""ottawashooting-all-rnr-threads""]","[""271413771"", ""351120282"", ""15224867"", ""344281070"", ""19814041"", ""501768982"", ""16012783"", ""322572436"", ""428333""]",9,7,16
287183523,19,105.21052631578948,-0.4714695874013399,6838419.0,6,0.42105263157894735,"[""charliehebdo-all-rnr-threads"", ""ottawashooting-all-rnr-threads""]","[""121817564"", ""1367531"", ""2097571"", ""203123011"", ""83638901"", ""428333""]",8,11,19
17004618,2,127.0,-0.3741159439086914,2034228.0,32,1.0,"[""charliehebdo-all-rnr-threads"", ""sydneysiege-all-rnr-threads""]","[""1398582079"", ""17017548"", ""2723735572"", ""273380867"", ""2268655708"", ""899096840"", ""2316193393"", ""111835051"", ""264478693"", ""235049256"", ""2960600946"", ""21159892"", ""247982939"", ""552117307"", ""424946289"", ""39916487"", ""613440304"", ""2464502209"", ""228258026"", ""2884101328"", ""335107341"", ""131111772"", ""1659233256"", ""401862528"", ""25877017"", ""14869994"", ""2237451721"", ""43984700"", ""15861899"", ""2650963080"", ""2819189783"", ""50620384""]",2,0,2
552117307,2,132.0,-0.39653900265693665,2030400.0,2,1.0,"[""charliehebdo-all-rnr-threads"", ""sydneysiege-all-rnr-threads""]","[""17004618"", ""2097571""]",2,0,2
1398582079,2,76.5,-0.6112765967845917,2026481.0,2,0.5,"[""charliehebdo-all-rnr-threads"", ""sydneysiege-all-rnr-threads""]","[""7702542"", ""17004618""]",1,1,2
2567292679,3,113.66666666666667,-0.10954145590464275,2150026.0,3,1.0,"[""charliehebdo-all-rnr-threads"", ""sydneysiege-all-rnr-threads""]","[""16183458"", ""380648579"", ""42407972""]",3,0,3
34713362,7,119.42857142857143,-0.37294786317007883,2217559.0,63,0.5714285714285714,"[""charliehebdo-all-rnr-threads"", ""sydneysiege-all-rnr-threads""]","[""47502031"", ""2429562680"", ""178026053"", ""27297014"", ""86796377"", ""2473498570"", ""404290044"", ""165412746"", ""447097903"", ""1202412145"", ""379165619"", ""21471016"", ""261945431"", ""133615938"", ""58817868"", ""1480845120"", ""2889591523"", ""18142983"", ""41358463"", ""326909819"", ""1931711646"", ""16607919"", ""2827611330"", ""325234656"", ""385195352"", ""2904681641"", ""2693848200"", ""16408867"", ""134871277"", ""350170190"", ""2434349067"", ""2157633218"", ""363145371"", ""2413562079"", ""172258142"", ""22154657"", ""2464502209"", ""204367553"", ""72277004"", ""18315361"", ""2513043992"", ""59300026"", ""16491993"", ""81897467"", ""290387782"", ""1591762152"", ""483528697"", ""1213237104"", ""227965358"", ""252787867"", ""1334128494"", ""157275139"", ""306767945"", ""53905269"", ""135082720"", ""342695240"", ""16223558"", ""1180743055"", ""2190716904"", ""2272063722"", ""2654587483"", ""2878745356"", ""200641413""]",4,3,7
21525006,2,92.0,0.20651185512542725,2008727.0,2,1.0,"[""charliehebdo-all-rnr-threads"", ""sydneysiege-all-rnr-threads""]","[""22724717"", ""21749564""]",2,0,2
226475070,2,72.5,-0.6868414878845215,2002442.0,2,1.0,"[""charliehebdo-all-rnr-threads"", ""sydneysiege-all-rnr-threads""]","[""16589206"", ""21749564""]",2,0,2
324908191,8,99.5,-0.23100674152374268,2172816.0,7,0.375,"[""charliehebdo-all-rnr-threads"", ""sydneysiege-all-rnr-threads""]","[""269167743"", ""21749564"", ""14700117"", ""15438913"", ""742143"", ""374712154"", ""5402612""]",3,5,8
110314533,6,67.0,-0.12251423796017964,2032621.0,5,0.5,"[""charliehebdo-all-rnr-threads"", ""sydneysiege-all-rnr-threads""]","[""271413771"", ""18965916"", ""21749564"", ""204832963"", ""2768501""]",3,3,6
15754281,24,121.33333333333333,-0.45315323770046234,19520105.0,187,0.5416666666666666,"[""charliehebdo-all-rnr-threads"", ""germanwings-crash-all-rnr-threads"", ""sydneysiege-all-rnr-threads"", ""ottawashooting-all-rnr-threads"", ""ferguson-all-rnr-threads""]","[""107031620"", ""1351063537"", ""22435220"", ""21952628"", ""23973831"", ""113361389"", ""190280139"", ""2339262414"", ""359013156"", ""1109685884"", ""221091564"", ""1566494670"", ""281202163"", ""430379404"", ""1921507278"", ""18142983"", ""1503342588"", ""258869694"", ""2194219524"", ""628038157"", ""20386888"", ""26550151"", ""1379477982"", ""705123059"", ""1349929171"", ""473730677"", ""43521065"", ""279416849"", ""492039176"", ""2264375440"", ""22291404"", ""78898625"", ""18650447"", ""1339552872"", ""2945865278"", ""56666374"", ""104299137"", ""2231108696"", ""1863699235"", ""73279371"", ""417871797"", ""326331226"", ""16538186"", ""391024828"", ""747289232"", ""485534407"", ""18821140"", ""61755415"", ""2318100722"", ""2818826268"", ""15421689"", ""560697217"", ""256456300"", ""234912898"", ""542925160"", ""1344316574"", ""15754281"", ""373100052"", ""359015191"", ""524659763"", ""36654629"", ""359370558"", ""334347402"", ""20882772"", ""1596060386"", ""15922161"", ""2826961293"", ""24269325"", ""476853918"", ""2363741781"", ""102851271"", ""132586100"", ""2940041869"", ""466785227"", ""2311197780"", ""2705888250"", ""408864557"", ""60851980"", ""2492020338"", ""592214012"", ""455931830"", ""2756134454"", ""31761198"", ""198012457"", ""1545832794"", ""874649498"", ""412690571"", ""2875761863"", ""112233466"", ""629015556"", ""1934787661"", ""17124173"", ""190095658"", ""35222419"", ""340923136"", ""517259100"", ""1071027804"", ""2853513981"", ""2894958605"", ""353187983"", ""2227563385"", ""2866589902"", ""2341221866"", ""2886586060"", ""21043723"", ""327311364"", ""25425818"", ""139849976"", ""1534712844"", ""949990633"", ""2484664106"", ""307184329"", ""56735779"", ""118545746"", ""2964610828"", ""2720563708"", ""149286219"", ""27924172"", ""2373783968"", ""18558137"", ""2862319827"", ""1494212108"", ""17436585"", ""813486180"", ""34990733"", ""1350577488"", ""21952661"", ""16062207"", ""503580426"", ""1915761794"", ""601342849"", ""2320301251"", ""538765846"", ""84851408"", ""192638247"", ""2256516282"", ""534328852"", ""36394205"", ""2976256067"", ""2484630409"", ""224060482"", ""760544600"", ""2411458885"", ""575857218"", ""240114180"", ""215794445"", ""1523623633"", ""28201964"", ""256358298"", ""2427067352"", ""2931709299"", ""1093122908"", ""20391491"", ""110499349"", ""2612126299"", ""2846816373"", ""147394873"", ""17290237"", ""1534755738"", ""325234656"", ""260230031"", ""27036172"", ""526774128"", ""2885348567"", ""2322095298"", ""473009843"", ""2345690030"", ""15754900"", ""26695982"", ""81943051"", ""139238453"", ""293420884"", ""1849407440"", ""2798972827"", ""56097286"", ""235255071"", ""2730745842"", ""164809259"", ""807743592"", ""81142305"", ""41553061"", ""280587878"", ""28626894"", ""2693480258"", ""20978217"", ""394333801"", ""2468342486""]",13,11,24
575857218,3,103.33333333333333,-0.25163060426712036,2023871.0,3,0.6666666666666666,"[""charliehebdo-all-rnr-threads"", ""sydneysiege-all-rnr-threads""]","[""15754281"", ""17995040"", ""16031927""]",2,1,3
18581038,2,137.0,-0.0604134202003479,6563031.0,2,0.5,"[""charliehebdo-all-rnr-threads"", ""germanwings-crash-all-rnr-threads""]","[""134196350"", ""64643056""]",1,1,2
394142623,3,61.333333333333336,-0.09669460852940877,1980899.0,1,0.3333333333333333,"[""charliehebdo-all-rnr-threads"", ""sydneysiege-all-rnr-threads""]","[""64643056""]",1,2,3
10715902,12,94.5,-0.19232875108718872,2151505.0,6,0.16666666666666666,"[""charliehebdo-all-rnr-threads"", ""sydneysiege-all-rnr-threads""]","[""459390022"", ""15798091"", ""2566535282"", ""3108351"", ""136004952"", ""1053365834""]",2,10,12
1475403872,2,96.5,-0.6500467956066132,6735282.0,1,1.0,"[""charliehebdo-all-rnr-threads"", ""germanwings-crash-all-rnr-threads""]","[""2566535282""]",2,0,2
1569707556,18,105.72222222222223,-0.338408178753323,2077250.0,4,0.3888888888888889,"[""charliehebdo-all-rnr-threads"", ""sydneysiege-all-rnr-threads""]","[""344281070"", ""15143478"", ""3108351"", ""64643056""]",7,11,18
326140439,4,124.0,-0.328230157494545,6568536.0,5,0.5,"[""charliehebdo-all-rnr-threads"", ""germanwings-crash-all-rnr-threads""]","[""14293310"", ""168376502"", ""1645064149"", ""501768982"", ""125570941""]",2,2,4
28837388,7,62.42857142857143,-0.18742803164890834,12997085.0,7,0.2857142857142857,"[""charliehebdo-all-rnr-threads"", ""ferguson-all-rnr-threads""]","[""14293310"", ""61149653"", ""611585332"", ""14090948"", ""325340909"", ""770759270"", ""17072206""]",2,5,7
507561137,2,121.5,-0.49225085973739624,6634864.0,2,1.0,"[""charliehebdo-all-rnr-threads"", ""ottawashooting-all-rnr-threads""]","[""51241574"", ""14293310""]",2,0,2
2201464242,4,117.0,-0.38468922674655914,12687687.0,3,0.5,"[""charliehebdo-all-rnr-threads"", ""ferguson-all-rnr-threads""]","[""952112047"", ""14293310"", ""195271137""]",2,2,4
44464005,13,105.53846153846153,-0.24060943951973549,2191143.0,3,0.15384615384615385,"[""charliehebdo-all-rnr-threads"", ""sydneysiege-all-rnr-threads""]","[""16973333"", ""7587032"", ""5402612""]",2,11,13
150219628,21,91.28571428571429,-0.2882904892876035,2009507.0,1,0.9047619047619048,"[""charliehebdo-all-rnr-threads"", ""sydneysiege-all-rnr-threads""]","[""7587032""]",19,2,21
423662810,12,101.5,-0.39690572023391724,12916005.0,75,0.8333333333333334,"[""charliehebdo-all-rnr-threads"", ""ottawashooting-all-rnr-threads"", ""ferguson-all-rnr-threads"", ""sydneysiege-all-rnr-threads""]","[""1310344602"", ""275538252"", ""19815846"", ""165369712"", ""555532124"", ""54751665"", ""297967623"", ""303328043"", ""326936495"", ""2755585124"", ""2313262152"", ""541866571"", ""289352032"", ""103396707"", ""175176750"", ""19642191"", ""40383569"", ""368641558"", ""594766932"", ""708086066"", ""51962082"", ""59384316"", ""85935745"", ""257712285"", ""1526673276"", ""2195487036"", ""2825597273"", ""17436585"", ""396665411"", ""2379201713"", ""17291610"", ""58237409"", ""468940017"", ""215058742"", ""1424533340"", ""2883185098"", ""423662810"", ""380058173"", ""34557610"", ""2147851824"", ""2581929888"", ""2837858684"", ""2213098404"", ""2686761836"", ""242096041"", ""1442580457"", ""193959062"", ""56509416"", ""15091678"", ""867201332"", ""14090948"", ""327295143"", ""35943251"", ""2734020596"", ""869226241"", ""1878549530"", ""230442970"", ""47239788"", ""174772293"", ""2787477375"", ""2439569372"", ""2267528078"", ""29891281"", ""1104692737"", ""251992389"", ""2725109187"", ""66963308"", ""57571538"", ""2597593818"", ""1348798826"", ""7838552"", ""2791639902"", ""993643850"", ""47473609"", ""8754802""]",10,2,12
152891927,18,102.61111111111111,-0.00016590290599399142,2075817.0,11,0.1111111111111111,"[""charliehebdo-all-rnr-threads"", ""sydneysiege-all-rnr-threads""]","[""19317766"", ""16973333"", ""485249248"", ""168376502"", ""7587032"", ""380648579"", ""20043786"", ""37881687"", ""35466620"", ""239964092"", ""36412963""]",2,16,18
2201786204,31,93.16129032258064,-0.33620379048009075,2323139.0,4,0.1935483870967742,"[""charliehebdo-all-rnr-threads"", ""sydneysiege-all-rnr-threads""]","[""18424289"", ""55195680"", ""239964092"", ""19346439""]",6,25,31
2351339382,7,92.14285714285714,-0.39011884587151663,5645809.0,6,0.5714285714285714,"[""charliehebdo-all-rnr-threads"", ""putinmissing-all-rnr-threads""]","[""52003080"", ""5858532"", ""171953871"", ""64643056"", ""16012783"", ""793879086""]",4,3,7
414653470,5,115.6,-0.709157657623291,2163334.0,2,0.4,"[""charliehebdo-all-rnr-threads"", ""sydneysiege-all-rnr-threads""]","[""1562935142"", ""64643056""]",2,3,5
2841491128,8,88.5,-0.24003329873085022,2060543.0,4,0.25,"[""charliehebdo-all-rnr-threads"", ""sydneysiege-all-rnr-threads""]","[""16973333"", ""7587032"", ""64643056"", ""5402612""]",2,6,8
2193206563,5,59.8,-0.15252091884613037,6647990.0,2,0.2,"[""charliehebdo-all-rnr-threads"", ""ottawashooting-all-rnr-threads""]","[""16973333"", ""164075542""]",1,4,5
1093195092,7,100.14285714285714,-0.3152805396488735,12516082.0,2,0.14285714285714285,"[""charliehebdo-all-rnr-threads"", ""ferguson-all-rnr-threads""]","[""16973333"", ""319777415""]",1,6,7
22342990,6,75.83333333333333,0.005870044231414795,2035749.0,4,0.3333333333333333,"[""charliehebdo-all-rnr-threads"", ""sydneysiege-all-rnr-threads""]","[""6017542"", ""3108351"", ""36311109"", ""1960878613""]",2,4,6
2584501496,28,105.03571428571429,-0.11302087136677333,8585902.0,11,0.07142857142857142,"[""charliehebdo-all-rnr-threads"", ""germanwings-crash-all-rnr-threads"", ""sydneysiege-all-rnr-threads""]","[""1408003598"", ""28139873"", ""16973333"", ""36311109"", ""16807528"", ""1125937411"", ""3108351"", ""16343974"", ""1367531"", ""15513604"", ""374712154""]",2,26,28
266554539,3,132.66666666666666,-0.5504204034805298,6561686.0,3,0.6666666666666666,"[""charliehebdo-all-rnr-threads"", ""germanwings-crash-all-rnr-threads""]","[""1652541"", ""3108351"", ""64643056""]",2,1,3
200641413,9,56.77777777777778,-0.13824103938208687,2168479.0,9,0.5555555555555556,"[""charliehebdo-all-rnr-threads"", ""sydneysiege-all-rnr-threads""]","[""14173315"", ""807095"", ""3108351"", ""759251"", ""2467791"", ""34713362"", ""156464691"", ""15012486"", ""428333""]",5,4,9
1630896181,9,127.0,-0.4669229785601298,12706135.0,93,0.5555555555555556,"[""charliehebdo-all-rnr-threads"", ""sydneysiege-all-rnr-threads"", ""ferguson-all-rnr-threads""]","[""406727474"", ""23586157"", ""25496455"", ""53298305"", ""306447291"", ""407393101"", ""53901975"", ""395711027"", ""1679359094"", ""1131873528"", ""13222472"", ""566858667"", ""2816099904"", ""32349735"", ""928067310"", ""197351686"", ""2942351439"", ""1022294935"", ""2725109187"", ""951964526"", ""228332540"", ""17888833"", ""1223667216"", ""2397562590"", ""200319021"", ""546353513"", ""2833017615"", ""2858680249"", ""2334214846"", ""546742999"", ""399677423"", ""250662265"", ""25206663"", ""604623068"", ""446276492"", ""2932422959"", ""46026799"", ""206389248"", ""28173645"", ""768311516"", ""34446512"", ""899803861"", ""2451878102"", ""7439352"", ""46273199"", ""2306178093"", ""41617733"", ""1356094878"", ""2875917137"", ""244316028"", ""743094138"", ""939295970"", ""2952859347"", ""176853382"", ""2516920201"", ""32189808"", ""1381927082"", ""191517957"", ""169894743"", ""1195149150"", ""27443948"", ""222119096"", ""2491343202"", ""263940105"", ""134219547"", ""303772616"", ""267736032"", ""460441079"", ""920277535"", ""30578719"", ""2788602386"", ""2453850531"", ""2935490089"", ""371631913"", ""1630896181"", ""2178724328"", ""1860970033"", ""564421695"", ""73189676"", ""55949344"", ""2486471330"", ""49763576"", ""353147411"", ""49044080"", ""488506071"", ""581942293"", ""1072387866"", ""2715573733"", ""142071772"", ""2822788842"", ""175657091"", ""2806676274"", ""108563943""]",5,4,9
25206663,25,93.56,-0.32636518955230714,6827498.0,13,0.2,"[""charliehebdo-all-rnr-threads"", ""ottawashooting-all-rnr-threads""]","[""1630896181"", ""16721461"", ""868112707"", ""340441440"", ""19533817"", ""427515851"", ""1652541"", ""149913262"", ""380648579"", ""292777349"", ""7589572"", ""16343974"", ""17175213""]",5,20,25
759251,28,133.32142857142858,-0.4170866757631302,19305724.0,380,0.35714285714285715,"[""charliehebdo-all-rnr-threads"", ""germanwings-crash-all-rnr-threads"", ""sydneysiege-all-rnr-threads"", ""ottawashooting-all-rnr-threads"", ""ferguson-all-rnr-threads""]","[""68905747"", ""34842179"", ""40769714"", ""1099717518"", ""2786024854"", ""80376691"", ""39432465"", ""2788975302"", ""194931990"", ""251878533"", ""177543335"", ""95217333"", ""1058287999"", ""2174716046"", ""27257908"", ""149249419"", ""202038058"", ""327994582"", ""141684250"", ""790783038"", ""1939076610"", ""987413828"", ""316226298"", ""169272033"", ""2343270212"", ""1162137932"", ""117092236"", ""2983423492"", ""139660121"", ""224072314"", ""929662333"", ""230914235"", ""589525058"", ""2737827112"", ""111579633"", ""2586207838"", ""87062247"", ""51571100"", ""314003530"", ""57445261"", ""119373329"", ""1597310269"", ""372625621"", ""44161696"", ""43217160"", ""2434406185"", ""533667289"", ""146394404"", ""113161641"", ""349708100"", ""19557811"", ""202633092"", ""179981249"", ""1960426465"", ""214531763"", ""94788907"", ""271393276"", ""2312340767"", ""917497788"", ""86726621"", ""942675320"", ""1273480106"", ""105478418"", ""48843015"", ""46983871"", ""24524722"", ""148953609"", ""302425104"", ""155080991"", ""214224689"", ""3005762823"", ""22924662"", ""30372911"", ""1687837032"", ""288198074"", ""1109948761"", ""56678586"", ""60111050"", ""29625450"", ""248131395"", ""123303878"", ""1081973952"", ""45029442"", ""2955269027"", ""231244784"", ""2738650307"", ""19398213"", ""288471798"", ""457481692"", ""177972446"", ""402744581"", ""2959799731"", ""2587624195"", ""14631369"", ""387842150"", ""133107989"", ""157134686"", ""245414893"", ""21837233"", ""490065494"", ""23263760"", ""151361845"", ""238197580"", ""51452048"", ""434668135"", ""2312348246"", ""1589098614"", ""17112197"", ""2531111359"", ""56030702"", ""35865777"", ""63463165"", ""30626499"", ""16297024"", ""1209814933"", ""2952556292"", ""1305673812"", ""54802178"", ""430749539"", ""127666780"", ""3017516320"", ""287439671"", ""2718860162"", ""18324871"", ""84429722"", ""63868222"", ""953122789"", ""286280825"", ""302903787"", ""1852665702"", ""148855072"", ""489865470"", ""122027688"", ""1901191638"", ""2321395454"", ""1857973608"", ""233396666"", ""79217329"", ""47454715"", ""26556332"", ""269016791"", ""91235530"", ""49389806"", ""276273324"", ""1353271412"", ""456510060"", ""870389288"", ""387516768"", ""42552146"", ""465076617"", ""2436335941"", ""132040668"", ""2730452773"", ""128917051"", ""1380943194"", ""81726886"", ""134863416"", ""134151257"", ""352908624"", ""155950538"", ""2840716863"", ""42650881"", ""858810572"", ""2176103106"", ""920866298"", ""404249705"", ""2910413544"", ""2301966008"", ""311359507"", ""467923904"", ""177117566"", ""967164217"", ""34290630"", ""190352365"", ""20391491"", ""69212244"", ""35704124"", ""77755525"", ""2780648743"", ""2183631739"", ""217628587"", ""134592398"", ""363037578"", ""15321243"", ""21479865"", ""1426211654"", ""2741829395"", ""181557884"", ""569801700"", ""426453747"", ""744921588"", ""44312464"", ""24604505"", ""924584022"", ""618811816"", ""566487841"", ""369859193"", ""81260589"", ""390679655"", ""379483584"", ""27168890"", ""244959636"", ""176484991"", ""286356260"", ""151658729"", ""496353354"", ""2690397787"", ""1420787767"", ""636036496"", ""1117142131"", ""20275809"", ""16375770"", ""546959906"", ""3070885715"", ""503782099"", ""161026267"", ""2350051369"", ""200641413"", ""1738299560"", ""1569304639"", ""2855109985"", ""30688155"", ""72066972"", ""102934053"", ""1382799344"", ""378639234"", ""76492895"", ""331233087"", ""22351659"", ""83760226"", ""1206279740"", ""2167026835"", ""1904877384"", ""1531789724"", ""60482694"", ""91653957"", ""2960455347"", ""1160950970"", ""27520704"", ""60438114"", ""293701873"", ""2536796111"", ""1486767462"", ""602033727"", ""34446512"", ""201631665"", ""295547934"", ""2314092451"", ""1030435626"", ""234083699"", ""517656712"", ""12846992"", ""37021199"", ""45526752"", ""209220162"", ""255269261"", ""220930776"", ""2560060409"", ""2935011081"", ""535761994"", ""330577722"", ""803365566"", ""323424369"", ""21263260"", ""218218274"", ""68956490"", ""2378059878"", ""557344637"", ""22873947"", ""2370908751"", ""227108716"", ""2541596221"", ""804942871"", ""46671533"", ""125570941"", ""2845342548"", ""285306823"", ""2393673055"", ""714209622"", ""1939465026"", ""26753306"", ""913941019"", ""15738060"", ""1849407440"", ""15793875"", ""156116115"", ""125344265"", ""70019283"", ""75665895"", ""230044046"", ""2723735572"", ""74923050"", ""261121099"", ""2730365841"", ""464827890"", ""231859462"", ""759251"", ""65426411"", ""2227636212"", ""172279135"", ""15367365"", ""158487840"", ""19804800"", ""444387971"", ""1016976828"", ""586696592"", ""2621800250"", ""720097766"", ""24452368"", ""15162467"", ""132330530"", ""77957493"", ""1085149063"", ""17297649"", ""1348798826"", ""427182981"", ""1516705844"", ""255439171"", ""457692035"", ""129460208"", ""571937056"", ""69670513"", ""2459278543"", ""1401081260"", ""2558947681"", ""953958546"", ""242748561"", ""81374146"", ""22152709"", ""65242370"", ""248093850"", ""885667550"", ""15183759"", ""291424247"", ""1059399253"", ""178411533"", ""2734300973"", ""2480267495"", ""112426062"", ""2824442646"", ""43369293"", ""267596181"", ""21368516"", ""49770741"", ""2657050459"", ""216060257"", ""1541966965"", ""1933481100"", ""402822803"", ""90084196"", ""19691570"", ""2491358210"", ""26602717"", ""124262298"", ""378973056"", ""78869025"", ""1184315592"", ""334609466"", ""725595571"", ""2900938994"", ""177634356"", ""1282292556"", ""1077831362"", ""448812885"", ""1852769262"", ""328474622"", ""179803139"", ""2960946279"", ""2445448106"", ""321428477"", ""1443853454"", ""615110937"", ""421472267"", ""50731557"", ""807743592"", ""216252276"", ""588284880"", ""18627369"", ""1168840772"", ""2835206378""]",10,18,28
111579633,4,64.25,-0.15759703516960144,2115711.0,3,0.5,"[""charliehebdo-all-rnr-threads"", ""sydneysiege-all-rnr-threads""]","[""759251"", ""1634077976"", ""28785486""]",2,2,4
178411533,3,86.0,0.46010541915893555,6646564.0,3,0.3333333333333333,"[""charliehebdo-all-rnr-threads"", ""ottawashooting-all-rnr-threads""]","[""193725962"", ""759251"", ""39728435""]",1,2,3
177543335,3,140.66666666666666,-0.30148832003275555,2025503.0,3,0.3333333333333333,"[""charliehebdo-all-rnr-threads"", ""sydneysiege-all-rnr-threads""]","[""36311109"", ""759251"", ""25803703""]",1,2,3
18424289,13,133.6153846153846,-0.4384021208836482,8598476.0,106,0.46153846153846156,"[""charliehebdo-all-rnr-threads"", ""germanwings-crash-all-rnr-threads"", ""sydneysiege-all-rnr-threads""]","[""2589988879"", ""264103932"", ""1050521179"", ""2640651999"", ""18210569"", ""28415140"", ""1111221290"", ""320088703"", ""2476021071"", ""22526817"", ""2731866714"", ""2830305847"", ""1949272500"", ""1572315950"", ""797743976"", ""2563809408"", ""1324736137"", ""192773586"", ""30887950"", ""502313818"", ""2302159284"", ""2602730288"", ""2933173971"", ""75687321"", ""179085106"", ""23698809"", ""2480368868"", ""613345582"", ""2491948466"", ""2886894341"", ""2617597213"", ""489627329"", ""316561698"", ""40210819"", ""546353513"", ""2396462640"", ""105497418"", ""509054962"", ""246801406"", ""62550901"", ""2560148358"", ""118950574"", ""1198971475"", ""2875761863"", ""2201786204"", ""375742021"", ""186457433"", ""122384979"", ""2686396124"", ""269460044"", ""28107803"", ""2536796111"", ""900497136"", ""619369088"", ""2294804946"", ""1319453274"", ""83644445"", ""844297722"", ""49948272"", ""2686106365"", ""1428883938"", ""1377275815"", ""2823532027"", ""327760525"", ""401319224"", ""463653182"", ""16071327"", ""14800024"", ""455394628"", ""13182342"", ""3045028731"", ""31209090"", ""28313717"", ""255062000"", ""50427352"", ""2276434226"", ""2727254073"", ""482920079"", ""307531686"", ""2398461846"", ""23682743"", ""27715194"", ""1030837254"", ""184510373"", ""613015171"", ""276549748"", ""377540405"", ""274509374"", ""2172659323"", ""217761175"", ""2311015496"", ""103350059"", ""283937135"", ""263285930"", ""168605167"", ""1480842452"", ""617936301"", ""1654112761"", ""324485303"", ""298181340"", ""100482942"", ""1091725316"", ""224433933"", ""29577416"", ""190217639"", ""45282172""]",6,7,13
34262462,4,117.75,-0.566473975777626,6560648.0,15,0.5,"[""charliehebdo-all-rnr-threads"", ""germanwings-crash-all-rnr-threads""]","[""2324261167"", ""2552587040"", ""77425319"", ""2461872043"", ""3006168515"", ""59812246"", ""2995414714"", ""39025716"", ""2205121861"", ""291973500"", ""122800020"", ""483945427"", ""2898598594"", ""42569338"", ""1653834024""]",2,2,4
2461872043,5,44.2,-0.19201141595840454,19452459.0,5,0.6,"[""charliehebdo-all-rnr-threads"", ""germanwings-crash-all-rnr-threads"", ""ferguson-all-rnr-threads""]","[""487600344"", ""34262462"", ""14138785"", ""64643056"", ""52299545""]",3,2,5
42569338,3,137.33333333333334,-0.08146476745605469,2069189.0,3,0.6666666666666666,"[""charliehebdo-all-rnr-threads"", ""sydneysiege-all-rnr-threads""]","[""34262462"", ""15438913"", ""380648579""]",2,1,3
77425319,8,119.875,-0.24287407100200653,2181164.0,5,0.25,"[""charliehebdo-all-rnr-threads"", ""sydneysiege-all-rnr-threads""]","[""34262462"", ""419520517"", ""20646711"", ""64643056"", ""14095052""]",2,6,8
2205121861,2,44.0,0.11913096904754639,2033135.0,2,1.0,"[""charliehebdo-all-rnr-threads"", ""sydneysiege-all-rnr-threads""]","[""19038934"", ""34262462""]",2,0,2
110807429,2,138.0,-0.28949177265167236,2025052.0,2,1.0,"[""charliehebdo-all-rnr-threads"", ""sydneysiege-all-rnr-threads""]","[""14460241"", ""39750128""]",2,0,2
876695682,2,59.0,0.010494470596313477,6685880.0,2,0.5,"[""charliehebdo-all-rnr-threads"", ""germanwings-crash-all-rnr-threads""]","[""39750128"", ""227837742""]",1,1,2
266275672,2,84.5,-0.4413425028324127,2002590.0,2,0.5,"[""charliehebdo-all-rnr-threads"", ""sydneysiege-all-rnr-threads""]","[""48705816"", ""7587032""]",1,1,2
16589206,12,124.66666666666667,-0.4364030063152313,12670291.0,142,0.25,"[""charliehebdo-all-rnr-threads"", ""sydneysiege-all-rnr-threads"", ""ferguson-all-rnr-threads""]","[""297967623"", ""89646340"", ""1072723118"", ""18906053"", ""282834254"", ""1556940050"", ""223394024"", ""1458557011"", ""51795266"", ""21076985"", ""16589206"", ""1568890652"", ""51524529"", ""75797367"", ""1644866557"", ""46003732"", ""81544504"", ""580979115"", ""1585970245"", ""169670184"", ""98595881"", ""117448801"", ""6332882"", ""2445721854"", ""206675979"", ""330378192"", ""295111386"", ""244224146"", ""2687335106"", ""301279662"", ""234912898"", ""197759390"", ""967802298"", ""2395931444"", ""2648603905"", ""148993807"", ""2511511747"", ""565036823"", ""515962024"", ""275288575"", ""187937616"", ""29095436"", ""206252460"", ""56114051"", ""84685036"", ""78730279"", ""480369901"", ""60165404"", ""2831373568"", ""61035181"", ""106371320"", ""1450111284"", ""921377706"", ""16106863"", ""1205309749"", ""735705336"", ""127574746"", ""1107096824"", ""945358686"", ""293439073"", ""18719944"", ""2495626183"", ""116985382"", ""522901339"", ""36340107"", ""20526449"", ""44620310"", ""104502359"", ""627900668"", ""611792881"", ""55044037"", ""18763491"", ""440672127"", ""1925803393"", ""220689036"", ""221018809"", ""8423622"", ""169775701"", ""25208066"", ""14756262"", ""66284799"", ""67086474"", ""2777511878"", ""23444554"", ""2686106365"", ""2192327574"", ""190673905"", ""711083054"", ""146599220"", ""803009624"", ""996119641"", ""1863542702"", ""24046957"", ""537433628"", ""2273282888"", ""181873706"", ""2464502209"", ""33631852"", ""20807468"", ""95443956"", ""60006673"", ""28305154"", ""309264453"", ""209845048"", ""38155149"", ""179457781"", ""1600134031"", ""260581096"", ""16509444"", ""2602155961"", ""787402807"", ""22166232"", ""55949344"", ""536223591"", ""189050609"", ""110820682"", ""1685380520"", ""107881606"", ""36648285"", ""59802843"", ""2875378221"", ""2788271714"", ""532779460"", ""378420614"", ""484304223"", ""36313110"", ""113725102"", ""536980961"", ""54487456"", ""226475070"", ""1849407440"", ""261598181"", ""116123162"", ""972506492"", ""75682950"", ""2228156305"", ""606152631"", ""254918117"", ""2556316302"", ""26493907"", ""17664062"", ""18301058""]",3,9,12
580979115,3,101.66666666666667,-0.397860050201416,1994454.0,2,1.0,"[""charliehebdo-all-rnr-threads"", ""sydneysiege-all-rnr-threads""]","[""16589206"", ""742143""]",3,0,3
2620831379,7,69.14285714285714,-0.2267482110432216,2029919.0,4,0.14285714285714285,"[""charliehebdo-all-rnr-threads"", ""sydneysiege-all-rnr-threads""]","[""20891396"", ""32405126"", ""15143478"", ""213326209""]",1,6,7
332063391,3,97.66666666666667,-0.3140753507614136,6652935.0,3,0.6666666666666666,"[""charliehebdo-all-rnr-threads"", ""ottawashooting-all-rnr-threads""]","[""42896073"", ""32405126"", ""156123647""]",2,1,3
404460410,97,64.04123711340209,-0.07297352663020497,13293164.0,96,0.1134020618556701,"[""charliehebdo-all-rnr-threads"", ""ottawashooting-all-rnr-threads"", ""ferguson-all-rnr-threads"", ""sydneysiege-all-rnr-threads""]","[""23645988"", ""19140457"", ""18668407"", ""26192631"", ""849121410"", ""132162464"", ""24062457"", ""24187097"", ""39609732"", ""22443725"", ""21744712"", ""48290701"", ""262834755"", ""14700316"", ""23937894"", ""302071347"", ""113038982"", ""39364684"", ""18294906"", ""101848151"", ""21748597"", ""16080866"", ""1468696195"", ""373416209"", ""76388579"", ""97382927"", ""169844049"", ""237606548"", ""55911799"", ""19865053"", ""28406270"", ""113899804"", ""146765658"", ""228871317"", ""47992292"", ""98627870"", ""36730252"", ""368196789"", ""22280546"", ""589010907"", ""248967064"", ""242653461"", ""30599768"", ""27172787"", ""16469809"", ""47624589"", ""215694545"", ""154435961"", ""15249499"", ""5858532"", ""21344944"", ""1360789357"", ""20304663"", ""122928586"", ""558251172"", ""711348452"", ""68413067"", ""25999072"", ""319777415"", ""14526877"", ""14264854"", ""1700366010"", ""21998314"", ""204832963"", ""16661744"", ""49444292"", ""23831448"", ""343800462"", ""32405126"", ""2808121994"", ""25106021"", ""253186785"", ""16593816"", ""38736974"", ""21467787"", ""171953871"", ""61436584"", ""23041630"", ""28443608"", ""180171266"", ""24925027"", ""379481082"", ""33519870"", ""17073225"", ""119294048"", ""86516574"", ""111250814"", ""373564351"", ""122557484"", ""190427235"", ""330459560"", ""14090948"", ""1851229334"", ""317384131"", ""19379616"", ""147090647""]",11,86,97
50367013,3,48.333333333333336,-0.16473007202148438,6628092.0,3,1.0,"[""charliehebdo-all-rnr-threads"", ""ottawashooting-all-rnr-threads""]","[""16534576"", ""32405126"", ""249339016""]",3,0,3
605283640,2,121.0,-0.027389705181121826,6625667.0,4,1.0,"[""charliehebdo-all-rnr-threads"", ""ottawashooting-all-rnr-threads""]","[""498294115"", ""2378914268"", ""218965318"", ""17537467""]",2,0,2
74938726,2,67.0,-0.48554015159606934,1989099.0,2,0.5,"[""charliehebdo-all-rnr-threads"", ""sydneysiege-all-rnr-threads""]","[""501768982"", ""76858507""]",1,1,2
576627484,4,121.75,-0.28131626546382904,2024512.0,4,0.25,"[""charliehebdo-all-rnr-threads"", ""sydneysiege-all-rnr-threads""]","[""60022825"", ""33388399"", ""21282561"", ""16973333""]",1,3,4
289414660,6,123.5,-0.38791629672050476,1986485.0,3,0.5,"[""charliehebdo-all-rnr-threads"", ""sydneysiege-all-rnr-threads""]","[""37034483"", ""3108351"", ""16973333""]",3,3,6
25049056,9,129.0,-0.4934338728586833,6559264.0,35,0.7777777777777778,"[""charliehebdo-all-rnr-threads"", ""germanwings-crash-all-rnr-threads""]","[""2434619407"", ""932558718"", ""167343111"", ""2288799413"", ""24440905"", ""15917486"", ""1670896333"", ""1611306366"", ""2788122942"", ""9953462"", ""2459278543"", ""16476911"", ""21651982"", ""19516869"", ""387516768"", ""2396286874"", ""268982264"", ""2464502209"", ""145851251"", ""36033359"", ""1421458982"", ""2966255939"", ""25484835"", ""1542767918"", ""25235198"", ""354917016"", ""2455470360"", ""533578801"", ""165335229"", ""2869574487"", ""2535748428"", ""1263176426"", ""12895152"", ""242833879"", ""207819339""]",7,2,9
1542767918,31,90.64516129032258,-0.2813262689498163,2217429.0,16,0.22580645161290322,"[""charliehebdo-all-rnr-threads"", ""sydneysiege-all-rnr-threads""]","[""25049056"", ""299416026"", ""487600344"", ""36311109"", ""5402612"", ""77528520"", ""14511951"", ""7587032"", ""807095"", ""3108351"", ""22662704"", ""742143"", ""16675569"", ""87818409"", ""2768501"", ""793879086""]",7,24,31
25235198,3,130.33333333333334,-0.3661510944366455,6703318.0,14,0.6666666666666666,"[""charliehebdo-all-rnr-threads"", ""ottawashooting-all-rnr-threads""]","[""25049056"", ""433675700"", ""184418799"", ""22949027"", ""50580177"", ""866788843"", ""18039285"", ""66059569"", ""23684776"", ""2661256651"", ""6017542"", ""44742939"", ""622362841"", ""23153001""]",2,1,3
932558718,7,82.14285714285714,-0.04812393869672503,2012502.0,3,0.14285714285714285,"[""charliehebdo-all-rnr-threads"", ""sydneysiege-all-rnr-threads""]","[""271413771"", ""25049056"", ""2736449935""]",1,6,7
2922814893,19,107.84210526315789,-0.5341204749910455,2078686.0,11,0.47368421052631576,"[""charliehebdo-all-rnr-threads"", ""sydneysiege-all-rnr-threads""]","[""14173315"", ""16973333"", ""14138785"", ""1367531"", ""2097571"", ""742143"", ""64643056"", ""2461887810"", ""16343974"", ""16012783"", ""5402612""]",9,10,19
864927037,15,83.66666666666667,-0.16885883808135987,13434562.0,9,0.7333333333333333,"[""charliehebdo-all-rnr-threads"", ""germanwings-crash-all-rnr-threads"", ""ottawashooting-all-rnr-threads"", ""sydneysiege-all-rnr-threads""]","[""6433472"", ""182251918"", ""28785486"", ""30699754"", ""292777349"", ""325747234"", ""16343974"", ""288283415"", ""2768501""]",11,4,15
1064312154,2,111.0,-0.3774898052215576,6560674.0,2,0.5,"[""charliehebdo-all-rnr-threads"", ""germanwings-crash-all-rnr-threads""]","[""16343974"", ""64643056""]",1,1,2
271413771,10,128.0,-0.35872175097465514,8553868.0,94,0.3,"[""charliehebdo-all-rnr-threads"", ""germanwings-crash-all-rnr-threads"", ""sydneysiege-all-rnr-threads""]","[""401183991"", ""16179703"", ""1080276308"", ""27989993"", ""4055701"", ""344427103"", ""798217951"", ""2453073078"", ""2326157761"", ""540903074"", ""159484630"", ""559826992"", ""416044899"", ""15557891"", ""37308433"", ""53190110"", ""63705191"", ""88153731"", ""395970571"", ""46540000"", ""2886894341"", ""270470351"", ""1668697268"", ""2841464808"", ""2328525793"", ""19763467"", ""2351478066"", ""265317800"", ""195097945"", ""20911313"", ""619276411"", ""2559224616"", ""1584013315"", ""224564319"", ""553533504"", ""2830933580"", ""1454075262"", ""2886586060"", ""1625374544"", ""137605748"", ""1320435102"", ""558772900"", ""282816280"", ""2497006866"", ""1228806157"", ""872508648"", ""1022902286"", ""114128072"", ""2573332596"", ""55135128"", ""2609283960"", ""146199428"", ""76702224"", ""179103448"", ""284057231"", ""94212396"", ""491139696"", ""2213711298"", ""336755015"", ""2646413934"", ""19655788"", ""160187124"", ""46642044"", ""2180135409"", ""110314533"", ""902554447"", ""1093219254"", ""932558718"", ""223965677"", ""25313109"", ""173525747"", ""1442058246"", ""341609579"", ""91333394"", ""346163692"", ""81783384"", ""500794290"", ""320979335"", ""468696306"", ""2558777061"", ""362602281"", ""21267760"", ""346733298"", ""1914421867"", ""20164025"", ""2942094500"", ""398055381"", ""1078610234"", ""106200664"", ""194146598"", ""46818339"", ""538417570"", ""423600623"", ""497463899""]",3,7,10
346733298,5,90.8,-0.19197412729263305,12111284.0,5,1.0,"[""charliehebdo-all-rnr-threads"", ""germanwings-crash-all-rnr-threads"", ""prince-toronto-all-rnr-threads""]","[""271413771"", ""347411522"", ""12848262"", ""2841460589"", ""428333""]",5,0,5
1584013315,2,73.0,-0.6165381968021393,5510507.0,2,1.0,"[""charliehebdo-all-rnr-threads"", ""prince-toronto-all-rnr-threads""]","[""271413771"", ""103338203""]",2,0,2
742143,33,122.18181818181819,-0.16847323648857349,19078953.0,425,0.30303030303030304,"[""charliehebdo-all-rnr-threads"", ""germanwings-crash-all-rnr-threads"", ""sydneysiege-all-rnr-threads"", ""ottawashooting-all-rnr-threads"", ""ferguson-all-rnr-threads""]","[""15724647"", ""1655429624"", ""2753139956"", ""577977401"", ""42429809"", ""39040427"", ""264103932"", ""259166697"", ""1109685884"", ""2915189943"", ""2590559634"", ""1503342588"", ""258869694"", ""2891096840"", ""2941760242"", ""2682687162"", ""2588948750"", ""580979115"", ""2529190431"", ""2491909578"", ""938455268"", ""2428542024"", ""2939131869"", ""309401664"", ""1457286554"", ""2995440245"", ""76741355"", ""201971401"", ""474358566"", ""536279030"", ""347883924"", ""1002255540"", ""540187029"", ""2296851499"", ""17983365"", ""2882783909"", ""73205646"", ""90865583"", ""19518885"", ""1729065984"", ""29406737"", ""116051125"", ""20213865"", ""592214012"", ""469699513"", ""2560148358"", ""416696463"", ""347462394"", ""929662333"", ""1377583728"", ""41018036"", ""540033015"", ""291676686"", ""2414457033"", ""1849848000"", ""1637236532"", ""21230017"", ""2434406185"", ""2922814893"", ""26522915"", ""2376076501"", ""349708100"", ""1041202986"", ""76392453"", ""2161859750"", ""2513124578"", ""277020822"", ""51162046"", ""2775150405"", ""944112024"", ""21543226"", ""2746430107"", ""2890822477"", ""2562635260"", ""38823542"", ""2945871636"", ""228089048"", ""2915061734"", ""2165153857"", ""165491467"", ""1343988523"", ""128798208"", ""280414048"", ""19080694"", ""352064833"", ""104797409"", ""107584041"", ""20148675"", ""2965280221"", ""38252892"", ""365729149"", ""51975278"", ""2684603246"", ""351263372"", ""2611858165"", ""283938393"", ""226299861"", ""274651688"", ""232372741"", ""400856052"", ""113367928"", ""267699009"", ""17436585"", ""33990004"", ""200264886"", ""560374994"", ""721092824"", ""809194890"", ""2873267413"", ""2856401319"", ""2281835347"", ""857330720"", ""29410522"", ""1119305256"", ""614912756"", ""395335393"", ""53435162"", ""2728757570"", ""1542767918"", ""2834690978"", ""16271264"", ""2723262499"", ""2546508158"", ""14332682"", ""77235394"", ""18821140"", ""2835404948"", ""19986805"", ""22927334"", ""2582736318"", ""112184737"", ""2277183243"", ""22717923"", ""409275587"", ""91857015"", ""220426702"", ""344011545"", ""2739568563"", ""106330685"", ""202785761"", ""1355958920"", ""962239778"", ""374246336"", ""19388832"", ""1592530428"", ""19497064"", ""11744492"", ""2195378001"", ""827681827"", ""2655648540"", ""23196128"", ""389046461"", ""379798935"", ""263361152"", ""392413519"", ""2171201828"", ""248534586"", ""14632493"", ""2204126059"", ""18426052"", ""1485880807"", ""22700836"", ""3062906469"", ""2503331"", ""751900110"", ""610165606"", ""241982231"", ""768120781"", ""31618419"", ""2181655057"", ""2336193672"", ""2667503227"", ""2537452978"", ""231485616"", ""228296915"", ""69032114"", ""848319770"", ""2681160897"", ""602058946"", ""780992342"", ""2708850794"", ""1268435324"", ""976583954"", ""296070902"", ""128917051"", ""3071741826"", ""2573619805"", ""2481267398"", ""878655300"", ""797194555"", ""2734020596"", ""529205945"", ""909894727"", ""2768705528"", ""187081193"", ""35858253"", ""56312505"", ""963562537"", ""2221491937"", ""197083967"", ""558215877"", ""190734698"", ""464841735"", ""214960151"", ""2540028654"", ""183431837"", ""526244601"", ""23523876"", ""1444168824"", ""2412273459"", ""84869698"", ""250937927"", ""893046055"", ""2750309806"", ""2898190371"", ""392790310"", ""2808842918"", ""78707462"", ""2171636099"", ""926976464"", ""2961649574"", ""396890769"", ""36616344"", ""20742461"", ""2215260181"", ""157903235"", ""136283997"", ""2194470846"", ""1082201604"", ""114570088"", ""2513308740"", ""439615380"", ""68720707"", ""475626780"", ""78898625"", ""77170271"", ""1329199266"", ""17194863"", ""200725558"", ""110992398"", ""262040253"", ""2231401623"", ""730211846"", ""2726447790"", ""18560379"", ""2857893113"", ""2903186220"", ""923278088"", ""2587786188"", ""268688659"", ""1531789724"", ""309656268"", ""125458972"", ""470857663"", ""2852446116"", ""271887033"", ""81873794"", ""2875761863"", ""1596987152"", ""2752512885"", ""48958586"", ""21498505"", ""2728345935"", ""997345080"", ""58341062"", ""20028665"", ""482140116"", ""75425599"", ""201631665"", ""1030435626"", ""20987358"", ""517656712"", ""2777872329"", ""2864140683"", ""478587768"", ""1518883244"", ""2881770975"", ""536183507"", ""1344297120"", ""2240360555"", ""118619214"", ""1375717166"", ""399785087"", ""2162096364"", ""23464009"", ""35051304"", ""2453850531"", ""41300398"", ""1472776850"", ""389633348"", ""31471284"", ""2605916636"", ""89929611"", ""2370908751"", ""8432682"", ""2549605682"", ""712588641"", ""600600709"", ""802792604"", ""18712684"", ""23321067"", ""283937135"", ""348638083"", ""116061092"", ""2951968857"", ""233885425"", ""785363341"", ""125344265"", ""2771878829"", ""582119732"", ""1333261783"", ""606316521"", ""2967365878"", ""1576572156"", ""33178654"", ""123949508"", ""604962199"", ""478522911"", ""314325527"", ""114962484"", ""34945490"", ""2691219201"", ""2247784187"", ""2945865278"", ""504028774"", ""256690019"", ""2336930774"", ""59843216"", ""143597109"", ""1085149063"", ""2950736856"", ""1048444981"", ""2818826268"", ""318691517"", ""2607811206"", ""21330040"", ""2601118704"", ""213553711"", ""180468045"", ""324908191"", ""889829281"", ""280495086"", ""559796430"", ""1234987687"", ""2856404785"", ""106742088"", ""475414462"", ""2815652701"", ""2459278543"", ""1635176300"", ""244661569"", ""510490823"", ""85754435"", ""2935523322"", ""330118063"", ""618120104"", ""24156429"", ""149635489"", ""2817934664"", ""2858467094"", ""2663115926"", ""17539456"", ""279788564"", ""2867154637"", ""2241006968"", ""2959936515"", ""384332900"", ""1724090454"", ""750360169"", ""311028372"", ""29083132"", ""2823532027"", ""2891192068"", ""233931728"", ""2591208013"", ""25184694"", ""2821577173"", ""742143"", ""867214392"", ""960881222"", ""89203243"", ""60719876"", ""213299391"", ""426561297"", ""185322197"", ""2856254314"", ""2861795873"", ""282164554"", ""1429245848"", ""82925049"", ""631554075"", ""39915851"", ""81297237"", ""17814209"", ""105523496"", ""632805985"", ""2315875827"", ""33133988"", ""221107287"", ""123053156"", ""185798831"", ""185761169"", ""323863880"", ""151122885"", ""1265512556"", ""2264718528"", ""302173769"", ""246683775"", ""612618297"", ""2885348567"", ""30880296"", ""493524550"", ""79802631"", ""2909084623"", ""813682537"", ""1914421867"", ""1470667441"", ""2158900602"", ""16177536"", ""93349233"", ""20583237"", ""214980977"", ""348021589"", ""190217639"", ""2684175109""]",10,23,33
2560148358,15,128.8,-0.13435478607813517,8545603.0,10,0.13333333333333333,"[""charliehebdo-all-rnr-threads"", ""germanwings-crash-all-rnr-threads"", ""sydneysiege-all-rnr-threads""]","[""14173315"", ""1652541"", ""51241574"", ""807095"", ""18424289"", ""3108351"", ""28785486"", ""742143"", ""87818409"", ""428333""]",2,13,15
20987358,5,85.2,-0.2128328800201416,2011421.0,2,1.0,"[""charliehebdo-all-rnr-threads"", ""sydneysiege-all-rnr-threads""]","[""742143"", ""5402612""]",5,0,5
29406737,7,96.42857142857143,-0.3861830489976065,2191739.0,4,1.0,"[""charliehebdo-all-rnr-threads"", ""sydneysiege-all-rnr-threads""]","[""380648579"", ""742143"", ""868112707"", ""5402612""]",7,0,7
28839148,5,99.2,0.082160484790802,6561375.0,4,0.4,"[""charliehebdo-all-rnr-threads"", ""germanwings-crash-all-rnr-threads""]","[""34655603"", ""16012783"", ""14511951"", ""5402612""]",2,3,5
1914421867,6,73.33333333333333,0.037568082412083946,2114123.0,5,0.3333333333333333,"[""charliehebdo-all-rnr-threads"", ""sydneysiege-all-rnr-threads""]","[""271413771"", ""16973333"", ""556633808"", ""14569869"", ""742143""]",2,4,6
25995131,4,53.75,0.0578288733959198,8596061.0,3,0.75,"[""charliehebdo-all-rnr-threads"", ""germanwings-crash-all-rnr-threads"", ""sydneysiege-all-rnr-threads""]","[""2280470022"", ""292777349"", ""14569869""]",3,1,4
230045723,10,71.4,-0.1578446924686432,2205251.0,3,0.8,"[""charliehebdo-all-rnr-threads"", ""sydneysiege-all-rnr-threads""]","[""16973333"", ""292777349"", ""5402612""]",8,2,10
999907196,49,134.08163265306118,-0.4601074554482285,13218687.0,32,0.6122448979591837,"[""charliehebdo-all-rnr-threads"", ""germanwings-crash-all-rnr-threads"", ""ottawashooting-all-rnr-threads"", ""sydneysiege-all-rnr-threads""]","[""55011262"", ""359138243"", ""9609632"", ""13896552"", ""17897698"", ""1115146242"", ""807095"", ""12848262"", ""18999969"", ""21212604"", ""9651232"", ""118672200"", ""410334710"", ""1093638847"", ""27931710"", ""153029181"", ""16834659"", ""5402612"", ""8736882"", ""164075542"", ""14678279"", ""156464691"", ""957502914"", ""39728435"", ""257291338"", ""16675569"", ""1652541"", ""371510063"", ""589010907"", ""380648579"", ""1367531"", ""126486040""]",30,19,49
1938260035,7,105.85714285714286,-0.2756081819534302,12604841.0,4,0.8571428571428571,"[""charliehebdo-all-rnr-threads"", ""ferguson-all-rnr-threads""]","[""179732982"", ""15108530"", ""64643056"", ""5402612""]",6,1,7
48655691,2,133.5,-0.4178193211555481,2034914.0,2,1.0,"[""charliehebdo-all-rnr-threads"", ""sydneysiege-all-rnr-threads""]","[""288755234"", ""27831488""]",2,0,2
745248356,7,136.42857142857142,0.07179653644561768,1989739.0,7,0.14285714285714285,"[""charliehebdo-all-rnr-threads"", ""sydneysiege-all-rnr-threads""]","[""358127438"", ""48705816"", ""46078438"", ""3108351"", ""47685065"", ""18725815"", ""76858507""]",1,6,7
587935398,8,112.875,-0.23209919035434723,2036445.0,7,0.25,"[""charliehebdo-all-rnr-threads"", ""sydneysiege-all-rnr-threads""]","[""14173315"", ""17525171"", ""3108351"", ""37675954"", ""2467791"", ""20891396"", ""16164636""]",2,6,8
11094282,2,137.5,-0.48974812030792236,2030156.0,2,1.0,"[""charliehebdo-all-rnr-threads"", ""sydneysiege-all-rnr-threads""]","[""972651"", ""3108351""]",2,0,2
94626353,3,92.66666666666667,-0.261197566986084,2026651.0,3,0.6666666666666666,"[""charliehebdo-all-rnr-threads"", ""sydneysiege-all-rnr-threads""]","[""3108351"", ""1960878613"", ""64643056""]",2,1,3
207023127,10,76.6,-0.3313109278678894,2002751.0,5,0.2,"[""charliehebdo-all-rnr-threads"", ""sydneysiege-all-rnr-threads""]","[""351120282"", ""3108351"", ""31135856"", ""245784511"", ""11741632""]",2,8,10
297967623,3,75.0,-0.5143382350603739,2035411.0,3,1.0,"[""charliehebdo-all-rnr-threads"", ""sydneysiege-all-rnr-threads""]","[""423662810"", ""16589206"", ""469509327""]",3,0,3
180961394,9,81.11111111111111,-0.3971913721826341,6808871.0,7,0.3333333333333333,"[""charliehebdo-all-rnr-threads"", ""ottawashooting-all-rnr-threads""]","[""1562935142"", ""1068121346"", ""18668407"", ""15438913"", ""16343974"", ""469509327"", ""5402612""]",3,6,9
192359034,27,90.14814814814815,-0.2761146072988157,12737405.0,6,0.1111111111111111,"[""charliehebdo-all-rnr-threads"", ""ottawashooting-all-rnr-threads"", ""ferguson-all-rnr-threads"", ""sydneysiege-all-rnr-threads""]","[""15907183"", ""358347117"", ""244452760"", ""7587032"", ""87416722"", ""469509327""]",3,24,27
1048468734,4,55.5,0.3549729287624359,12344972.0,3,0.75,"[""charliehebdo-all-rnr-threads"", ""putinmissing-all-rnr-threads"", ""ottawashooting-all-rnr-threads""]","[""2862224447"", ""203123011"", ""469509327""]",3,1,4
214462611,3,95.0,-0.09464828173319499,2154125.0,2,0.6666666666666666,"[""charliehebdo-all-rnr-threads"", ""sydneysiege-all-rnr-threads""]","[""87416722"", ""1299769218""]",2,1,3
923278088,7,108.85714285714286,-0.1526397807257516,2121318.0,7,0.2857142857142857,"[""charliehebdo-all-rnr-threads"", ""sydneysiege-all-rnr-threads""]","[""14293310"", ""7587032"", ""2097571"", ""51241574"", ""742143"", ""786764"", ""5402612""]",2,5,7
281737861,18,92.88888888888889,-0.3149208393361833,6813382.0,7,0.3333333333333333,"[""charliehebdo-all-rnr-threads"", ""ottawashooting-all-rnr-threads"", ""sydneysiege-all-rnr-threads""]","[""143415291"", ""574701065"", ""5402612"", ""7587032"", ""87416722"", ""66967746"", ""111250814""]",6,12,18
24639297,19,102.47368421052632,-0.3004979553975557,13047480.0,7,0.21052631578947367,"[""charliehebdo-all-rnr-threads"", ""ottawashooting-all-rnr-threads"", ""ferguson-all-rnr-threads""]","[""135604500"", ""42921216"", ""7587032"", ""225235528"", ""376109186"", ""18643437"", ""5402612""]",4,15,19
372502604,3,125.0,-0.48169811566670734,1983892.0,19,0.6666666666666666,"[""charliehebdo-all-rnr-threads"", ""sydneysiege-all-rnr-threads""]","[""110306778"", ""332969934"", ""2157975905"", ""107072215"", ""177456660"", ""268959309"", ""343211136"", ""1536797588"", ""2164830257"", ""22521283"", ""757345172"", ""1155421448"", ""1303993316"", ""46340184"", ""389548615"", ""1004153972"", ""2895568885"", ""195229666"", ""14723131""]",2,1,3
757345172,5,95.0,-0.4517609477043152,12489329.0,3,0.6,"[""charliehebdo-all-rnr-threads"", ""ferguson-all-rnr-threads""]","[""372502604"", ""215694545"", ""313675516""]",3,2,5
1536797588,15,134.06666666666666,-0.36503209273020426,2027468.0,8,0.26666666666666666,"[""charliehebdo-all-rnr-threads"", ""sydneysiege-all-rnr-threads""]","[""25106021"", ""597251143"", ""171802941"", ""25777812"", ""54489465"", ""103849564"", ""372502604"", ""129673790""]",4,11,15
2875761863,37,119.08108108108108,-0.4402518320727993,7004710.0,22,0.2702702702702703,"[""charliehebdo-all-rnr-threads"", ""putinmissing-all-rnr-threads"", ""germanwings-crash-all-rnr-threads""]","[""1562935142"", ""807095"", ""243318995"", ""14293310"", ""403899803"", ""25067168"", ""18424289"", ""37675954"", ""742143"", ""788524"", ""14173315"", ""15300388"", ""2467791"", ""64643056"", ""2190056023"", ""1877831"", ""1652541"", ""3108351"", ""15754281"", ""16343974"", ""87818409"", ""16311797""]",10,27,37
1372692300,3,94.66666666666667,0.22432859738667807,2033065.0,3,0.3333333333333333,"[""charliehebdo-all-rnr-threads"", ""sydneysiege-all-rnr-threads""]","[""28785486"", ""7587032"", ""2097571""]",1,2,3
23163280,2,121.5,-0.8404369950294495,1983799.0,2,0.5,"[""charliehebdo-all-rnr-threads"", ""sydneysiege-all-rnr-threads""]","[""807095"", ""428333""]",1,1,2
131395119,2,25.5,0.29047471284866333,2022143.0,1,1.0,"[""charliehebdo-all-rnr-threads"", ""sydneysiege-all-rnr-threads""]","[""64643056""]",2,0,2
1215196814,5,47.2,-0.20937907695770264,5833373.0,1,0.6,"[""charliehebdo-all-rnr-threads"", ""putinmissing-all-rnr-threads""]","[""64643056""]",3,2,5
1240917696,3,116.66666666666667,-0.35338640213012695,2013655.0,3,0.3333333333333333,"[""charliehebdo-all-rnr-threads"", ""sydneysiege-all-rnr-threads""]","[""18725815"", ""19899606"", ""64643056""]",1,2,3
2370908751,87,102.93103448275858,-0.42195361852645874,8554863.0,20,0.4827586206896552,"[""charliehebdo-all-rnr-threads"", ""germanwings-crash-all-rnr-threads"", ""sydneysiege-all-rnr-threads""]","[""807095"", ""759251"", ""6107422"", ""15012486"", ""16973333"", ""14293310"", ""15108702"", ""6017542"", ""742143"", ""788524"", ""5402612"", ""14173315"", ""428333"", ""7587032"", ""87416722"", ""64643056"", ""1652541"", ""3108351"", ""16343974"", ""1367531""]",42,45,87
236684588,7,52.714285714285715,0.0476445129939488,2031070.0,4,0.2857142857142857,"[""charliehebdo-all-rnr-threads"", ""sydneysiege-all-rnr-threads""]","[""16973333"", ""14224719"", ""16811829"", ""64643056""]",2,5,7
2467791,12,113.66666666666667,-0.21944159269332886,6823437.0,143,0.3333333333333333,"[""charliehebdo-all-rnr-threads"", ""ottawashooting-all-rnr-threads"", ""sydneysiege-all-rnr-threads""]","[""17878191"", ""48753654"", ""2856401319"", ""2478094418"", ""891449460"", ""145635977"", ""2907264303"", ""587935398"", ""956688378"", ""14125115"", ""76938029"", ""1255061629"", ""2255374178"", ""2584944914"", ""123622674"", ""14175549"", ""114962484"", ""176310317"", ""1407027576"", ""51998397"", ""2962137827"", ""37270324"", ""607311691"", ""713339565"", ""38832351"", ""450991824"", ""104299137"", ""81216823"", ""75182421"", ""122822115"", ""27256651"", ""611438425"", ""171316624"", ""20719498"", ""21155483"", ""36176688"", ""24888201"", ""1311348684"", ""2257552586"", ""1177491776"", ""1348798826"", ""2507342209"", ""148066896"", ""63876466"", ""255354721"", ""200641413"", ""120157086"", ""2855109985"", ""1258145024"", ""282837401"", ""873063606"", ""175192146"", ""2614001430"", ""2923319881"", ""34346537"", ""20961647"", ""154021046"", ""856442948"", ""268528880"", ""16645396"", ""395613417"", ""359514537"", ""237011341"", ""60443809"", ""2222248950"", ""140128586"", ""2495613440"", ""254869887"", ""28193568"", ""148224229"", ""1852665702"", ""926383879"", ""2875761863"", ""30222655"", ""2960917818"", ""2877389752"", ""2895823046"", ""43799837"", ""156763"", ""2651807532"", ""2451878102"", ""91652757"", ""517656712"", ""570559903"", ""1241386093"", ""30574994"", ""16208179"", ""270521533"", ""901162321"", ""29769901"", ""2794577969"", ""177512390"", ""15840102"", ""2464502209"", ""249292522"", ""1715163332"", ""459620943"", ""2877158969"", ""33796531"", ""2333921870"", ""139137003"", ""373055616"", ""391052129"", ""276239681"", ""2837410746"", ""322882916"", ""2959360301"", ""599875685"", ""1638877406"", ""274616222"", ""89008435"", ""228073841"", ""1733026586"", ""127689975"", ""1412164226"", ""554090187"", ""2376582930"", ""38039095"", ""295058041"", ""552285517"", ""2392516015"", ""531331765"", ""1022381874"", ""187059363"", ""810714324"", ""986509249"", ""2497286180"", ""185762351"", ""2828640809"", ""172594656"", ""226647254"", ""43533997"", ""236175465"", ""703306700"", ""262486400"", ""1266770882"", ""1137986071"", ""349272693"", ""175004773"", ""273025101"", ""804426548"", ""299899105"", ""2214510864""]",4,8,12
2941652236,18,101.88888888888889,-0.2995472086800469,5832170.0,3,0.9444444444444444,"[""charliehebdo-all-rnr-threads"", ""putinmissing-all-rnr-threads""]","[""2566535282"", ""15300388"", ""64643056""]",17,1,18
165335229,33,95.57575757575758,-0.2869104959748008,19226404.0,12,0.8181818181818182,"[""charliehebdo-all-rnr-threads"", ""germanwings-crash-all-rnr-threads"", ""sydneysiege-all-rnr-threads"", ""putinmissing-all-rnr-threads"", ""ferguson-all-rnr-threads""]","[""25049056"", ""52003080"", ""3006168515"", ""15669672"", ""171802941"", ""21575717"", ""428333"", ""385093141"", ""207441433"", ""87818409"", ""16012783"", ""22063600""]",27,6,33
127632704,10,87.0,-0.11973313093185425,6548713.0,3,0.9,"[""charliehebdo-all-rnr-threads"", ""putinmissing-all-rnr-threads"", ""germanwings-crash-all-rnr-threads""]","[""2280470022"", ""52003080"", ""16012783""]",9,1,10
2516181758,2,71.0,-0.09423404932022095,5727207.0,2,0.5,"[""charliehebdo-all-rnr-threads"", ""putinmissing-all-rnr-threads""]","[""16012783"", ""439565971""]",1,1,2
2327911741,7,127.71428571428571,-0.16037614004952566,5622571.0,3,0.2857142857142857,"[""charliehebdo-all-rnr-threads"", ""putinmissing-all-rnr-threads""]","[""1093610112"", ""16012783"", ""270016438""]",2,5,7
20826640,4,97.0,-0.10991150140762329,5728012.0,7,0.5,"[""charliehebdo-all-rnr-threads"", ""putinmissing-all-rnr-threads""]","[""52003080"", ""28059319"", ""2891179943"", ""246082925"", ""3077745647"", ""16012783"", ""718379855""]",2,2,4
15164565,10,116.8,-0.2286419987678528,19465272.0,97,0.1,"[""charliehebdo-all-rnr-threads"", ""germanwings-crash-all-rnr-threads"", ""ferguson-all-rnr-threads""]","[""2211587423"", ""371302314"", ""2873434727"", ""631159292"", ""1969879975"", ""99925806"", ""256705538"", ""2185942319"", ""1561833134"", ""75205739"", ""20045868"", ""323344335"", ""2334005558"", ""17474081"", ""15140297"", ""952866163"", ""14707078"", ""21213172"", ""1218170342"", ""17697255"", ""46746701"", ""2459812171"", ""789430788"", ""259878649"", ""1348798826"", ""274109576"", ""33923271"", ""2354843142"", ""23190257"", ""615500906"", ""2936562194"", ""412239022"", ""15164565"", ""330508527"", ""1249557512"", ""118950574"", ""1570473295"", ""47516349"", ""2329311277"", ""16868115"", ""338777169"", ""303665229"", ""1263236965"", ""1311326426"", ""41960566"", ""19425192"", ""279788564"", ""130373200"", ""942662162"", ""2898545532"", ""55595406"", ""2308907439"", ""138509803"", ""531705837"", ""157099071"", ""16582131"", ""18124693"", ""14663958"", ""289337184"", ""1397421727"", ""390696780"", ""182840025"", ""173514323"", ""2464502209"", ""272016895"", ""303636190"", ""14679482"", ""19572390"", ""93912662"", ""850863444"", ""159433006"", ""52893714"", ""996952393"", ""50807134"", ""23410233"", ""1015035295"", ""126732937"", ""256442158"", ""369566908"", ""26233526"", ""7829912"", ""117524213"", ""17004629"", ""379524778"", ""840766664"", ""72313702"", ""485166864"", ""33679137"", ""476459853"", ""47962856"", ""20494522"", ""2804811358"", ""860648802"", ""1362235314"", ""415099852"", ""705500738"", ""37772031""]",1,9,10
173514323,2,139.0,-0.4309859573841095,12525510.0,2,1.0,"[""charliehebdo-all-rnr-threads"", ""ferguson-all-rnr-threads""]","[""19881665"", ""15164565""]",2,0,2
256009120,3,138.0,-0.396004597345988,2012734.0,2,0.3333333333333333,"[""charliehebdo-all-rnr-threads"", ""sydneysiege-all-rnr-threads""]","[""211105315"", ""37303498""]",1,2,3
189654054,2,112.5,0.3666318655014038,12955864.0,2,0.5,"[""charliehebdo-all-rnr-threads"", ""ferguson-all-rnr-threads""]","[""17448965"", ""212369763""]",1,1,2
20159596,8,115.25,-0.041772834956645966,13192804.0,46,0.5,"[""charliehebdo-all-rnr-threads"", ""germanwings-crash-all-rnr-threads"", ""ottawashooting-all-rnr-threads"", ""sydneysiege-all-rnr-threads""]","[""169620752"", ""129311082"", ""17444890"", ""828880422"", ""336002124"", ""539104576"", ""9038672"", ""2280470022"", ""18999969"", ""1635058646"", ""2434042825"", ""579504493"", ""17437437"", ""458328611"", ""17406763"", ""2856694188"", ""252448322"", ""1355110922"", ""269557216"", ""2556573511"", ""7306602"", ""71232732"", ""2176696315"", ""1028764352"", ""200889383"", ""352953768"", ""258403765"", ""266309584"", ""134196350"", ""35804894"", ""67326258"", ""16319009"", ""4239551"", ""587648328"", ""12707982"", ""15300487"", ""11856882"", ""338541420"", ""264862915"", ""1209245539"", ""14233285"", ""89964115"", ""985371620"", ""19872788"", ""31122446"", ""209006288""]",4,4,8
21899739,2,77.0,-0.3208153247833252,2062223.0,2,1.0,"[""charliehebdo-all-rnr-threads"", ""sydneysiege-all-rnr-threads""]","[""14940354"", ""25999072""]",2,0,2
114085514,2,133.0,-0.36060523986816406,2023004.0,2,0.5,"[""charliehebdo-all-rnr-threads"", ""sydneysiege-all-rnr-threads""]","[""25999072"", ""5402612""]",1,1,2
21573897,2,132.0,-0.11452841758728027,12535083.0,2,0.5,"[""charliehebdo-all-rnr-threads"", ""ferguson-all-rnr-threads""]","[""9295502"", ""25999072""]",1,1,2
55794552,43,63.69767441860465,0.11742227299268855,19568433.0,43,0.06976744186046512,"[""charliehebdo-all-rnr-threads"", ""germanwings-crash-all-rnr-threads"", ""sydneysiege-all-rnr-threads"", ""ottawashooting-all-rnr-threads"", ""ferguson-all-rnr-threads""]","[""25106021"", ""16080866"", ""373416209"", ""15249499"", ""76388579"", ""97382927"", ""26192631"", ""61436584"", ""21344944"", ""28443608"", ""1360789357"", ""849121410"", ""55911799"", ""24925027"", ""246532728"", ""558251172"", ""25777812"", ""24187097"", ""153029181"", ""13393052"", ""17073225"", ""1571428436"", ""86516574"", ""25999072"", ""111250814"", ""21744712"", ""24069453"", ""48290701"", ""14700316"", ""14090948"", ""98627870"", ""39728435"", ""23937894"", ""16661744"", ""1851229334"", ""343800462"", ""317384131"", ""54756055"", ""30599768"", ""1707427058"", ""27172787"", ""39364684"", ""101848151""]",3,40,43
626682905,6,83.0,0.16435229778289795,2170720.0,3,0.5,"[""charliehebdo-all-rnr-threads"", ""sydneysiege-all-rnr-threads""]","[""3108351"", ""25999072"", ""5402612""]",3,3,6
214205356,4,90.75,0.16405367851257324,12586802.0,27,0.25,"[""charliehebdo-all-rnr-threads"", ""ferguson-all-rnr-threads""]","[""419180011"", ""34280888"", ""377483653"", ""456758392"", ""197065399"", ""375833573"", ""6117452"", ""2174043325"", ""736544570"", ""27671543"", ""4863241"", ""33108473"", ""89905959"", ""23626411"", ""2416274990"", ""328900914"", ""2800812359"", ""16078071"", ""2950545429"", ""1137292190"", ""307544083"", ""214205356"", ""94180796"", ""2516321935"", ""17448463"", ""27172412"", ""2332033299""]",1,3,4
4863241,2,90.5,0.22688770294189453,2073704.0,2,0.5,"[""charliehebdo-all-rnr-threads"", ""sydneysiege-all-rnr-threads""]","[""214205356"", ""331672974""]",1,1,2
2748686820,19,111.73684210526316,-0.2762373497611598,2414980.0,19,0.9473684210526315,"[""charliehebdo-all-rnr-threads"", ""sydneysiege-all-rnr-threads""]","[""2748686820"", ""95182092"", ""981380791"", ""16811829"", ""1052605182"", ""362422478"", ""2330953410"", ""1656372986"", ""993275714"", ""2361913628"", ""77534522"", ""546634791"", ""1620588187"", ""268476335"", ""2224573998"", ""294584251"", ""2363574036"", ""566021395"", ""2939440823""]",18,1,19
2363574036,4,74.25,-0.3369859606027603,12789171.0,3,0.25,"[""charliehebdo-all-rnr-threads"", ""ferguson-all-rnr-threads""]","[""14526877"", ""16253142"", ""2748686820""]",1,3,4
240028072,3,62.0,-0.028010050455729168,2070890.0,14,0.6666666666666666,"[""charliehebdo-all-rnr-threads"", ""sydneysiege-all-rnr-threads""]","[""226748027"", ""251459764"", ""341255294"", ""79603514"", ""16304130"", ""445791130"", ""116825202"", ""289787164"", ""23696709"", ""37881687"", ""12712112"", ""393011550"", ""17335415"", ""270650736""]",2,1,3
21744712,5,88.0,-0.3327705979347229,2068983.0,60,0.4,"[""charliehebdo-all-rnr-threads"", ""sydneysiege-all-rnr-threads""]","[""130998421"", ""47874155"", ""1354084202"", ""2907653441"", ""2559310359"", ""31570647"", ""1290762192"", ""15138104"", ""104342504"", ""24500736"", ""373937708"", ""17437437"", ""47008273"", ""55795410"", ""2865103551"", ""511639376"", ""841255098"", ""58371527"", ""52165470"", ""114911627"", ""64370820"", ""25479291"", ""337662486"", ""316385442"", ""32798162"", ""93950111"", ""2344154581"", ""93313169"", ""1038235795"", ""469256022"", ""2255976348"", ""43533997"", ""404460410"", ""20595894"", ""132602552"", ""39804063"", ""84386050"", ""18948060"", ""32224824"", ""1404087277"", ""55794552"", ""593786958"", ""222293533"", ""2832527047"", ""34870175"", ""297980492"", ""75248428"", ""41557838"", ""103226207"", ""1221752407"", ""134407767"", ""17365415"", ""2679627566"", ""1712159514"", ""160023999"", ""284002545"", ""21146043"", ""87818409"", ""296545369"", ""52183150""]",2,3,5
43533997,6,105.83333333333333,0.14721250534057617,2203709.0,6,0.3333333333333333,"[""charliehebdo-all-rnr-threads"", ""sydneysiege-all-rnr-threads""]","[""21744712"", ""17152053"", ""807095"", ""2467791"", ""103065157"", ""14460241""]",2,4,6
160023999,2,82.0,0.5014646649360657,12529590.0,2,0.5,"[""charliehebdo-all-rnr-threads"", ""ferguson-all-rnr-threads""]","[""1716581"", ""21744712""]",1,1,2
132602552,2,105.5,-0.14583316445350647,6676881.0,2,1.0,"[""charliehebdo-all-rnr-threads"", ""ottawashooting-all-rnr-threads""]","[""21744712"", ""8736882""]",2,0,2
296545369,6,127.16666666666667,-0.20373821258544922,2085395.0,6,0.16666666666666666,"[""charliehebdo-all-rnr-threads"", ""sydneysiege-all-rnr-threads""]","[""21744712"", ""17525171"", ""8197942"", ""18576537"", ""972651"", ""22443725""]",1,5,6
55795410,15,64.46666666666667,0.09191651344299316,19526309.0,15,0.06666666666666667,"[""charliehebdo-all-rnr-threads"", ""germanwings-crash-all-rnr-threads"", ""sydneysiege-all-rnr-threads"", ""ottawashooting-all-rnr-threads"", ""ferguson-all-rnr-threads""]","[""14123751"", ""1851229334"", ""21744712"", ""849121410"", ""48290701"", ""558251172"", ""317384131"", ""54756055"", ""380648579"", ""24187097"", ""30599768"", ""1707427058"", ""13393052"", ""204832963"", ""86516574""]",1,14,15
24500736,2,85.0,0.07120966911315918,2077520.0,2,1.0,"[""charliehebdo-all-rnr-threads"", ""sydneysiege-all-rnr-threads""]","[""16973333"", ""21744712""]",2,0,2
14599545,2,124.0,-0.2855570912361145,2059286.0,13,0.5,"[""charliehebdo-all-rnr-threads"", ""sydneysiege-all-rnr-threads""]","[""2411586222"", ""145731072"", ""164118386"", ""2202938540"", ""1420547803"", ""2663033660"", ""2163076560"", ""2458476536"", ""52911116"", ""43604262"", ""2927428900"", ""20658265"", ""262915621""]",1,1,2
2663033660,10,103.4,-0.33757404088973997,2186105.0,6,0.2,"[""charliehebdo-all-rnr-threads"", ""sydneysiege-all-rnr-threads""]","[""14599545"", ""16973333"", ""429533485"", ""58467371"", ""1634077976"", ""16834659""]",2,8,10
380648579,35,84.8,-0.5714210561343603,13209832.0,339,0.6285714285714286,"[""charliehebdo-all-rnr-threads"", ""germanwings-crash-all-rnr-threads"", ""ottawashooting-all-rnr-threads"", ""sydneysiege-all-rnr-threads""]","[""286801248"", ""101681864"", ""2956496417"", ""275356558"", ""329021553"", ""454423746"", ""23189508"", ""102452887"", ""175243720"", ""125688358"", ""1009250149"", ""109589897"", ""70119298"", ""128712259"", ""911747592"", ""21962518"", ""17408916"", ""52005353"", ""223556088"", ""22529583"", ""2408067523"", ""56047181"", ""14942242"", ""23486744"", ""407646881"", ""28093810"", ""532299353"", ""53520864"", ""753969769"", ""316288394"", ""23246523"", ""765476"", ""29406737"", ""191231615"", ""1711365822"", ""14098607"", ""148063984"", ""329353102"", ""309064436"", ""153132339"", ""2567292679"", ""19195094"", ""84021687"", ""14647203"", ""802315148"", ""125016785"", ""138831539"", ""889335176"", ""34123337"", ""299928077"", ""31617052"", ""225366234"", ""15634438"", ""250393818"", ""20848139"", ""312816046"", ""2905232597"", ""258730076"", ""183098309"", ""999907196"", ""80445162"", ""304951125"", ""7310842"", ""2870802406"", ""37973014"", ""547416021"", ""238979179"", ""19120132"", ""372431040"", ""107195704"", ""1076082146"", ""15136484"", ""79260733"", ""14360516"", ""2958452794"", ""134970599"", ""186502780"", ""223814664"", ""627363601"", ""33946271"", ""30676826"", ""164809259"", ""19651918"", ""1498797607"", ""27540642"", ""2827864026"", ""118384061"", ""2332375748"", ""615559786"", ""33043866"", ""19969662"", ""92521568"", ""128921313"", ""1150376528"", ""72588786"", ""263794723"", ""511322355"", ""36033359"", ""31114386"", ""2589541577"", ""322216305"", ""2179807246"", ""27071781"", ""289129500"", ""393650551"", ""28372386"", ""241386939"", ""17692894"", ""447851450"", ""2925283179"", ""49318528"", ""479597669"", ""19898213"", ""48927755"", ""742841876"", ""87538158"", ""25206663"", ""418243137"", ""182920333"", ""188869825"", ""253517139"", ""14261961"", ""2413247540"", ""2723802684"", ""253791853"", ""54042025"", ""19449079"", ""394612386"", ""91794315"", ""16475267"", ""2970881066"", ""801546008"", ""2209486785"", ""20092071"", ""582175283"", ""42569338"", ""55795410"", ""115156207"", ""178288356"", ""420890823"", ""109041137"", ""2464502209"", ""953490462"", ""3094369868"", ""508993989"", ""336529778"", ""29664767"", ""402738328"", ""38155149"", ""187343982"", ""449936336"", ""260588991"", ""899462880"", ""153698624"", ""2339351"", ""2772543686"", ""17999859"", ""2388075212"", ""152891927"", ""102692275"", ""26966487"", ""11052412"", ""468657693"", ""591297988"", ""726733386"", ""174365756"", ""17893690"", ""67013524"", ""69232915"", ""174119600"", ""80488204"", ""108973249"", ""194735550"", ""12895152"", ""955046888"", ""2577216392"", ""47485260"", ""581351672"", ""117667331"", ""35434532"", ""155763912"", ""614259648"", ""295584920"", ""176140784"", ""915724004"", ""2908317124"", ""1586330341"", ""33984817"", ""168491473"", ""416210375"", ""300215930"", ""295795359"", ""1072251836"", ""99337454"", ""906396630"", ""2331766851"", ""1698582715"", ""96977991"", ""165650101"", ""37877871"", ""39339956"", ""34126592"", ""180901428"", ""180747828"", ""241911475"", ""2903554787"", ""2680339380"", ""21719318"", ""121045694"", ""89457594"", ""89947367"", ""419322888"", ""18759573"", ""735705336"", ""116458959"", ""2690842873"", ""2163076560"", ""830622012"", ""22402352"", ""360436867"", ""19952601"", ""2471649080"", ""924354284"", ""361871176"", ""16090877"", ""2543469458"", ""18379848"", ""1030435626"", ""152396951"", ""15430237"", ""377097322"", ""579504493"", ""218503228"", ""248447552"", ""57788007"", ""292092444"", ""2888783532"", ""2356629433"", ""1707841208"", ""1467151153"", ""202516830"", ""74490017"", ""2161075897"", ""276892348"", ""1075005146"", ""2927365819"", ""159438150"", ""2312659651"", ""72526835"", ""2967649792"", ""31891467"", ""23787867"", ""42441516"", ""200245290"", ""181606266"", ""61761935"", ""115707779"", ""122294990"", ""131287716"", ""1137986071"", ""20491503"", ""284227804"", ""163017135"", ""413339220"", ""2823466711"", ""15307435"", ""248317578"", ""14704816"", ""588640557"", ""473504628"", ""259630649"", ""166943853"", ""14987044"", ""2893235717"", ""1063661725"", ""23153001"", ""2945865278"", ""2600147630"", ""58939424"", ""286410173"", ""909591775"", ""47909467"", ""15740635"", ""406829745"", ""199149993"", ""117333411"", ""910318406"", ""1232348810"", ""274639464"", ""275653174"", ""114073151"", ""24156429"", ""871591850"", ""354321161"", ""928677270"", ""807795427"", ""164036072"", ""1001127668"", ""2440645811"", ""17503749"", ""26165656"", ""409867690"", ""2534441287"", ""338366750"", ""722285863"", ""999595358"", ""91608940"", ""134004640"", ""454782645"", ""17817491"", ""2460449173"", ""2968633268"", ""372779355"", ""18455693"", ""309865110"", ""255180467"", ""34178535"", ""136271609"", ""885272058"", ""551131903"", ""454311887"", ""28855043"", ""927696012"", ""1634512056"", ""326579804"", ""32270078"", ""12474932"", ""490097102"", ""1431151166"", ""453487567"", ""260413367"", ""809014566"", ""348070292"", ""186314952"", ""75630518"", ""195059447"", ""819160010"", ""24540377"", ""42971403""]",22,13,35
1575138829,8,58.25,-0.2477620542049408,12704520.0,7,0.625,"[""charliehebdo-all-rnr-threads"", ""sydneysiege-all-rnr-threads"", ""ferguson-all-rnr-threads""]","[""16930489"", ""183341278"", ""342894187"", ""39609732"", ""33519870"", ""216299334"", ""9507342""]",5,3,8
629884158,4,92.75,0.24203944206237793,13418498.0,3,1.0,"[""charliehebdo-all-rnr-threads"", ""germanwings-crash-all-rnr-threads"", ""ottawashooting-all-rnr-threads""]","[""39609732"", ""19211550"", ""70315912""]",4,0,4
413624285,10,97.0,-0.2584386825561523,2079092.0,4,0.7,"[""charliehebdo-all-rnr-threads"", ""sydneysiege-all-rnr-threads""]","[""2271035214"", ""39609732"", ""63362429"", ""377163508""]",7,3,10
2175192882,3,106.0,-0.3102710048357646,6684362.0,2,1.0,"[""charliehebdo-all-rnr-threads"", ""ottawashooting-all-rnr-threads""]","[""39609732"", ""2779009591""]",3,0,3
289998339,13,118.0,-0.07215167925908016,6689034.0,79,0.6923076923076923,"[""charliehebdo-all-rnr-threads"", ""ottawashooting-all-rnr-threads"", ""prince-toronto-all-rnr-threads"", ""sydneysiege-all-rnr-threads""]","[""330929366"", ""543629948"", ""17678529"", ""53102822"", ""206621725"", ""590060199"", ""1881694416"", ""546838312"", ""2798941629"", ""1551604218"", ""272614288"", ""1539904334"", ""1104450438"", ""20683604"", ""136859399"", ""344765105"", ""1244952680"", ""2627173857"", ""2675581850"", ""322281829"", ""337351696"", ""51355872"", ""314950348"", ""104703986"", ""562264738"", ""193114114"", ""14183914"", ""2388043548"", ""274690839"", ""28869233"", ""225113410"", ""2888321602"", ""601588449"", ""33572013"", ""37398020"", ""2450600312"", ""1483893572"", ""1320859458"", ""24795242"", ""1074101239"", ""426435897"", ""148544137"", ""25687273"", ""1308509430"", ""210874244"", ""275338272"", ""310208771"", ""506706634"", ""2262101887"", ""1069277966"", ""44799544"", ""488533531"", ""824250668"", ""16023784"", ""426825447"", ""2852741687"", ""2655230094"", ""1411099453"", ""2447212345"", ""133024127"", ""2839342797"", ""122588492"", ""24995149"", ""24123074"", ""37751043"", ""2332669549"", ""21574142"", ""270411885"", ""62728111"", ""1851214532"", ""16490787"", ""230835236"", ""37822797"", ""1081513452"", ""30609050"", ""633843393"", ""11462742"", ""2284145784"", ""1041078708""]",9,4,13
426435897,2,74.0,0.027261078357696533,2007722.0,2,0.5,"[""charliehebdo-all-rnr-threads"", ""sydneysiege-all-rnr-threads""]","[""289998339"", ""105173441""]",1,1,2
415109792,2,87.0,-0.48339831829071045,2018770.0,1,0.5,"[""charliehebdo-all-rnr-threads"", ""sydneysiege-all-rnr-threads""]","[""5402612""]",1,1,2
1722647352,3,104.66666666666667,-0.7197877367337545,12457269.0,3,0.6666666666666666,"[""charliehebdo-all-rnr-threads"", ""ferguson-all-rnr-threads""]","[""403647191"", ""1008392934"", ""5402612""]",2,1,3
1242171468,2,74.0,-0.5581658482551575,2060251.0,2,0.5,"[""charliehebdo-all-rnr-threads"", ""sydneysiege-all-rnr-threads""]","[""954124423"", ""5402612""]",1,1,2
2419629020,25,112.08,-0.24896246910095216,2199553.0,3,0.84,"[""charliehebdo-all-rnr-threads"", ""sydneysiege-all-rnr-threads""]","[""2257598532"", ""16973333"", ""5402612""]",21,4,25
69340789,9,63.111111111111114,-0.1394734647538927,6666390.0,2,1.0,"[""charliehebdo-all-rnr-threads"", ""ottawashooting-all-rnr-threads""]","[""51241574"", ""5402612""]",9,0,9
366248873,47,102.63829787234043,-0.23229900826799108,2180665.0,2,0.2978723404255319,"[""charliehebdo-all-rnr-threads"", ""sydneysiege-all-rnr-threads""]","[""1367531"", ""5402612""]",14,33,47
16211566,2,124.5,-0.1642545759677887,6517390.0,6,0.5,"[""charliehebdo-all-rnr-threads"", ""germanwings-crash-all-rnr-threads""]","[""173167408"", ""19337423"", ""59812246"", ""40643525"", ""35710757"", ""97357772""]",1,1,2
238197580,3,88.66666666666667,-0.5399076342582703,2040843.0,2,1.0,"[""charliehebdo-all-rnr-threads"", ""sydneysiege-all-rnr-threads""]","[""759251"", ""2889324884""]",3,0,3
173382311,4,80.25,-0.2923154979944229,6710436.0,2,1.0,"[""charliehebdo-all-rnr-threads"", ""ottawashooting-all-rnr-threads""]","[""1652541"", ""2889324884""]",4,0,4
100880543,72,110.33333333333333,-0.4676966965198517,12567236.0,18,1.0,"[""charliehebdo-all-rnr-threads"", ""ferguson-all-rnr-threads""]","[""2858149972"", ""33411018"", ""41767207"", ""12004852"", ""2281350912"", ""602362290"", ""354248645"", ""2480390078"", ""401710943"", ""194168215"", ""1424071273"", ""30122242"", ""501723968"", ""49398502"", ""32986559"", ""100880543"", ""228157264"", ""2739680245""]",72,0,72
2281350912,6,124.83333333333333,-0.2652016282081604,2079887.0,2,0.8333333333333334,"[""charliehebdo-all-rnr-threads"", ""sydneysiege-all-rnr-threads""]","[""28785486"", ""100880543""]",5,1,6
401710943,4,117.0,-0.1233094334602356,6943847.0,4,0.5,"[""charliehebdo-all-rnr-threads"", ""ottawashooting-all-rnr-threads"", ""sydneysiege-all-rnr-threads""]","[""47624589"", ""100880543"", ""28096105"", ""16834659""]",2,2,4
41767207,18,133.61111111111111,-0.3854103585084279,12659985.0,2,0.9444444444444444,"[""charliehebdo-all-rnr-threads"", ""ferguson-all-rnr-threads""]","[""18510860"", ""100880543""]",17,1,18
30122242,26,101.1923076923077,-0.20950815540093642,19785674.0,29,0.34615384615384615,"[""charliehebdo-all-rnr-threads"", ""germanwings-crash-all-rnr-threads"", ""sydneysiege-all-rnr-threads"", ""ferguson-all-rnr-threads""]","[""1287244520"", ""733838438"", ""3003118451"", ""100880543"", ""302142602"", ""30122242"", ""78545411"", ""2896380156"", ""76891950"", ""12811952"", ""2319934142"", ""198359255"", ""205024182"", ""2306285647"", ""94028693"", ""369158562"", ""76858507"", ""69231187"", ""46434040"", ""824915659"", ""162304163"", ""17289449"", ""17537467"", ""107210124"", ""19211550"", ""18783373"", ""53503202"", ""114032121"", ""76994576""]",9,17,26
2858149972,10,101.3,-0.2702162146568298,2104957.0,9,0.3,"[""charliehebdo-all-rnr-threads"", ""sydneysiege-all-rnr-threads""]","[""10102272"", ""427748930"", ""3108351"", ""465973"", ""2461887810"", ""18725815"", ""433584049"", ""100880543"", ""46376581""]",3,7,10
47124097,3,83.33333333333333,-0.23690903186798096,12617921.0,3,0.6666666666666666,"[""charliehebdo-all-rnr-threads"", ""ferguson-all-rnr-threads""]","[""32272710"", ""119972954"", ""49698134""]",2,1,3
268476335,3,140.0,-0.5690595706303915,12562829.0,27,1.0,"[""charliehebdo-all-rnr-threads"", ""ferguson-all-rnr-threads""]","[""2578428787"", ""23179326"", ""2748686820"", ""131201211"", ""37025524"", ""53448694"", ""202740010"", ""85947311"", ""1196183660"", ""35728268"", ""428659042"", ""18029837"", ""774153380"", ""85772667"", ""127496158"", ""268551843"", ""268476335"", ""254462484"", ""255722041"", ""17539336"", ""21063394"", ""253257813"", ""1857973608"", ""586557301"", ""2388910731"", ""1163070384"", ""239875508""]",3,0,3
1857973608,3,72.0,-0.6409335931142172,13094841.0,3,0.3333333333333333,"[""charliehebdo-all-rnr-threads"", ""ferguson-all-rnr-threads""]","[""14090948"", ""759251"", ""268476335""]",1,2,3
239875508,6,108.66666666666667,-0.17195507884025574,2136888.0,4,0.5,"[""charliehebdo-all-rnr-threads"", ""sydneysiege-all-rnr-threads""]","[""14173315"", ""441636351"", ""17537467"", ""268476335""]",3,3,6
2878172763,6,97.5,-0.24513915181159973,2066552.0,3,0.16666666666666666,"[""charliehebdo-all-rnr-threads"", ""sydneysiege-all-rnr-threads""]","[""14138785"", ""16973333"", ""59440137""]",1,5,6
351263372,9,83.33333333333333,-0.619163990020752,2182736.0,3,0.6666666666666666,"[""charliehebdo-all-rnr-threads"", ""sydneysiege-all-rnr-threads""]","[""380285402"", ""87416722"", ""742143""]",6,3,9
296948666,3,81.0,0.04017690817515055,2075959.0,3,0.6666666666666666,"[""charliehebdo-all-rnr-threads"", ""sydneysiege-all-rnr-threads""]","[""7587032"", ""87416722"", ""5402612""]",2,1,3
2793506633,2,18.0,-0.12270081043243408,6491154.0,2,0.5,"[""charliehebdo-all-rnr-threads"", ""germanwings-crash-all-rnr-threads""]","[""14138785"", ""16973333""]",1,1,2
628038157,14,108.28571428571429,-0.3872943903718676,6785563.0,8,0.5714285714285714,"[""charliehebdo-all-rnr-threads"", ""ottawashooting-all-rnr-threads""]","[""14173315"", ""868112707"", ""14293310"", ""1877831"", ""51241574"", ""6017542"", ""15754281"", ""5402612""]",8,6,14
2685015253,2,59.0,-0.43289268016815186,2083710.0,2,1.0,"[""charliehebdo-all-rnr-threads"", ""sydneysiege-all-rnr-threads""]","[""6017542"", ""51241574""]",2,0,2
14173315,49,119.93877551020408,-0.3334808969984251,19313814.0,437,0.6122448979591837,"[""charliehebdo-all-rnr-threads"", ""germanwings-crash-all-rnr-threads"", ""sydneysiege-all-rnr-threads"", ""ottawashooting-all-rnr-threads"", ""ferguson-all-rnr-threads""]","[""1239062041"", ""21923301"", ""947860201"", ""85348046"", ""264906424"", ""498319563"", ""1109685884"", ""1048739886"", ""587935398"", ""43521065"", ""14173315"", ""1411897166"", ""562920723"", ""28838306"", ""260354965"", ""81216823"", ""811881092"", ""766658"", ""321059889"", ""247334850"", ""31816832"", ""187408256"", ""383225803"", ""1737781596"", ""2264503075"", ""1911964296"", ""225521111"", ""2435550511"", ""1332666337"", ""712468253"", ""146200439"", ""377555729"", ""2817249356"", ""5666732"", ""295474600"", ""51670985"", ""348147023"", ""75958795"", ""345555307"", ""592214012"", ""2560148358"", ""758132576"", ""183114838"", ""2875047336"", ""125011812"", ""929662333"", ""15690298"", ""2500030157"", ""90888044"", ""2663137088"", ""2735568390"", ""114020146"", ""99108648"", ""344412774"", ""56781563"", ""2922814893"", ""62155958"", ""417691545"", ""95199164"", ""976219603"", ""386163662"", ""989234678"", ""40329700"", ""21531242"", ""14688058"", ""16529278"", ""15188077"", ""152292232"", ""19949975"", ""2161859750"", ""1352795052"", ""2458889550"", ""65526277"", ""250393818"", ""23336328"", ""239472065"", ""2856927247"", ""27413161"", ""56933871"", ""309119396"", ""38133247"", ""391052129"", ""58934739"", ""12380812"", ""1101168920"", ""428308662"", ""43111662"", ""2417374160"", ""261602610"", ""491865725"", ""17235165"", ""1049040930"", ""25181713"", ""720725023"", ""324658179"", ""2901750487"", ""1373532835"", ""159249668"", ""1663103508"", ""2497286180"", ""225503094"", ""18717465"", ""224082338"", ""150345163"", ""3091027107"", ""82682487"", ""1870516538"", ""1954387958"", ""61567655"", ""426354646"", ""191093637"", ""17436585"", ""402070775"", ""2572794365"", ""124302756"", ""309162320"", ""28206550"", ""2873267413"", ""171091425"", ""1032825270"", ""54489465"", ""2601685062"", ""35463248"", ""55967990"", ""123622674"", ""17935077"", ""545772069"", ""1378109503"", ""329976431"", ""70840791"", ""116273024"", ""128699956"", ""2479789147"", ""86529914"", ""1213237104"", ""1725724380"", ""295495044"", ""2404923614"", ""296505265"", ""25908382"", ""408150347"", ""21269438"", ""2577602433"", ""312813243"", ""301652348"", ""15922161"", ""2577680166"", ""279681294"", ""476853918"", ""167632416"", ""1188728394"", ""2766929145"", ""2421135257"", ""956485507"", ""48304732"", ""903143731"", ""62591883"", ""70120412"", ""1089154554"", ""494349825"", ""2842590826"", ""2497874076"", ""354917016"", ""2316346471"", ""70743640"", ""2577436002"", ""194154954"", ""272045009"", ""473472787"", ""15219854"", ""44272969"", ""467087280"", ""24467057"", ""2626482516"", ""293768205"", ""316405268"", ""218593858"", ""282390088"", ""1062791150"", ""159447476"", ""2654195378"", ""205112845"", ""2936694741"", ""2474493694"", ""2862319827"", ""409679126"", ""97519068"", ""25689501"", ""592708606"", ""363119009"", ""2464502209"", ""475315078"", ""2804183066"", ""172232963"", ""593440072"", ""183960617"", ""26193011"", ""521489078"", ""73312315"", ""1571699462"", ""32165285"", ""30148992"", ""887340002"", ""37616102"", ""485324928"", ""61089608"", ""1449478590"", ""714272731"", ""283803602"", ""353147411"", ""556180021"", ""2817243859"", ""93015846"", ""451019170"", ""290326947"", ""293719747"", ""159920872"", ""2182088840"", ""196065002"", ""229743093"", ""35759628"", ""264582867"", ""18692955"", ""126293966"", ""47052792"", ""22119246"", ""140187322"", ""1417812433"", ""2214510864"", ""2389924765"", ""1484906744"", ""69661743"", ""2215260181"", ""283959279"", ""628038157"", ""260505307"", ""1420787767"", ""787887222"", ""2462593885"", ""284813143"", ""37183987"", ""164753964"", ""2147515585"", ""2763083529"", ""2847286171"", ""501178889"", ""1943263711"", ""283892304"", ""183832473"", ""200641413"", ""249228197"", ""522754788"", ""384062792"", ""91557233"", ""184827391"", ""858157333"", ""69115474"", ""2365622293"", ""846939530"", ""479000591"", ""414123074"", ""259353418"", ""375239846"", ""2741636707"", ""75971805"", ""33711244"", ""2690842873"", ""240279011"", ""576668548"", ""2419368481"", ""2875761863"", ""277147330"", ""151351438"", ""425906548"", ""1613858876"", ""58341062"", ""2895823046"", ""1687941666"", ""2883007650"", ""54248664"", ""594244296"", ""28619781"", ""252978405"", ""2881605653"", ""220731517"", ""381012847"", ""1563925562"", ""1658674446"", ""205404891"", ""31066684"", ""1031773916"", ""539569440"", ""18970657"", ""1948926008"", ""522638276"", ""2187387666"", ""601342849"", ""198938888"", ""406716292"", ""1684795675"", ""983235253"", ""1149353412"", ""211991277"", ""611058482"", ""785082055"", ""73891239"", ""78144408"", ""2370908751"", ""2728348611"", ""2445446947"", ""37692162"", ""1554387499"", ""24459544"", ""159689626"", ""813276"", ""1084397502"", ""61902243"", ""187805921"", ""53440950"", ""1206007376"", ""1623289296"", ""45835391"", ""287626790"", ""17366667"", ""1903812320"", ""1637725969"", ""112040405"", ""514452771"", ""2723735572"", ""51727927"", ""2330527741"", ""209619795"", ""2915660732"", ""158353895"", ""2846769033"", ""60830577"", ""1268438574"", ""16273700"", ""1004484211"", ""123121482"", ""102807025"", ""2888761394"", ""282133249"", ""382856329"", ""2493987576"", ""29870604"", ""25285559"", ""16642528"", ""1085149063"", ""2674312449"", ""490002042"", ""100634191"", ""91812492"", ""281831774"", ""25300556"", ""21330040"", ""151827802"", ""2601118704"", ""1348798826"", ""132254964"", ""239875508"", ""109672975"", ""2616034362"", ""406829745"", ""15580650"", ""1234987687"", ""42935252"", ""66878080"", ""36530776"", ""2745150799"", ""2515278999"", ""22707692"", ""546886420"", ""1379250560"", ""230720547"", ""319825431"", ""523349706"", ""1711930446"", ""494708954"", ""2783411121"", ""2790538982"", ""2184465216"", ""40004064"", ""787325430"", ""49981219"", ""136516156"", ""20032587"", ""804920876"", ""2863757533"", ""2333745212"", ""15016500"", ""587383223"", ""2344678944"", ""47491845"", ""2241029670"", ""1424071273"", ""2824442646"", ""633347340"", ""381270604"", ""34502387"", ""2821577173"", ""26695877"", ""2205768662"", ""2389777327"", ""2314684839"", ""15774139"", ""182694077"", ""49688747"", ""25943764"", ""475368798"", ""44970758"", ""1490960996"", ""1340721432"", ""102803388"", ""1190146039"", ""208937100"", ""22999688"", ""464329417"", ""950697206"", ""1060478178"", ""143643872"", ""622969430"", ""176956930"", ""265707231"", ""178888741"", ""47063444"", ""310975510"", ""2617194469"", ""625044288"", ""206962580"", ""965524621"", ""27479443"", ""2850249772"", ""879540642"", ""1638883418"", ""532007000"", ""37027891""]",30,19,49
1068121346,5,121.8,-0.2868041157722473,2091095.0,52,0.2,"[""charliehebdo-all-rnr-threads"", ""sydneysiege-all-rnr-threads""]","[""109986058"", ""1373494208"", ""1909390567"", ""411811711"", ""59489293"", ""1493984264"", ""295622436"", ""2892316270"", ""207980039"", ""2696436181"", ""226672378"", ""164897733"", ""2908520384"", ""96148306"", ""15875423"", ""190183745"", ""1060468963"", ""180961394"", ""72381210"", ""260715321"", ""2784761424"", ""1582497511"", ""316559156"", ""786446162"", ""1344297120"", ""248021167"", ""606539838"", ""37199309"", ""1241042244"", ""261241914"", ""488877098"", ""2852446116"", ""1711365822"", ""860616002"", ""2527730201"", ""27840475"", ""2932422959"", ""2717075357"", ""74636607"", ""27894340"", ""2906692454"", ""2476650373"", ""268515146"", ""420223654"", ""1616592169"", ""125275062"", ""74030266"", ""19607211"", ""227703159"", ""1151095778"", ""738565416"", ""17857396""]",1,4,5
2476650373,2,79.0,-0.6718645393848419,2094286.0,2,0.5,"[""charliehebdo-all-rnr-threads"", ""sydneysiege-all-rnr-threads""]","[""281754653"", ""1068121346""]",1,1,2
132494834,3,86.66666666666667,-0.03780066967010498,2078386.0,3,0.6666666666666666,"[""charliehebdo-all-rnr-threads"", ""sydneysiege-all-rnr-threads""]","[""6017542"", ""16973333"", ""7587032""]",2,1,3
510996222,3,84.33333333333333,-0.06350143750508626,2070420.0,3,0.3333333333333333,"[""charliehebdo-all-rnr-threads"", ""sydneysiege-all-rnr-threads""]","[""16973333"", ""14095052"", ""2461887810""]",1,2,3
501178889,8,121.0,-0.6803299635648727,2189587.0,3,0.75,"[""charliehebdo-all-rnr-threads"", ""sydneysiege-all-rnr-threads""]","[""14173315"", ""16215478"", ""2345696184""]",6,2,8
309119396,4,69.5,-0.32382774353027344,2142113.0,2,0.75,"[""charliehebdo-all-rnr-threads"", ""sydneysiege-all-rnr-threads""]","[""14173315"", ""1367531""]",3,1,4
79939817,3,96.66666666666667,-0.20503481229146323,2171159.0,3,0.3333333333333333,"[""charliehebdo-all-rnr-threads"", ""sydneysiege-all-rnr-threads""]","[""3108351"", ""16973333"", ""292777349""]",1,2,3
54882415,6,61.5,0.3328347404797872,6817846.0,6,0.3333333333333333,"[""charliehebdo-all-rnr-threads"", ""ottawashooting-all-rnr-threads""]","[""16973333"", ""2097571"", ""413157362"", ""12716032"", ""972651"", ""384455157""]",2,4,6
29979814,12,83.41666666666667,0.3955746740102768,12748911.0,32,0.08333333333333333,"[""charliehebdo-all-rnr-threads"", ""ferguson-all-rnr-threads""]","[""584665370"", ""22161479"", ""305097283"", ""250750991"", ""335871995"", ""17187492"", ""1100846148"", ""228535069"", ""18083070"", ""2263590002"", ""11740172"", ""14887755"", ""175307482"", ""500995375"", ""2780648743"", ""41670593"", ""92913722"", ""159544191"", ""471795640"", ""1952105298"", ""1463313162"", ""26279847"", ""16102620"", ""2402563808"", ""23045174"", ""899716645"", ""49388979"", ""29979814"", ""78369798"", ""1318683378"", ""43679281"", ""493776189""]",1,11,12
22403315,14,95.64285714285714,-0.3839161438601358,6726550.0,10,0.07142857142857142,"[""charliehebdo-all-rnr-threads"", ""ottawashooting-all-rnr-threads""]","[""16973333"", ""15170194"", ""140955302"", ""21439144"", ""19341389"", ""31135856"", ""270016438"", ""16469809"", ""299378671"", ""5402612""]",1,13,14
441036257,4,59.25,-0.4174751043319702,2096409.0,3,0.5,"[""charliehebdo-all-rnr-threads"", ""sydneysiege-all-rnr-threads""]","[""7587032"", ""20848139"", ""5402612""]",2,2,4
416690465,11,96.72727272727273,-0.21948786757209085,12739322.0,5,0.7272727272727273,"[""charliehebdo-all-rnr-threads"", ""sydneysiege-all-rnr-threads"", ""ferguson-all-rnr-threads""]","[""14526877"", ""1367531"", ""1960878613"", ""35051304"", ""5402612""]",8,3,11
221310328,11,81.63636363636364,-0.32148145545612683,6564579.0,6,0.2727272727272727,"[""charliehebdo-all-rnr-threads"", ""germanwings-crash-all-rnr-threads""]","[""532779460"", ""15348883"", ""14569869"", ""780024367"", ""87818409"", ""5402612""]",3,8,11
1927566248,7,77.28571428571429,0.27127502645765034,6819676.0,4,1.0,"[""charliehebdo-all-rnr-threads"", ""ottawashooting-all-rnr-threads""]","[""1652541"", ""15438913"", ""7587032"", ""5402612""]",7,0,7
438601264,7,45.857142857142854,-0.11263923985617501,5648997.0,3,0.2857142857142857,"[""charliehebdo-all-rnr-threads"", ""putinmissing-all-rnr-threads""]","[""15438913"", ""7587032"", ""21182691""]",2,5,7
18466590,5,114.4,-0.521257746219635,6658335.0,1,1.0,"[""charliehebdo-all-rnr-threads"", ""germanwings-crash-all-rnr-threads""]","[""87416722""]",5,0,5
19045104,2,96.5,-0.21974444389343262,12801751.0,2,0.5,"[""charliehebdo-all-rnr-threads"", ""ferguson-all-rnr-threads""]","[""16973333"", ""14321959""]",1,1,2
1119305256,4,42.75,-0.4145108312368393,2093129.0,4,0.25,"[""charliehebdo-all-rnr-threads"", ""sydneysiege-all-rnr-threads""]","[""16973333"", ""742143"", ""270569708"", ""2653613168""]",1,3,4
1180564789,2,58.5,0.3154851198196411,6710362.0,2,1.0,"[""charliehebdo-all-rnr-threads"", ""ottawashooting-all-rnr-threads""]","[""16973333"", ""7587032""]",2,0,2
2885348567,19,106.78947368421052,-0.5865764806145116,2186002.0,12,0.3684210526315789,"[""charliehebdo-all-rnr-threads"", ""sydneysiege-all-rnr-threads""]","[""1367531"", ""7587032"", ""1375289149"", ""1020058453"", ""15754281"", ""742143"", ""7744592"", ""64643056"", ""16343974"", ""87818409"", ""2768501"", ""5402612""]",7,12,19
4970411,13,129.76923076923077,-0.45335102539796096,13189110.0,83,0.3076923076923077,"[""charliehebdo-all-rnr-threads"", ""germanwings-crash-all-rnr-threads"", ""ottawashooting-all-rnr-threads"", ""sydneysiege-all-rnr-threads""]","[""29747246"", ""796375668"", ""15297348"", ""2933091346"", ""94248769"", ""259166697"", ""453385090"", ""2449982929"", ""2844404412"", ""2967066814"", ""1217590153"", ""52012677"", ""316695856"", ""2966627041"", ""22529583"", ""2408067523"", ""576323963"", ""2873429769"", ""2923782684"", ""149975156"", ""54524007"", ""297392086"", ""2260283116"", ""2959175634"", ""21687995"", ""4970411"", ""18673811"", ""61035181"", ""2786924315"", ""238661633"", ""137086244"", ""259300744"", ""121531810"", ""185287105"", ""2292332876"", ""181864051"", ""73657561"", ""525625427"", ""332605972"", ""366652585"", ""374215189"", ""215111370"", ""27933437"", ""578320877"", ""65039239"", ""311028372"", ""2535254532"", ""348101654"", ""2558035557"", ""1323035978"", ""701094366"", ""41156456"", ""101416860"", ""59511457"", ""2615258356"", ""48843015"", ""740763697"", ""42791906"", ""481627355"", ""241877307"", ""390790649"", ""17444890"", ""1853914981"", ""75359240"", ""245687126"", ""388825750"", ""223604018"", ""116754368"", ""137214604"", ""2771542204"", ""147501168"", ""419267042"", ""1671975163"", ""28086543"", ""2460904493"", ""2992452341"", ""2326945596"", ""273054503"", ""2660260377"", ""29577416"", ""327556586"", ""584800875"", ""1267588176""]",4,9,13
2844404412,2,39.5,-0.20377063751220703,2055453.0,2,0.5,"[""charliehebdo-all-rnr-threads"", ""sydneysiege-all-rnr-threads""]","[""4970411"", ""23041630""]",1,1,2
48304732,14,139.71428571428572,-0.21102451852389745,6743716.0,12,0.21428571428571427,"[""charliehebdo-all-rnr-threads"", ""ottawashooting-all-rnr-threads"", ""sydneysiege-all-rnr-threads""]","[""14173315"", ""16973333"", ""1877831"", ""8736882"", ""1652541"", ""26012202"", ""330906573"", ""3108351"", ""87416722"", ""50348344"", ""786764"", ""338968305""]",3,11,14
1562935142,6,106.83333333333333,-0.060994615157445274,2089383.0,87,0.16666666666666666,"[""charliehebdo-all-rnr-threads"", ""sydneysiege-all-rnr-threads""]","[""2517335123"", ""2509853635"", ""64127121"", ""392340964"", ""883239463"", ""18142983"", ""197563371"", ""21231908"", ""26292218"", ""18952983"", ""541715779"", ""67340449"", ""20658917"", ""34945490"", ""15780691"", ""404750664"", ""274134128"", ""2905430920"", ""516404211"", ""307259311"", ""21679976"", ""88105583"", ""559433611"", ""168841729"", ""180901428"", ""373528975"", ""21078743"", ""2882783909"", ""19388832"", ""1909191404"", ""19455392"", ""1605914786"", ""2448522264"", ""1540484833"", ""1078347888"", ""1103117258"", ""94718067"", ""2875761863"", ""81672110"", ""51578079"", ""38445526"", ""26870652"", ""2607703608"", ""279788564"", ""302205765"", ""18755443"", ""98893873"", ""1394418516"", ""40029929"", ""307900091"", ""236396691"", ""626044430"", ""2735655330"", ""315024285"", ""133240108"", ""2654842970"", ""179732982"", ""1960426465"", ""2535400212"", ""2911021701"", ""358136244"", ""409460802"", ""16744227"", ""300307207"", ""514179265"", ""2506835746"", ""2925094346"", ""2385431253"", ""266764912"", ""605295936"", ""89929611"", ""2945871636"", ""148036048"", ""426038806"", ""428308662"", ""2180155964"", ""1029253586"", ""2385557324"", ""180961394"", ""596381503"", ""2515377882"", ""376191841"", ""62728111"", ""389548615"", ""2831713327"", ""414653470"", ""215435356""]",1,5,6
179732982,8,129.125,-0.3016577288508415,12595476.0,40,0.875,"[""charliehebdo-all-rnr-threads"", ""ferguson-all-rnr-threads""]","[""30130263"", ""394497108"", ""2308538340"", ""1562935142"", ""122745846"", ""722630419"", ""17925611"", ""204660784"", ""818969215"", ""902528816"", ""434720449"", ""24379982"", ""452248666"", ""1621144291"", ""170684305"", ""237011341"", ""2402060774"", ""110459289"", ""2736638706"", ""225869431"", ""179732982"", ""2524750897"", ""33839296"", ""876226856"", ""166270542"", ""981657048"", ""1456172125"", ""579991485"", ""1938260035"", ""113178263"", ""59515817"", ""20545422"", ""377440844"", ""829123928"", ""496734925"", ""1038066661"", ""154925400"", ""2358039120"", ""1349538888"", ""178235191""]",7,1,8
2735655330,3,56.0,-0.31747015317281085,6699043.0,2,1.0,"[""charliehebdo-all-rnr-threads"", ""germanwings-crash-all-rnr-threads""]","[""1562935142"", ""2163076560""]",3,0,3
28785486,54,124.72222222222223,-0.3028051091565026,19099189.0,443,0.5925925925925926,"[""charliehebdo-all-rnr-threads"", ""germanwings-crash-all-rnr-threads"", ""sydneysiege-all-rnr-threads"", ""ottawashooting-all-rnr-threads"", ""ferguson-all-rnr-threads""]","[""133211017"", ""212226464"", ""711730988"", ""84548595"", ""259166697"", ""615739534"", ""85014040"", ""1137979866"", ""394703874"", ""2922160087"", ""19806962"", ""232393095"", ""2341028683"", ""2396412966"", ""33760765"", ""1007792130"", ""718737756"", ""264005068"", ""56666374"", ""2183118511"", ""1100873592"", ""283958013"", ""59612303"", ""81216823"", ""309822757"", ""1732867261"", ""304242593"", ""82881002"", ""2195199840"", ""724521750"", ""267906861"", ""34016877"", ""168840820"", ""77777460"", ""192725029"", ""2264503075"", ""2895209637"", ""45908865"", ""103972238"", ""264473449"", ""2364751496"", ""37666604"", ""712468253"", ""22684884"", ""318358387"", ""525702401"", ""1403764388"", ""2560148358"", ""43327554"", ""27663582"", ""285577465"", ""2199743879"", ""494842201"", ""1565923734"", ""1257734767"", ""111579633"", ""874824648"", ""1023417762"", ""50941014"", ""19331152"", ""2588155512"", ""2250804206"", ""2263772618"", ""21003013"", ""28441643"", ""1612968180"", ""1515801284"", ""377119331"", ""194388077"", ""2813765185"", ""524159710"", ""563123148"", ""41704550"", ""1488864481"", ""264333941"", ""168602253"", ""82998105"", ""177730452"", ""1258325856"", ""935856000"", ""2162983369"", ""2314634707"", ""400434619"", ""57188441"", ""2315834142"", ""32483614"", ""860856012"", ""73416159"", ""518201306"", ""1721215850"", ""1309174525"", ""2951665768"", ""406445860"", ""262348688"", ""396893560"", ""25669679"", ""1278586290"", ""273325769"", ""86026819"", ""2394981079"", ""2574860244"", ""41623942"", ""534308567"", ""495115403"", ""58302091"", ""2803849820"", ""1658030684"", ""2193063652"", ""267237983"", ""390263202"", ""16400142"", ""1713036884"", ""1641718777"", ""2497286180"", ""2504386075"", ""2322095298"", ""2907840246"", ""745265886"", ""277211228"", ""181344165"", ""17581602"", ""613724954"", ""348847011"", ""45128645"", ""910124983"", ""554969283"", ""37685181"", ""108368459"", ""191093637"", ""17436585"", ""256615450"", ""39766984"", ""360730047"", ""297242658"", ""17429182"", ""96244116"", ""235665057"", ""1018823131"", ""19578675"", ""229155407"", ""964528909"", ""285914311"", ""409335738"", ""2903053296"", ""2402349354"", ""2302159284"", ""43054730"", ""255354721"", ""18251461"", ""274478755"", ""956687742"", ""815481722"", ""2727480569"", ""2510649648"", ""38230678"", ""2899192880"", ""2403657412"", ""84350975"", ""261000330"", ""903143731"", ""1071402942"", ""188869825"", ""14735639"", ""248784419"", ""199946738"", ""269816511"", ""59586322"", ""2777381458"", ""380594508"", ""2217185738"", ""54199578"", ""1030592935"", ""2886586060"", ""1478998278"", ""1045295202"", ""1062791150"", ""344816505"", ""2904699168"", ""206756788"", ""2851263210"", ""47502031"", ""2612532926"", ""48743381"", ""749939078"", ""502254054"", ""119759920"", ""28263687"", ""2862319827"", ""2807772065"", ""2859958581"", ""849342841"", ""2429548903"", ""387516768"", ""400358971"", ""481752913"", ""489497300"", ""38990352"", ""250178611"", ""29063395"", ""2877158969"", ""21846453"", ""40651462"", ""2575759197"", ""35310833"", ""234269635"", ""249322219"", ""1368474618"", ""359020843"", ""31219247"", ""21625716"", ""27910818"", ""255552783"", ""416668840"", ""149666064"", ""2821683741"", ""53624244"", ""2951224168"", ""118214601"", ""295058041"", ""2252446281"", ""16059828"", ""63921811"", ""213041814"", ""35759628"", ""1498760984"", ""20247382"", ""59938412"", ""2193653428"", ""34497962"", ""16643532"", ""334387917"", ""1215763321"", ""15861899"", ""23470695"", ""1652458177"", ""2815203144"", ""1484450803"", ""149043514"", ""2223966244"", ""107031620"", ""2285944336"", ""305502995"", ""323245161"", ""36035381"", ""135649629"", ""460738493"", ""384336759"", ""52317587"", ""851896567"", ""2781960407"", ""78898625"", ""31460850"", ""144356139"", ""168491473"", ""464634225"", ""24400524"", ""593181922"", ""2783818447"", ""64094267"", ""244806580"", ""377061441"", ""99337454"", ""1739650556"", ""535114284"", ""2603703420"", ""287763940"", ""76175716"", ""134488899"", ""2781968155"", ""2901126156"", ""2487221479"", ""2495412380"", ""414123074"", ""70617933"", ""495121007"", ""2940041869"", ""2970101113"", ""232080325"", ""28130163"", ""1871679841"", ""2875534515"", ""16921111"", ""240355214"", ""14379689"", ""39403686"", ""342893331"", ""1372692300"", ""2496517866"", ""2828277842"", ""46476819"", ""21803786"", ""2587656930"", ""241760841"", ""2317241800"", ""61889817"", ""33801361"", ""169772193"", ""14574597"", ""15974789"", ""14247096"", ""18649788"", ""2725970806"", ""22422706"", ""969418525"", ""2768713667"", ""505322398"", ""127587958"", ""2900038735"", ""774735289"", ""1149353412"", ""292638353"", ""1027528664"", ""374357782"", ""167862232"", ""436986320"", ""125236825"", ""18467299"", ""49582123"", ""400360169"", ""2774026927"", ""2503165899"", ""706948371"", ""2774417460"", ""2737829545"", ""26464926"", ""525753971"", ""103487694"", ""1388688583"", ""29914322"", ""2799850290"", ""42565336"", ""26615884"", ""724596810"", ""25069093"", ""2402690081"", ""408194759"", ""32138442"", ""348457547"", ""95097330"", ""50736496"", ""2760665943"", ""2571457676"", ""330013387"", ""2211081060"", ""836209867"", ""2187199279"", ""370775638"", ""313641424"", ""2927861964"", ""76994576"", ""137936688"", ""2723735572"", ""841058988"", ""1483825754"", ""830227452"", ""18558809"", ""3041579847"", ""22146954"", ""1704909612"", ""2310813366"", ""2888127365"", ""503749143"", ""335486578"", ""40148667"", ""2945865278"", ""291711469"", ""465046002"", ""2899924184"", ""464231162"", ""189460217"", ""304039676"", ""1206161593"", ""521592931"", ""15249113"", ""546913986"", ""35921682"", ""260966532"", ""34418222"", ""323076264"", ""1380691543"", ""80866049"", ""11770332"", ""847605858"", ""1689277844"", ""299213400"", ""523467953"", ""33597588"", ""272321542"", ""156334907"", ""17700085"", ""1379250560"", ""260239302"", ""61359143"", ""551750280"", ""139491591"", ""707982757"", ""28101457"", ""2788131814"", ""122934798"", ""14486438"", ""433787314"", ""2871741875"", ""188030355"", ""1428693931"", ""28785486"", ""14662121"", ""113796182"", ""92855040"", ""1078368642"", ""465790247"", ""2439538555"", ""2821577173"", ""85308262"", ""347913941"", ""268031972"", ""16145763"", ""18455693"", ""20845597"", ""2620662823"", ""564344577"", ""2281350912"", ""58104347"", ""428750698"", ""73424289"", ""110129833"", ""201691608"", ""18921995"", ""1720731416"", ""317279748"", ""142150016"", ""635173618"", ""46808996"", ""250707028"", ""514688350"", ""79802631"", ""221373945"", ""2282954094"", ""2355478825"", ""2915935225"", ""2375634619"", ""988704438"", ""864927037"", ""18670998""]",32,22,54
2241324176,2,75.0,-0.09795665740966797,6480638.0,1,0.5,"[""charliehebdo-all-rnr-threads"", ""germanwings-crash-all-rnr-threads""]","[""7587032""]",1,1,2
17045133,2,120.0,-0.29796284437179565,5600518.0,12,0.5,"[""charliehebdo-all-rnr-threads"", ""putinmissing-all-rnr-threads""]","[""163113368"", ""1078425018"", ""15730804"", ""14557480"", ""62324947"", ""49430686"", ""1963598808"", ""1962596220"", ""60476469"", ""15737761"", ""265376095"", ""407702780""]",1,1,2
54489465,6,102.5,-0.08437448740005493,2120792.0,15,0.5,"[""charliehebdo-all-rnr-threads"", ""sydneysiege-all-rnr-threads""]","[""249895981"", ""14173315"", ""2616938000"", ""16973333"", ""1536797588"", ""2243999444"", ""25211509"", ""25777812"", ""54489465"", ""45587911"", ""27852173"", ""142021771"", ""255118008"", ""22607317"", ""359015191""]",3,3,6
239466907,2,17.0,0.09714663028717041,2075058.0,1,0.5,"[""charliehebdo-all-rnr-threads"", ""sydneysiege-all-rnr-threads""]","[""16973333""]",1,1,2
1467733123,3,129.0,0.38501906394958496,2150846.0,15,0.3333333333333333,"[""charliehebdo-all-rnr-threads"", ""sydneysiege-all-rnr-threads""]","[""2869269365"", ""20203344"", ""311414095"", ""196096646"", ""400360169"", ""2831354731"", ""600922364"", ""340626862"", ""44477065"", ""453537985"", ""850841780"", ""1582155954"", ""2907370742"", ""57913149"", ""256531639""]",1,2,3
2853256766,3,73.66666666666667,-0.499012291431427,2152113.0,3,0.6666666666666666,"[""charliehebdo-all-rnr-threads"", ""sydneysiege-all-rnr-threads""]","[""1367531"", ""2097571"", ""807095""]",2,1,3
2852446116,11,133.36363636363637,0.49046552181243896,8585966.0,6,0.6363636363636364,"[""charliehebdo-all-rnr-threads"", ""germanwings-crash-all-rnr-threads"", ""sydneysiege-all-rnr-threads""]","[""1068121346"", ""2097571"", ""742143"", ""428333"", ""972651"", ""5402612""]",7,4,11
538765846,12,134.5,-0.6311228622992834,13047175.0,10,0.25,"[""charliehebdo-all-rnr-threads"", ""ferguson-all-rnr-threads""]","[""2190056023"", ""15108530"", ""109065990"", ""3108351"", ""15438913"", ""15754281"", ""14090948"", ""972651"", ""1381926373"", ""428333""]",3,9,12
1030435626,20,121.45,-0.3521736800670624,6824009.0,14,0.55,"[""charliehebdo-all-rnr-threads"", ""ottawashooting-all-rnr-threads"", ""sydneysiege-all-rnr-threads""]","[""7309052"", ""868112707"", ""51241574"", ""15108702"", ""2097571"", ""380648579"", ""15438913"", ""759251"", ""742143"", ""2799960092"", ""50348344"", ""2836941830"", ""83638901"", ""428333""]",11,9,20
264862915,12,74.16666666666666,-0.18748906751473748,2213221.0,4,0.8333333333333334,"[""charliehebdo-all-rnr-threads"", ""sydneysiege-all-rnr-threads""]","[""53789862"", ""292777349"", ""7587032"", ""20159596""]",10,2,12
336002124,3,85.0,-0.08164095878601074,2081557.0,2,0.6666666666666666,"[""charliehebdo-all-rnr-threads"", ""sydneysiege-all-rnr-threads""]","[""15374755"", ""20159596""]",2,1,3
972651,33,122.66666666666667,-0.3345790631843335,19097160.0,302,0.5151515151515151,"[""charliehebdo-all-rnr-threads"", ""germanwings-crash-all-rnr-threads"", ""sydneysiege-all-rnr-threads"", ""ottawashooting-all-rnr-threads"", ""ferguson-all-rnr-threads""]","[""488232923"", ""2425183427"", ""107031620"", ""57206966"", ""586322351"", ""1060743756"", ""418395255"", ""16651784"", ""86306029"", ""2714207155"", ""1482977316"", ""74664013"", ""386991434"", ""409769195"", ""1489728072"", ""192414391"", ""38845294"", ""861538412"", ""3041579847"", ""192277923"", ""2369482951"", ""75315133"", ""52806914"", ""61839433"", ""976069400"", ""889781113"", ""306079041"", ""316562687"", ""80142540"", ""1455101366"", ""25173947"", ""11094282"", ""364046816"", ""160241472"", ""2315428177"", ""277774138"", ""274663144"", ""15130854"", ""1695147684"", ""178078681"", ""115700682"", ""23103000"", ""515254424"", ""50078523"", ""607311691"", ""2231189869"", ""1590592436"", ""272598978"", ""89143402"", ""234059883"", ""1165979425"", ""2735552054"", ""24853675"", ""1577710783"", ""48698510"", ""56914204"", ""281969201"", ""268061821"", ""64220143"", ""1021248438"", ""713769332"", ""112472551"", ""62738045"", ""71031689"", ""60338278"", ""17190622"", ""14513819"", ""815725783"", ""79330780"", ""304303205"", ""15382223"", ""213270786"", ""322609857"", ""77323101"", ""2409887767"", ""2871002565"", ""51652149"", ""3087187654"", ""158014608"", ""459581217"", ""103016417"", ""44595967"", ""1416343825"", ""2238411649"", ""2958990716"", ""196086790"", ""108157782"", ""19015615"", ""1516168694"", ""2423249816"", ""226440623"", ""565423513"", ""1719933126"", ""1113627067"", ""25343373"", ""428860598"", ""2384105730"", ""11034112"", ""84959697"", ""83652774"", ""2415264335"", ""311001818"", ""1574914610"", ""8648302"", ""1355170518"", ""26892042"", ""842791753"", ""171494213"", ""9836742"", ""190018869"", ""129181096"", ""21935680"", ""1717208412"", ""24397183"", ""122560076"", ""25717256"", ""14262590"", ""841911949"", ""21824313"", ""972651"", ""2225184676"", ""2944429343"", ""14227485"", ""1198705884"", ""5727392"", ""2852446116"", ""20777381"", ""2418899281"", ""40298256"", ""8037402"", ""116926997"", ""19909827"", ""19496695"", ""30935427"", ""259724375"", ""236694749"", ""2172352730"", ""13083622"", ""53831819"", ""139038691"", ""67946122"", ""22385603"", ""186457433"", ""711538602"", ""2348001955"", ""134905706"", ""16285547"", ""983777994"", ""138676224"", ""2320139270"", ""611465372"", ""111975492"", ""23033713"", ""423693045"", ""532842211"", ""49020336"", ""16827864"", ""51309259"", ""36394732"", ""2310107706"", ""508110571"", ""45446985"", ""14761257"", ""389640756"", ""442069641"", ""9853482"", ""20727451"", ""89786489"", ""162506176"", ""16056686"", ""545658274"", ""29160776"", ""38936934"", ""14597094"", ""13310652"", ""37696331"", ""600535112"", ""17740069"", ""275331952"", ""243759906"", ""27730063"", ""1010731723"", ""180600112"", ""2371415304"", ""2164830257"", ""193122450"", ""16616583"", ""124202189"", ""843909307"", ""23531111"", ""498757115"", ""80075840"", ""2396848697"", ""31166117"", ""43533780"", ""2921091842"", ""438042918"", ""262852497"", ""14989726"", ""372875229"", ""91126711"", ""538765846"", ""2931865497"", ""15275682"", ""42986685"", ""372426477"", ""637103"", ""2617709575"", ""22836738"", ""5712532"", ""717709857"", ""2453850531"", ""12361462"", ""16114976"", ""531617111"", ""514489550"", ""2365959960"", ""33428158"", ""377374779"", ""54882415"", ""2359237515"", ""240478229"", ""14259005"", ""2181937441"", ""714434936"", ""181640678"", ""32825649"", ""2315583427"", ""90234882"", ""16767085"", ""14955791"", ""2497805203"", ""14722486"", ""324740746"", ""12114162"", ""16166464"", ""2213473914"", ""45679693"", ""7310842"", ""1384522687"", ""79673919"", ""319750177"", ""65489216"", ""16572453"", ""14220991"", ""27523643"", ""15664532"", ""37207900"", ""20891831"", ""27471564"", ""117110737"", ""39904809"", ""2178847422"", ""196893444"", ""19921746"", ""23629150"", ""34660897"", ""14360516"", ""116204150"", ""2956554429"", ""426455153"", ""2380804931"", ""17102191"", ""45518891"", ""633314033"", ""2720664950"", ""710477786"", ""243031077"", ""64739098"", ""57854585"", ""21045173"", ""873663181"", ""340029023"", ""217372027"", ""18555262"", ""28896087"", ""1274388504"", ""47962856"", ""56477991"", ""404491043"", ""1534113012"", ""1932816230"", ""9507342"", ""14581173"", ""375605832"", ""18244129"", ""40653508"", ""389548615"", ""15389102"", ""212702165"", ""40404100"", ""2891842919"", ""14314544"", ""375952144"", ""89636505"", ""2355402423"", ""32952592"", ""37957755"", ""212820561"", ""221143416"", ""296545369"", ""15004241""]",17,16,33
15922161,7,125.0,-0.5231565492493766,19348699.0,3,0.7142857142857143,"[""charliehebdo-all-rnr-threads"", ""germanwings-crash-all-rnr-threads"", ""sydneysiege-all-rnr-threads"", ""ferguson-all-rnr-threads""]","[""14173315"", ""15754281"", ""7744592""]",5,2,7
1109685884,7,134.71428571428572,-0.6164064747946603,6702093.0,6,0.42857142857142855,"[""charliehebdo-all-rnr-threads"", ""ottawashooting-all-rnr-threads""]","[""14173315"", ""3108351"", ""15754281"", ""742143"", ""14677919"", ""5402612""]",3,4,7
166288969,2,127.0,-0.10833624005317688,12615082.0,2,0.5,"[""charliehebdo-all-rnr-threads"", ""ferguson-all-rnr-threads""]","[""43261344"", ""210556794""]",1,1,2
351860076,3,85.66666666666667,-0.11990056435267131,6998953.0,2,0.3333333333333333,"[""charliehebdo-all-rnr-threads"", ""germanwings-crash-all-rnr-threads""]","[""227837742"", ""210556794""]",1,2,3
6664162,2,86.0,-0.4086712896823883,6747128.0,2,0.5,"[""charliehebdo-all-rnr-threads"", ""ottawashooting-all-rnr-threads""]","[""257291338"", ""210556794""]",1,1,2
1109386315,3,103.0,-0.2580050627390544,2125312.0,2,1.0,"[""charliehebdo-all-rnr-threads"", ""sydneysiege-all-rnr-threads""]","[""210556794"", ""2897135260""]",3,0,3
39570346,4,113.75,-0.4473033547401428,12880421.0,3,0.25,"[""charliehebdo-all-rnr-threads"", ""ferguson-all-rnr-threads""]","[""85913912"", ""157009365"", ""210556794""]",1,3,4
9507342,19,75.57894736842105,-0.2124472699667278,12839358.0,35,0.5263157894736842,"[""charliehebdo-all-rnr-threads"", ""ottawashooting-all-rnr-threads"", ""ferguson-all-rnr-threads"", ""sydneysiege-all-rnr-threads""]","[""1408458926"", ""12474732"", ""67481643"", ""96104822"", ""22123727"", ""51241574"", ""231484040"", ""190280139"", ""17268383"", ""493583449"", ""1575138829"", ""52557443"", ""66235118"", ""376378945"", ""972651"", ""14840417"", ""33092289"", ""546621108"", ""331321229"", ""267324615"", ""390576798"", ""59106330"", ""20267695"", ""22153760"", ""18498308"", ""97781259"", ""14185058"", ""28833436"", ""9507342"", ""19491130"", ""21649184"", ""72862435"", ""17428614"", ""508110571"", ""2373833395""]",10,9,19
8475532,7,121.14285714285714,-0.3019223553793771,12771890.0,6,0.2857142857142857,"[""charliehebdo-all-rnr-threads"", ""sydneysiege-all-rnr-threads"", ""ferguson-all-rnr-threads""]","[""558251172"", ""2789038870"", ""16650570"", ""436351349"", ""16469809"", ""8475532""]",2,5,7
436351349,5,104.8,0.39015176296234133,6820591.0,5,0.4,"[""charliehebdo-all-rnr-threads"", ""ottawashooting-all-rnr-threads""]","[""19000033"", ""564807258"", ""5858532"", ""382027901"", ""8475532""]",2,3,5
127496158,2,51.5,0.35805803537368774,12602370.0,2,1.0,"[""charliehebdo-all-rnr-threads"", ""ferguson-all-rnr-threads""]","[""16973333"", ""268476335""]",2,0,2
618811816,5,39.4,-0.4016639947891235,6479518.0,2,0.6,"[""charliehebdo-all-rnr-threads"", ""germanwings-crash-all-rnr-threads""]","[""759251"", ""16973333""]",3,2,5
2176555676,2,32.5,0.10500079393386841,2116292.0,2,1.0,"[""charliehebdo-all-rnr-threads"", ""sydneysiege-all-rnr-threads""]","[""3108351"", ""64643056""]",2,0,2
1436131861,4,120.0,-0.04374600946903229,12758106.0,4,0.25,"[""charliehebdo-all-rnr-threads"", ""sydneysiege-all-rnr-threads"", ""ferguson-all-rnr-threads""]","[""3108351"", ""386815916"", ""64643056"", ""11265832""]",1,3,4
21242484,3,74.66666666666667,-0.012629171212514242,12612936.0,3,0.3333333333333333,"[""charliehebdo-all-rnr-threads"", ""ferguson-all-rnr-threads""]","[""26898420"", ""3108351"", ""14090948""]",1,2,3
262293426,2,76.5,-0.49280858039855957,6731105.0,2,1.0,"[""charliehebdo-all-rnr-threads"", ""ottawashooting-all-rnr-threads""]","[""6017542"", ""51241574""]",2,0,2
176853382,8,135.0,-0.33980565518140793,12615895.0,2,1.0,"[""charliehebdo-all-rnr-threads"", ""ferguson-all-rnr-threads""]","[""1630896181"", ""6017542""]",8,0,8
2190056023,4,124.25,-0.22155679762363434,2104328.0,34,0.25,"[""charliehebdo-all-rnr-threads"", ""sydneysiege-all-rnr-threads""]","[""159110168"", ""2961649574"", ""809194890"", ""220731517"", ""1597935852"", ""264103932"", ""259166697"", ""1963662985"", ""69032114"", ""612879485"", ""33621003"", ""19792878"", ""132464028"", ""431028069"", ""2368270256"", ""23764053"", ""1521716119"", ""538765846"", ""2875761863"", ""2865376419"", ""2920099022"", ""2224194014"", ""25590752"", ""2781956756"", ""460502356"", ""1012771866"", ""104079268"", ""48061264"", ""577180219"", ""132503444"", ""2883191686"", ""1270306663"", ""102736645"", ""1329638036""]",1,3,4
69032114,10,105.1,-0.08934968709945679,2134066.0,8,0.9,"[""charliehebdo-all-rnr-threads"", ""sydneysiege-all-rnr-threads""]","[""2190056023"", ""1652541"", ""15438913"", ""742143"", ""1960878613"", ""1367531"", ""16834659"", ""428333""]",9,1,10
2779009591,14,86.57142857142857,-0.2517139273030417,6723844.0,22,0.7857142857142857,"[""charliehebdo-all-rnr-threads"", ""ottawashooting-all-rnr-threads"", ""sydneysiege-all-rnr-threads""]","[""2175192882"", ""67030010"", ""14905162"", ""1048137212"", ""848040139"", ""255288363"", ""89947367"", ""219752036"", ""105967043"", ""382300412"", ""52247328"", ""428333"", ""1617594984"", ""2779009591"", ""56824850"", ""50524794"", ""46017944"", ""2836793474"", ""25201206"", ""2459596554"", ""19765796"", ""369318439""]",11,3,14
2459596554,2,48.5,-0.036948323249816895,2081502.0,2,0.5,"[""charliehebdo-all-rnr-threads"", ""sydneysiege-all-rnr-threads""]","[""1626294277"", ""2779009591""]",1,1,2
2295881880,4,76.0,-0.25864817202091217,6727088.0,2,1.0,"[""charliehebdo-all-rnr-threads"", ""germanwings-crash-all-rnr-threads""]","[""2546562188"", ""288283415""]",4,0,4
16177399,3,73.0,-0.2709578474362691,12715821.0,3,0.3333333333333333,"[""charliehebdo-all-rnr-threads"", ""ottawashooting-all-rnr-threads"", ""ferguson-all-rnr-threads""]","[""2546562188"", ""282695161"", ""117155939""]",1,2,3
243318995,3,114.66666666666667,-0.4517210324605306,5608240.0,24,0.6666666666666666,"[""charliehebdo-all-rnr-threads"", ""putinmissing-all-rnr-threads""]","[""229022520"", ""2367754554"", ""432248565"", ""81134232"", ""2972998455"", ""47694125"", ""93410612"", ""2731107032"", ""775378315"", ""2406844921"", ""138681055"", ""567575673"", ""1946971338"", ""47594096"", ""909990571"", ""375178685"", ""2717034139"", ""2875761863"", ""117006605"", ""2939483921"", ""2268785065"", ""1309256510"", ""821700726"", ""2455300670""]",2,1,3
2750309806,4,118.75,-0.4372609853744507,6795837.0,3,0.5,"[""charliehebdo-all-rnr-threads"", ""ottawashooting-all-rnr-threads""]","[""742143"", ""95148130"", ""428333""]",2,2,4
19806962,4,108.0,-0.37047040462493896,2187329.0,14,0.5,"[""charliehebdo-all-rnr-threads"", ""sydneysiege-all-rnr-threads""]","[""17674088"", ""100679447"", ""35806119"", ""40306643"", ""2803983622"", ""19806962"", ""294543106"", ""28785486"", ""950435708"", ""349449860"", ""512492168"", ""2238599521"", ""345680202"", ""5402612""]",2,2,4
22529583,5,113.6,-0.3896122217178345,13205505.0,5,0.4,"[""charliehebdo-all-rnr-threads"", ""germanwings-crash-all-rnr-threads"", ""ottawashooting-all-rnr-threads"", ""sydneysiege-all-rnr-threads""]","[""1652541"", ""4970411"", ""380648579"", ""64643056"", ""428333""]",2,3,5
377097322,3,102.0,0.12108854452768962,13163645.0,3,0.3333333333333333,"[""charliehebdo-all-rnr-threads"", ""ferguson-all-rnr-threads""]","[""380648579"", ""27172787"", ""14090948""]",1,2,3
418243137,3,108.33333333333333,-0.17446784178415933,6832162.0,3,0.6666666666666666,"[""charliehebdo-all-rnr-threads"", ""ottawashooting-all-rnr-threads""]","[""380648579"", ""868112707"", ""5402612""]",2,1,3
85761585,5,48.2,0.2567432403564453,2168953.0,3,1.0,"[""charliehebdo-all-rnr-threads"", ""sydneysiege-all-rnr-threads""]","[""14138785"", ""868112707"", ""64643056""]",5,0,5
2383970420,7,115.85714285714286,-0.20345403466905868,12675582.0,2,0.14285714285714285,"[""charliehebdo-all-rnr-threads"", ""ferguson-all-rnr-threads""]","[""16973333"", ""770759270""]",1,6,7
758132576,3,72.33333333333333,0.5289471944173177,2173142.0,2,1.0,"[""charliehebdo-all-rnr-threads"", ""sydneysiege-all-rnr-threads""]","[""14173315"", ""1367531""]",3,0,3
354917016,12,122.25,-0.41354506214459735,13206900.0,12,0.5833333333333334,"[""charliehebdo-all-rnr-threads"", ""germanwings-crash-all-rnr-threads"", ""ottawashooting-all-rnr-threads"", ""sydneysiege-all-rnr-threads""]","[""14173315"", ""25049056"", ""14293310"", ""1652541"", ""51241574"", ""15108702"", ""7587032"", ""2097571"", ""6017542"", ""292777349"", ""64643056"", ""87818409""]",7,5,12
311028372,3,127.33333333333333,-0.4247300823529561,2173706.0,2,0.3333333333333333,"[""charliehebdo-all-rnr-threads"", ""sydneysiege-all-rnr-threads""]","[""4970411"", ""742143""]",1,2,3
1626294277,3,126.33333333333333,-0.6311447421709696,2140529.0,35,0.3333333333333333,"[""charliehebdo-all-rnr-threads"", ""sydneysiege-all-rnr-threads""]","[""1305583596"", ""106371668"", ""949794397"", ""1409482189"", ""67083024"", ""454200881"", ""133615938"", ""1288236433"", ""1926902684"", ""326085742"", ""48354257"", ""113693399"", ""169660103"", ""710278115"", ""1901945432"", ""83182871"", ""1655697204"", ""78898625"", ""403714562"", ""1117363285"", ""1917920580"", ""41284441"", ""90035997"", ""38133247"", ""364930955"", ""2607523644"", ""53046002"", ""360711219"", ""15725673"", ""824915659"", ""2459596554"", ""261581517"", ""418854161"", ""2906297560"", ""1127885846""]",1,2,3
21866939,6,120.33333333333333,-0.47423214713732403,8726072.0,47,0.6666666666666666,"[""charliehebdo-all-rnr-threads"", ""germanwings-crash-all-rnr-threads"", ""sydneysiege-all-rnr-threads""]","[""2692257313"", ""1685052726"", ""2792377168"", ""2843667729"", ""164599226"", ""2260150651"", ""279512802"", ""183372304"", ""155573237"", ""281597390"", ""104462388"", ""556709253"", ""242516957"", ""188415927"", ""2668571772"", ""261297837"", ""876113958"", ""271606307"", ""113028815"", ""295510001"", ""32257623"", ""35093623"", ""18975311"", ""1549066418"", ""2951345235"", ""196817482"", ""291808050"", ""295970604"", ""1061358956"", ""2881721902"", ""2754994200"", ""546924455"", ""625610952"", ""75146395"", ""1572595045"", ""426740892"", ""14869692"", ""171287153"", ""286373627"", ""331265038"", ""519738120"", ""342697424"", ""12528592"", ""297369350"", ""2738839271"", ""2474237058"", ""2740357726""]",4,2,6
2881721902,3,86.33333333333333,0.0227131446202596,2163296.0,3,0.3333333333333333,"[""charliehebdo-all-rnr-threads"", ""sydneysiege-all-rnr-threads""]","[""21866939"", ""14224719"", ""374712154""]",1,2,3
42178519,2,136.0,-0.4796904921531677,12650027.0,2,0.5,"[""charliehebdo-all-rnr-threads"", ""ferguson-all-rnr-threads""]","[""26898420"", ""6017542""]",1,1,2
176956930,2,122.5,-0.2990315854549408,12610379.0,2,1.0,"[""charliehebdo-all-rnr-threads"", ""ferguson-all-rnr-threads""]","[""14173315"", ""256363817""]",2,0,2
58341062,31,131.22580645161287,-0.6153579392740803,8567223.0,11,0.3225806451612903,"[""charliehebdo-all-rnr-threads"", ""germanwings-crash-all-rnr-threads"", ""sydneysiege-all-rnr-threads""]","[""14173315"", ""1652541"", ""87165980"", ""15108702"", ""1310201424"", ""807095"", ""384438102"", ""447410369"", ""742143"", ""142614009"", ""428333""]",10,21,31
2768501,26,123.76923076923077,-0.2835135368200449,8596624.0,285,0.5769230769230769,"[""charliehebdo-all-rnr-threads"", ""germanwings-crash-all-rnr-threads"", ""sydneysiege-all-rnr-threads""]","[""888912668"", ""2467903345"", ""190204183"", ""18918159"", ""106074367"", ""25478590"", ""27863051"", ""64182241"", ""2179189334"", ""25869176"", ""593629699"", ""23189508"", ""175282160"", ""253457930"", ""77977377"", ""1470728791"", ""221658533"", ""228857007"", ""423994870"", ""103164985"", ""27594107"", ""33793985"", ""351508855"", ""2791848577"", ""61492858"", ""2891096840"", ""1644866557"", ""1356407618"", ""782625342"", ""79918106"", ""222663865"", ""608074557"", ""158775651"", ""295510001"", ""100858563"", ""261093402"", ""893485608"", ""14886493"", ""56666374"", ""89840580"", ""1342067257"", ""1542767918"", ""27509343"", ""2566535282"", ""72547133"", ""1241264293"", ""26192233"", ""1059686779"", ""173815761"", ""462920644"", ""24675017"", ""416525671"", ""1420213766"", ""437162481"", ""330341835"", ""1081644907"", ""2177982396"", ""218434544"", ""2436560941"", ""58167203"", ""2890665768"", ""1725724380"", ""1317741559"", ""237617005"", ""16574787"", ""22907290"", ""238403215"", ""2373833395"", ""87103238"", ""147128397"", ""227285231"", ""113760003"", ""2728857555"", ""21060568"", ""302966027"", ""146289366"", ""872959243"", ""266236372"", ""2656378525"", ""1529609406"", ""137024255"", ""18328908"", ""232367421"", ""2449644567"", ""19763467"", ""296988845"", ""23712477"", ""2916073326"", ""2222873396"", ""6248922"", ""1893224126"", ""226748027"", ""105647388"", ""31006289"", ""5392032"", ""2459278543"", ""29510747"", ""2473675087"", ""869527898"", ""596363424"", ""26193041"", ""2315166895"", ""2885005042"", ""1198649053"", ""2253514663"", ""37738151"", ""1874126526"", ""2888321602"", ""15364652"", ""2450800536"", ""2898211110"", ""2731349107"", ""453117064"", ""20661658"", ""34079450"", ""19898890"", ""43541586"", ""21163415"", ""304428489"", ""490303343"", ""16127005"", ""64302965"", ""521302153"", ""63103751"", ""86506709"", ""2927858006"", ""2452110847"", ""1886531838"", ""2683599853"", ""954846247"", ""22899644"", ""891765697"", ""2730807420"", ""259553313"", ""2467216346"", ""1672452854"", ""22532070"", ""1007335268"", ""2886586060"", ""508110571"", ""2326870038"", ""49273182"", ""779697919"", ""240213840"", ""364132055"", ""2799588421"", ""47550130"", ""2939380504"", ""21511119"", ""23940245"", ""942773468"", ""2317241800"", ""1616213659"", ""1366465248"", ""17832938"", ""2897439499"", ""18896791"", ""1047008090"", ""2770401350"", ""1405807596"", ""394608257"", ""2675659412"", ""407350333"", ""2726339299"", ""1615792554"", ""114115853"", ""73121063"", ""2238231518"", ""16305881"", ""16236574"", ""17227586"", ""519458242"", ""2375530778"", ""2989139874"", ""395766971"", ""475201473"", ""48643826"", ""2890735243"", ""2895818529"", ""174968086"", ""867861240"", ""34340128"", ""5417762"", ""2892717469"", ""2222007591"", ""20966232"", ""109736956"", ""17668544"", ""2597508756"", ""1676855215"", ""32358289"", ""84392359"", ""119660122"", ""296256370"", ""27413161"", ""867201332"", ""402981323"", ""118151368"", ""2604057793"", ""1323276181"", ""1926654895"", ""15964823"", ""480445875"", ""246289854"", ""110314533"", ""18864531"", ""73452506"", ""309029339"", ""1955042766"", ""24484977"", ""2691332454"", ""498387863"", ""2236848466"", ""785390214"", ""251684331"", ""213479625"", ""17418943"", ""1144660910"", ""321402315"", ""83529469"", ""2728348611"", ""420176985"", ""2900356312"", ""307073549"", ""2690688206"", ""1448957436"", ""91471326"", ""194758773"", ""832990914"", ""275942257"", ""2857138922"", ""395116947"", ""27443402"", ""52027904"", ""2935468638"", ""30390762"", ""826852273"", ""56024833"", ""150947037"", ""1115778445"", ""2234329771"", ""628363513"", ""99986032"", ""23016046"", ""971761"", ""2363582713"", ""2885348567"", ""934530666"", ""1081477633"", ""122946633"", ""12361862"", ""155842433"", ""826662276"", ""284853152"", ""333353386"", ""267968904"", ""1304207616"", ""38814614"", ""47331289"", ""77739297"", ""504866029"", ""1227190772"", ""752643217"", ""2921307308"", ""2891738882"", ""265602022"", ""14157052"", ""1087978056"", ""454452139"", ""23875241"", ""2257457951"", ""20228905"", ""2833701362"", ""14815712"", ""183211791"", ""529555835"", ""289876697"", ""1964673422"", ""14314544"", ""864927037"", ""256452027"", ""2931585042"", ""68583725"", ""17286340"", ""462665315""]",15,11,26
19763467,12,112.41666666666667,-0.252837931116422,13160736.0,10,0.25,"[""charliehebdo-all-rnr-threads"", ""sydneysiege-all-rnr-threads"", ""ferguson-all-rnr-threads""]","[""271413771"", ""14098166"", ""16807528"", ""24165761"", ""7401202"", ""14090948"", ""35466620"", ""18725815"", ""15250661"", ""2768501""]",3,9,12
596363424,2,49.5,-0.11159175634384155,2159381.0,2,0.5,"[""charliehebdo-all-rnr-threads"", ""sydneysiege-all-rnr-threads""]","[""156464691"", ""2768501""]",1,1,2
205843793,3,53.0,-0.14886879920959473,2168276.0,3,0.6666666666666666,"[""charliehebdo-all-rnr-threads"", ""sydneysiege-all-rnr-threads""]","[""612473"", ""143415291"", ""5402612""]",2,1,3
24400524,6,114.83333333333333,-0.39351749420166016,2192086.0,4,0.8333333333333334,"[""charliehebdo-all-rnr-threads"", ""sydneysiege-all-rnr-threads""]","[""1652541"", ""2799960092"", ""28785486"", ""25210650""]",5,1,6
23470695,4,135.25,-0.15431982278823853,12708796.0,2,0.75,"[""charliehebdo-all-rnr-threads"", ""sydneysiege-all-rnr-threads"", ""ferguson-all-rnr-threads""]","[""103065157"", ""28785486""]",3,1,4
1724090454,30,102.96666666666667,-0.1551321864128113,2195081.0,4,0.4,"[""charliehebdo-all-rnr-threads"", ""sydneysiege-all-rnr-threads""]","[""153029181"", ""7587032"", ""742143"", ""374712154""]",12,18,30
609355875,2,98.0,0.60258948802948,2166728.0,1,1.0,"[""charliehebdo-all-rnr-threads"", ""sydneysiege-all-rnr-threads""]","[""64643056""]",2,0,2
49259564,2,131.5,-0.49896907806396484,2175361.0,2,1.0,"[""charliehebdo-all-rnr-threads"", ""sydneysiege-all-rnr-threads""]","[""6017542"", ""5402612""]",2,0,2
1254746366,3,123.0,0.05282076199849447,6786158.0,3,0.3333333333333333,"[""charliehebdo-all-rnr-threads"", ""ottawashooting-all-rnr-threads""]","[""6017542"", ""257291338"", ""47469552""]",1,2,3
84464003,2,33.5,-0.7076058387756348,6533517.0,2,1.0,"[""charliehebdo-all-rnr-threads"", ""germanwings-crash-all-rnr-threads""]","[""22993014"", ""87416722""]",2,0,2
807095,31,113.0,-0.13530446829334383,13422933.0,439,0.2903225806451613,"[""charliehebdo-all-rnr-threads"", ""germanwings-crash-all-rnr-threads"", ""ottawashooting-all-rnr-threads"", ""sydneysiege-all-rnr-threads""]","[""115787759"", ""2342356352"", ""23462565"", ""31370199"", ""18565227"", ""15474430"", ""2962699317"", ""2605768532"", ""71422357"", ""20479735"", ""26302594"", ""25330784"", ""2919219079"", ""67706546"", ""289870321"", ""1546131576"", ""2499104382"", ""1148474738"", ""297739133"", ""1407027576"", ""290914079"", ""88617541"", ""713149026"", ""42620459"", ""127836912"", ""440405421"", ""2766089701"", ""2919565796"", ""219876093"", ""245693508"", ""16574787"", ""152638467"", ""275288575"", ""239807874"", ""2386164428"", ""22290941"", ""191477637"", ""2478614430"", ""38421062"", ""2882783909"", ""2579863970"", ""25479077"", ""17807935"", ""2968810462"", ""61777890"", ""1078347888"", ""2560148358"", ""601954050"", ""173720699"", ""929662333"", ""1345535262"", ""379137307"", ""2167506691"", ""503129589"", ""460705232"", ""900497136"", ""1637236532"", ""1092729763"", ""8423622"", ""1615599416"", ""146940466"", ""108318698"", ""2866192559"", ""76392453"", ""625796024"", ""990133134"", ""122623128"", ""33097323"", ""19433066"", ""2359638289"", ""255062000"", ""433158220"", ""168547709"", ""277395433"", ""812989836"", ""2791620555"", ""2256324224"", ""2738912233"", ""999907196"", ""842338092"", ""19983101"", ""229160051"", ""51003849"", ""2780963558"", ""144259665"", ""342196306"", ""2802093104"", ""55794715"", ""317041794"", ""2289462162"", ""582489442"", ""45342174"", ""16335073"", ""1373532835"", ""18810426"", ""2497286180"", ""1539260924"", ""2775130295"", ""225503094"", ""1726614060"", ""1703880212"", ""18026638"", ""250221110"", ""1702788854"", ""1927751556"", ""2558164022"", ""521966673"", ""2762288549"", ""2354739402"", ""392340964"", ""1047778988"", ""287163004"", ""378103762"", ""61265736"", ""214282086"", ""632710114"", ""1031944087"", ""539721796"", ""87779569"", ""2935047519"", ""52826577"", ""49194495"", ""1686122971"", ""95530817"", ""1942274774"", ""183051843"", ""1542767918"", ""28770078"", ""1854612889"", ""32670983"", ""1604220710"", ""25799938"", ""858579492"", ""307589045"", ""999733868"", ""160450335"", ""391702208"", ""145923925"", ""155202983"", ""393650551"", ""2952697789"", ""1408243501"", ""1451377339"", ""842768190"", ""135820654"", ""2679627566"", ""17664922"", ""2745533462"", ""145699407"", ""123628014"", ""1409313404"", ""47396544"", ""207441433"", ""305276400"", ""26089495"", ""166681139"", ""167558182"", ""1512120685"", ""377929519"", ""153758109"", ""3067211786"", ""270588444"", ""7273952"", ""1062791150"", ""2965151476"", ""386169472"", ""162764688"", ""313295575"", ""2487330354"", ""577382223"", ""257325272"", ""240615942"", ""16297111"", ""2936694741"", ""2923133071"", ""218104926"", ""1202710489"", ""20332831"", ""409679126"", ""869904883"", ""41747909"", ""489497300"", ""854017730"", ""2474494520"", ""991234315"", ""79332759"", ""1517775560"", ""190384295"", ""2912429401"", ""1876669039"", ""276169538"", ""534002956"", ""220828364"", ""1605751488"", ""623593623"", ""340815286"", ""120668752"", ""305035263"", ""14888597"", ""353147411"", ""231190657"", ""182382604"", ""62859545"", ""75382079"", ""457322713"", ""103447291"", ""2521757999"", ""67610309"", ""2937525600"", ""23699702"", ""242230231"", ""43533997"", ""48382118"", ""141956199"", ""1128357733"", ""2463405720"", ""904482176"", ""2865244214"", ""169667063"", ""519804064"", ""2811835646"", ""2689665578"", ""345592846"", ""1440556951"", ""159631230"", ""54119321"", ""6018452"", ""34229099"", ""2961649574"", ""107031620"", ""1498081164"", ""20686232"", ""81260589"", ""1952614448"", ""1719561684"", ""2157904504"", ""2360464780"", ""71638316"", ""360183353"", ""244806580"", ""57023952"", ""271927117"", ""327912012"", ""2804855798"", ""64657863"", ""997810836"", ""200641413"", ""2857565159"", ""2495286284"", ""2855109985"", ""2969105847"", ""436029388"", ""15235266"", ""182045273"", ""27673910"", ""497196282"", ""2540996557"", ""15366312"", ""372315596"", ""19922710"", ""563874311"", ""18983688"", ""53892543"", ""805230774"", ""1688182286"", ""2849867501"", ""2875761863"", ""59835490"", ""328682085"", ""961721755"", ""27807394"", ""713398592"", ""17851197"", ""307607261"", ""58341062"", ""20526434"", ""172938122"", ""2159049399"", ""243847340"", ""50621314"", ""178070470"", ""220731517"", ""517656712"", ""570559903"", ""1031773916"", ""944820355"", ""2902476579"", ""185413809"", ""22763983"", ""2854781367"", ""1147895708"", ""2292797061"", ""2181425453"", ""707188250"", ""396831702"", ""493611144"", ""139493329"", ""274850235"", ""39853501"", ""43070765"", ""29702253"", ""521288109"", ""1016228486"", ""1320488653"", ""2900038735"", ""68956490"", ""270132503"", ""1336161774"", ""301766459"", ""969021517"", ""1082264491"", ""102313626"", ""361192609"", ""2370908751"", ""40331982"", ""2429562680"", ""85831602"", ""802036752"", ""2569763742"", ""449742415"", ""142707054"", ""61061322"", ""2404413558"", ""135500816"", ""20529676"", ""1455798942"", ""14792167"", ""75057635"", ""18712930"", ""24282449"", ""74488170"", ""2371302078"", ""2951968857"", ""1687360158"", ""31694460"", ""125344265"", ""596828095"", ""300794936"", ""96688612"", ""461635875"", ""2903436051"", ""125359666"", ""1656511472"", ""19934667"", ""16804088"", ""19580070"", ""570879187"", ""23609344"", ""2723735572"", ""308054951"", ""56064518"", ""2963680715"", ""415158200"", ""1355406758"", ""81695104"", ""1933990206"", ""63797517"", ""18089481"", ""114962484"", ""1124144461"", ""23163280"", ""2945865278"", ""66036052"", ""416044899"", ""2766265979"", ""2720540556"", ""1085149063"", ""2283483315"", ""48939583"", ""2257552586"", ""283557796"", ""1508982679"", ""292629799"", ""2267979900"", ""19115886"", ""114871891"", ""1234987687"", ""1188188916"", ""100366853"", ""931027944"", ""512582860"", ""374974105"", ""262264945"", ""949075567"", ""1654442893"", ""2668047543"", ""255978615"", ""546886420"", ""70275677"", ""34628686"", ""221550248"", ""488522254"", ""427402721"", ""81908419"", ""1549792512"", ""124013613"", ""1537145077"", ""324534950"", ""28101457"", ""2828447583"", ""22336731"", ""21043723"", ""225071374"", ""108579430"", ""2287612675"", ""1689064069"", ""25500715"", ""1890541950"", ""1327978776"", ""1943164956"", ""433488471"", ""13035112"", ""28115444"", ""1173408768"", ""1589387894"", ""607159517"", ""259555635"", ""19294654"", ""142408161"", ""347142333"", ""2933142656"", ""311244285"", ""857775810"", ""2853256766"", ""2338894161"", ""202574223"", ""199636080"", ""2336005385"", ""452083171"", ""364789232"", ""847315105"", ""110065397"", ""276515831"", ""2725911162"", ""80586683"", ""2902969245"", ""2936836060"", ""37284099"", ""1513780226""]",9,22,31
213479625,3,84.66666666666667,-0.22617721557617188,2368325.0,2,1.0,"[""charliehebdo-all-rnr-threads"", ""sydneysiege-all-rnr-threads""]","[""2768501"", ""1994321""]",3,0,3
76994576,4,89.0,-0.37008921802043915,8797464.0,3,1.0,"[""charliehebdo-all-rnr-threads"", ""germanwings-crash-all-rnr-threads"", ""sydneysiege-all-rnr-threads""]","[""28785486"", ""30122242"", ""5402612""]",4,0,4
2785717076,2,103.5,-0.4202212989330292,2170781.0,2,0.5,"[""charliehebdo-all-rnr-threads"", ""sydneysiege-all-rnr-threads""]","[""238575113"", ""5402612""]",1,1,2
442653867,4,88.75,-0.4812048673629761,2142757.0,4,0.5,"[""charliehebdo-all-rnr-threads"", ""sydneysiege-all-rnr-threads""]","[""2911567161"", ""2925317661"", ""2485349550"", ""2832805923""]",2,2,4
408150347,3,67.66666666666667,-0.13290194670359293,12700527.0,3,0.6666666666666666,"[""charliehebdo-all-rnr-threads"", ""ferguson-all-rnr-threads""]","[""14173315"", ""236488883"", ""2680112214""]",2,1,3
14511951,12,94.33333333333333,-0.3151656836271286,19272744.0,101,0.4166666666666667,"[""charliehebdo-all-rnr-threads"", ""germanwings-crash-all-rnr-threads"", ""ottawashooting-all-rnr-threads"", ""ferguson-all-rnr-threads""]","[""848037636"", ""89317153"", ""2323975734"", ""627271165"", ""6465642"", ""1629306200"", ""26425514"", ""259357092"", ""315133994"", ""2930966744"", ""17935077"", ""78924447"", ""295510001"", ""1942274774"", ""1271386550"", ""17571564"", ""2237583636"", ""18283338"", ""1885859976"", ""1165979425"", ""1542767918"", ""356446544"", ""950606636"", ""2888524707"", ""2766265979"", ""35149392"", ""14511951"", ""27733101"", ""2713171165"", ""64037390"", ""139106364"", ""152016501"", ""107842096"", ""2746998573"", ""517295675"", ""75064309"", ""292034728"", ""575455766"", ""498466337"", ""2378914268"", ""240279011"", ""107273605"", ""795170875"", ""33496605"", ""17027030"", ""28839148"", ""71518448"", ""2840650275"", ""197080395"", ""529422071"", ""25142109"", ""497471148"", ""1626325842"", ""195156866"", ""19769121"", ""2869304847"", ""521827299"", ""372448318"", ""2195116544"", ""917497788"", ""114845234"", ""17233536"", ""271279645"", ""2238975464"", ""29136196"", ""2862417437"", ""33625021"", ""383212923"", ""29620898"", ""68956490"", ""2902306568"", ""19982158"", ""1343657124"", ""116871871"", ""177945000"", ""2740166376"", ""16166464"", ""1025593699"", ""2920922597"", ""216320167"", ""1549284001"", ""22824100"", ""494372098"", ""33863988"", ""886957470"", ""2769965322"", ""17270046"", ""897702366"", ""1202792317"", ""570859259"", ""1739120575"", ""291998429"", ""2305363039"", ""384468868"", ""42646457"", ""21205297"", ""457481692"", ""2750347930"", ""56937357"", ""19068639"", ""224066941""]",5,7,12
17233536,2,95.5,0.11264297366142273,6805052.0,2,0.5,"[""charliehebdo-all-rnr-threads"", ""ottawashooting-all-rnr-threads""]","[""16249591"", ""14511951""]",1,1,2
42338948,7,87.71428571428571,-0.20454139368874685,12673190.0,3,0.14285714285714285,"[""charliehebdo-all-rnr-threads"", ""ferguson-all-rnr-threads""]","[""788524"", ""2097571"", ""216299334""]",1,6,7
17832938,7,116.14285714285714,-0.0222065874508449,2172293.0,5,0.8571428571428571,"[""charliehebdo-all-rnr-threads"", ""sydneysiege-all-rnr-threads""]","[""51241574"", ""23055689"", ""147754032"", ""22993014"", ""2768501""]",6,1,7
1369778664,4,75.5,-0.10908633470535278,6800489.0,4,0.5,"[""charliehebdo-all-rnr-threads"", ""ottawashooting-all-rnr-threads""]","[""15438913"", ""1367531"", ""375721095"", ""17537467""]",2,2,4
28863975,2,131.5,-0.37199386954307556,12887509.0,2,0.5,"[""charliehebdo-all-rnr-threads"", ""ferguson-all-rnr-threads""]","[""16936858"", ""1367531""]",1,1,2
22585606,7,94.42857142857143,-0.2539357372692653,2174603.0,3,0.7142857142857143,"[""charliehebdo-all-rnr-threads"", ""sydneysiege-all-rnr-threads""]","[""15907183"", ""1367531"", ""5402612""]",5,2,7
2444514337,2,57.0,-0.2316405177116394,12855697.0,2,0.5,"[""charliehebdo-all-rnr-threads"", ""ferguson-all-rnr-threads""]","[""1367531"", ""195271137""]",1,1,2
393650551,3,104.0,-0.5520541866620382,2138976.0,3,0.3333333333333333,"[""charliehebdo-all-rnr-threads"", ""sydneysiege-all-rnr-threads""]","[""380648579"", ""2097571"", ""807095""]",1,2,3
28372386,7,120.28571428571429,-0.3120315841266087,12844970.0,3,0.2857142857142857,"[""charliehebdo-all-rnr-threads"", ""sydneysiege-all-rnr-threads"", ""ferguson-all-rnr-threads""]","[""380648579"", ""16675569"", ""16650570""]",2,5,7
1518883244,10,126.4,-0.4787214994430542,2185170.0,7,0.7,"[""charliehebdo-all-rnr-threads"", ""sydneysiege-all-rnr-threads""]","[""14293310"", ""2097571"", ""22138134"", ""612473"", ""742143"", ""87818409"", ""5402612""]",7,3,10
16574787,10,128.8,-0.22894762754440307,2572888.0,8,0.5,"[""charliehebdo-all-rnr-threads"", ""sydneysiege-all-rnr-threads""]","[""16973333"", ""9609632"", ""51241574"", ""2097571"", ""807095"", ""1375289149"", ""447410369"", ""2768501""]",5,5,10
2847847026,3,96.66666666666667,-0.22949651877085367,2198367.0,2,1.0,"[""charliehebdo-all-rnr-threads"", ""sydneysiege-all-rnr-threads""]","[""49460512"", ""5402612""]",3,0,3
1031773916,9,69.55555555555556,-0.45163143343395656,6787263.0,3,0.1111111111111111,"[""charliehebdo-all-rnr-threads"", ""germanwings-crash-all-rnr-threads""]","[""14173315"", ""64643056"", ""807095""]",1,8,9
826046582,4,100.5,-0.48161469399929047,2060006.0,3,0.5,"[""charliehebdo-all-rnr-threads"", ""sydneysiege-all-rnr-threads""]","[""16725276"", ""45715838"", ""5402612""]",2,2,4
15189196,8,90.625,-0.5176401883363724,2212392.0,6,0.5,"[""charliehebdo-all-rnr-threads"", ""sydneysiege-all-rnr-threads""]","[""154485832"", ""419520517"", ""217758017"", ""136004952"", ""20891396"", ""5402612""]",4,4,8
135998621,2,127.0,0.30015069246292114,6799019.0,2,0.5,"[""charliehebdo-all-rnr-threads"", ""ottawashooting-all-rnr-threads""]","[""98487877"", ""136004952""]",1,1,2
1391753906,2,133.0,-0.11679351329803467,2175337.0,2,0.5,"[""charliehebdo-all-rnr-threads"", ""sydneysiege-all-rnr-threads""]","[""1367531"", ""153029181""]",1,1,2
213530957,7,122.85714285714286,0.029875482831682478,12959068.0,5,0.14285714285714285,"[""charliehebdo-all-rnr-threads"", ""ferguson-all-rnr-threads""]","[""14264854"", ""64643056"", ""14940354"", ""1367531"", ""1571428436""]",1,6,7
740623508,2,94.0,0.030072331428527832,2179276.0,2,1.0,"[""charliehebdo-all-rnr-threads"", ""sydneysiege-all-rnr-threads""]","[""23055689"", ""19662223""]",2,0,2
296070902,3,68.66666666666667,-0.2014645536740621,2172275.0,2,0.6666666666666666,"[""charliehebdo-all-rnr-threads"", ""sydneysiege-all-rnr-threads""]","[""742143"", ""5402612""]",2,1,3
20282201,3,52.666666666666664,-0.586360494295756,2173800.0,2,0.6666666666666666,"[""charliehebdo-all-rnr-threads"", ""sydneysiege-all-rnr-threads""]","[""7589572"", ""5402612""]",2,1,3
2248861878,4,40.25,-0.13707345724105835,6790877.0,4,0.5,"[""charliehebdo-all-rnr-threads"", ""ottawashooting-all-rnr-threads""]","[""1375289149"", ""7744592"", ""8839632"", ""5402612""]",2,2,4
26849753,2,114.0,-0.007473587989807129,2163541.0,2,0.5,"[""charliehebdo-all-rnr-threads"", ""sydneysiege-all-rnr-threads""]","[""16973333"", ""5402612""]",1,1,2
1719561684,8,76.125,-0.31063561141490936,2425923.0,6,0.25,"[""charliehebdo-all-rnr-threads"", ""sydneysiege-all-rnr-threads""]","[""16973333"", ""16591979"", ""807095"", ""292777349"", ""16012783"", ""2315411725""]",2,6,8
279788564,33,99.03030303030303,-0.25157569574587274,12707120.0,9,0.15151515151515152,"[""charliehebdo-all-rnr-threads"", ""sydneysiege-all-rnr-threads"", ""ferguson-all-rnr-threads""]","[""1877831"", ""1562935142"", ""129051309"", ""15164565"", ""15438913"", ""742143"", ""22650211"", ""409941587"", ""428333""]",5,28,33
1080276308,35,88.11428571428573,-0.4759405681065151,8561206.0,8,0.11428571428571428,"[""charliehebdo-all-rnr-threads"", ""germanwings-crash-all-rnr-threads"", ""sydneysiege-all-rnr-threads""]","[""271413771"", ""16973333"", ""1652541"", ""2097571"", ""125944392"", ""788524"", ""16343974"", ""36412963""]",4,31,35
28103908,4,112.0,0.7638522386550903,12693960.0,4,0.25,"[""charliehebdo-all-rnr-threads"", ""sydneysiege-all-rnr-threads"", ""ferguson-all-rnr-threads""]","[""1375289149"", ""281754653"", ""2097571"", ""2680112214""]",1,3,4
2231330071,6,110.5,-0.17493084073066711,2194805.0,2,0.16666666666666666,"[""charliehebdo-all-rnr-threads"", ""sydneysiege-all-rnr-threads""]","[""16675569"", ""2097571""]",1,5,6
97639418,4,44.75,-0.7080307751893997,13367300.0,4,1.0,"[""charliehebdo-all-rnr-threads"", ""germanwings-crash-all-rnr-threads"", ""ottawashooting-all-rnr-threads""]","[""15037033"", ""363879015"", ""2097571"", ""5402612""]",4,0,4
163870539,2,113.5,-0.34961259365081787,2162659.0,2,0.5,"[""charliehebdo-all-rnr-threads"", ""sydneysiege-all-rnr-threads""]","[""28695097"", ""5402612""]",1,1,2
2824442646,11,89.36363636363636,-0.08440397002480247,2178724.0,5,0.2727272727272727,"[""charliehebdo-all-rnr-threads"", ""sydneysiege-all-rnr-threads""]","[""14173315"", ""51241574"", ""2097571"", ""759251"", ""428333""]",3,8,11
112040405,2,99.5,-0.2519882321357727,12902324.0,2,0.5,"[""charliehebdo-all-rnr-threads"", ""ferguson-all-rnr-threads""]","[""14173315"", ""2611766492""]",1,1,2
1109948761,2,104.0,-0.700115293264389,6804411.0,2,1.0,"[""charliehebdo-all-rnr-threads"", ""ottawashooting-all-rnr-threads""]","[""759251"", ""5402612""]",2,0,2
76779374,4,62.0,-0.23940753936767578,2165700.0,2,1.0,"[""charliehebdo-all-rnr-threads"", ""sydneysiege-all-rnr-threads""]","[""87416722"", ""64643056""]",4,0,4
128917051,18,107.72222222222223,-0.3551916910542382,13416242.0,10,0.4444444444444444,"[""charliehebdo-all-rnr-threads"", ""germanwings-crash-all-rnr-threads"", ""ottawashooting-all-rnr-threads"", ""sydneysiege-all-rnr-threads""]","[""16973333"", ""1652541"", ""51241574"", ""2097571"", ""15438913"", ""759251"", ""742143"", ""5988062"", ""87818409"", ""428333""]",8,10,18
22873947,4,119.5,0.36187684535980225,6811000.0,3,0.25,"[""charliehebdo-all-rnr-threads"", ""ottawashooting-all-rnr-threads""]","[""759251"", ""39728435"", ""23937894""]",1,3,4
214007688,6,92.0,-0.3078085084756215,13360579.0,42,0.8333333333333334,"[""charliehebdo-all-rnr-threads"", ""germanwings-crash-all-rnr-threads"", ""ottawashooting-all-rnr-threads"", ""sydneysiege-all-rnr-threads""]","[""763010018"", ""143733560"", ""1952486390"", ""794546882"", ""607316801"", ""214007688"", ""433556779"", ""341790892"", ""79579327"", ""18244206"", ""2535590378"", ""257534459"", ""128202674"", ""52602945"", ""876410610"", ""330622588"", ""2531861484"", ""256561425"", ""323470465"", ""2213214668"", ""7587032"", ""2355819120"", ""930880214"", ""2873017493"", ""365598686"", ""123133485"", ""333649518"", ""1709681166"", ""2836793474"", ""299918397"", ""2829919614"", ""2339132688"", ""104184883"", ""93290821"", ""1541234072"", ""26686408"", ""1250251675"", ""2416434331"", ""237669408"", ""22609944"", ""1896904754"", ""1292608776""]",5,1,6
1061029789,2,132.0,-0.10030567646026611,2157256.0,2,0.5,"[""charliehebdo-all-rnr-threads"", ""sydneysiege-all-rnr-threads""]","[""3108351"", ""51241574""]",1,1,2
2462310905,4,138.75,-0.29451000690460205,6817921.0,3,0.25,"[""charliehebdo-all-rnr-threads"", ""ottawashooting-all-rnr-threads""]","[""3108351"", ""2836941830"", ""51241574""]",1,3,4
23293888,3,144.0,-0.29590054353078205,2157743.0,2,0.3333333333333333,"[""charliehebdo-all-rnr-threads"", ""sydneysiege-all-rnr-threads""]","[""18725815"", ""87416722""]",1,2,3
166943853,2,108.5,-0.7111672163009644,6387508.0,2,1.0,"[""charliehebdo-all-rnr-threads"", ""germanwings-crash-all-rnr-threads""]","[""380648579"", ""134196350""]",2,0,2
69171795,6,108.66666666666667,-0.4171512524286906,12838583.0,4,0.8333333333333334,"[""charliehebdo-all-rnr-threads"", ""sydneysiege-all-rnr-threads"", ""ferguson-all-rnr-threads""]","[""1652541"", ""51241574"", ""100136358"", ""24506246""]",5,1,6
269112578,3,95.66666666666667,-0.3784106373786926,2203643.0,2,1.0,"[""charliehebdo-all-rnr-threads"", ""sydneysiege-all-rnr-threads""]","[""20639175"", ""24506246""]",3,0,3
227444145,3,132.66666666666666,-0.12171796957651775,7658376.0,2,1.0,"[""charliehebdo-all-rnr-threads"", ""sydneysiege-all-rnr-threads"", ""ebola-essien-all-rnr-threads""]","[""1262229906"", ""64643056""]",3,0,3
192744648,3,122.0,0.04635075728098551,6808082.0,3,0.3333333333333333,"[""charliehebdo-all-rnr-threads"", ""ottawashooting-all-rnr-threads""]","[""87416722"", ""7587032"", ""268416076""]",1,2,3
126987176,3,102.33333333333333,-0.4111570318539937,2158218.0,1,1.0,"[""charliehebdo-all-rnr-threads"", ""sydneysiege-all-rnr-threads""]","[""7587032""]",3,0,3
2230031627,6,74.83333333333333,-0.2869865298271179,2161062.0,4,0.16666666666666666,"[""charliehebdo-all-rnr-threads"", ""sydneysiege-all-rnr-threads""]","[""116768508"", ""87818409"", ""36412963"", ""427748930""]",1,5,6
455724651,18,51.77777777777778,-0.3691422740618388,2189885.0,12,0.5,"[""charliehebdo-all-rnr-threads"", ""sydneysiege-all-rnr-threads""]","[""407779393"", ""154485832"", ""146765658"", ""1994321"", ""46078438"", ""7587032"", ""149913262"", ""47448886"", ""43182702"", ""270016438"", ""501768982"", ""5402612""]",9,9,18
2380356985,3,105.33333333333333,-0.365123709042867,2191432.0,2,1.0,"[""charliehebdo-all-rnr-threads"", ""sydneysiege-all-rnr-threads""]","[""20402945"", ""1994321""]",3,0,3
917497788,5,14.0,0.2457667112350464,19226465.0,5,0.2,"[""charliehebdo-all-rnr-threads"", ""germanwings-crash-all-rnr-threads"", ""ferguson-all-rnr-threads""]","[""183341278"", ""14511951"", ""3108351"", ""759251"", ""16012783""]",1,4,5
292777349,58,107.29310344827586,-0.4920763250054987,6833804.0,562,0.7241379310344828,"[""charliehebdo-all-rnr-threads"", ""ottawashooting-all-rnr-threads"", ""sydneysiege-all-rnr-threads""]","[""1661832032"", ""399692297"", ""16517048"", ""15840592"", ""20861293"", ""2240794122"", ""541777125"", ""2730333576"", ""75087004"", ""18195937"", ""1054060230"", ""23880636"", ""1668760046"", ""115550523"", ""77792754"", ""59513871"", ""463911196"", ""2878831764"", ""927597620"", ""636989614"", ""636262914"", ""216655013"", ""1721635405"", ""1104813811"", ""754108322"", ""1040962352"", ""2953666556"", ""175977604"", ""21604276"", ""365016756"", ""2363116363"", ""869226241"", ""106547728"", ""149096517"", ""54113109"", ""305752088"", ""298627624"", ""2755067452"", ""70593494"", ""629256391"", ""52400719"", ""2869962475"", ""417325218"", ""1656968611"", ""550263753"", ""94045996"", ""1660694940"", ""41459097"", ""1247566862"", ""185472553"", ""39262408"", ""579693044"", ""551234726"", ""2183810446"", ""35292444"", ""252252751"", ""198200324"", ""2805552330"", ""1666562821"", ""2814116371"", ""53322615"", ""1454738214"", ""2277924686"", ""2371379348"", ""1021257073"", ""325846016"", ""234981515"", ""34727886"", ""105098954"", ""874824648"", ""522572964"", ""436024010"", ""2286731521"", ""55674268"", ""1873444681"", ""328518851"", ""165355814"", ""479084332"", ""2373164606"", ""467451532"", ""499568043"", ""317640418"", ""100747631"", ""1912265406"", ""2432713640"", ""2923558568"", ""915995742"", ""102258935"", ""2217007286"", ""609208080"", ""434016102"", ""53325633"", ""344633710"", ""2341780486"", ""429876648"", ""250393818"", ""247104369"", ""1567655107"", ""51384128"", ""1262856372"", ""27781943"", ""192893537"", ""563178382"", ""169649363"", ""265075984"", ""200540173"", ""243817787"", ""1939752139"", ""2448419816"", ""286887545"", ""2770520699"", ""28680064"", ""143036325"", ""1164918769"", ""28025132"", ""2752811"", ""1408512746"", ""1668400686"", ""128763056"", ""1392865104"", ""1671200624"", ""607034515"", ""2821233695"", ""78744728"", ""462511443"", ""418332255"", ""175062171"", ""50594316"", ""138713188"", ""19670084"", ""257944088"", ""2253668960"", ""1063844286"", ""147177929"", ""464958277"", ""1635187568"", ""229055095"", ""1662653299"", ""1442580457"", ""1066414722"", ""38719385"", ""1117719180"", ""2334229333"", ""2861968850"", ""204124092"", ""505007129"", ""746737297"", ""84016514"", ""243836495"", ""36758140"", ""240008537"", ""615799477"", ""2576370989"", ""37595323"", ""2265865322"", ""362255426"", ""1206618644"", ""124851971"", ""2320803824"", ""1484411976"", ""40483575"", ""2397218818"", ""363112901"", ""264866478"", ""2875898855"", ""72588786"", ""330652241"", ""2493759192"", ""576580745"", ""1465997580"", ""949007618"", ""2566535282"", ""17984709"", ""35646496"", ""363867827"", ""1547659670"", ""18300792"", ""2177660940"", ""623633813"", ""117658347"", ""200556557"", ""1020333475"", ""606599760"", ""1213237104"", ""2368029176"", ""47051236"", ""297369350"", ""58913244"", ""8754802"", ""350574043"", ""22589258"", ""9138142"", ""161248822"", ""2601413087"", ""224512449"", ""519291698"", ""1300658593"", ""1925401974"", ""25995131"", ""446540358"", ""744462696"", ""74194971"", ""33699810"", ""25206663"", ""19750998"", ""3100011"", ""410307417"", ""354917016"", ""93075948"", ""2915283038"", ""806221214"", ""17213427"", ""633536872"", ""766894986"", ""42577934"", ""403393781"", ""1466242854"", ""2208403230"", ""720500850"", ""1012085413"", ""974205336"", ""31463675"", ""1648568587"", ""24000700"", ""192732860"", ""468719630"", ""2208515167"", ""114115853"", ""1007845926"", ""19788053"", ""13081872"", ""244159745"", ""2867425790"", ""59256308"", ""415245100"", ""539324725"", ""252835563"", ""1703451361"", ""2580917595"", ""118762484"", ""234391949"", ""2477028826"", ""41196286"", ""6322192"", ""287900135"", ""36784924"", ""27122356"", ""138498490"", ""2811015573"", ""2734350850"", ""2284220432"", ""204390336"", ""896542344"", ""2348060155"", ""506898166"", ""42801907"", ""276193153"", ""2829195081"", ""1334659567"", ""117110737"", ""283843715"", ""479073261"", ""178530482"", ""26896708"", ""904427838"", ""1638808831"", ""715618460"", ""142503277"", ""928447400"", ""2540972782"", ""93313169"", ""466181731"", ""233367576"", ""174365756"", ""25813762"", ""95103369"", ""268649182"", ""17608713"", ""211035819"", ""18139939"", ""16344352"", ""1965273673"", ""1437907688"", ""1858288778"", ""581507445"", ""623726325"", ""51355115"", ""29465011"", ""2872673093"", ""41738539"", ""392434009"", ""1301244769"", ""2274079149"", ""197142300"", ""17217772"", ""272623655"", ""15507696"", ""2802558656"", ""2422645062"", ""886909039"", ""30112164"", ""52759463"", ""2249904109"", ""89002214"", ""383216769"", ""531557678"", ""20797669"", ""2547279817"", ""17999966"", ""2572112909"", ""1719561684"", ""316493724"", ""2303718997"", ""2873166993"", ""2753652023"", ""160507547"", ""187410308"", ""571155194"", ""1601534479"", ""224775883"", ""552074490"", ""875957180"", ""553010243"", ""75184478"", ""466349742"", ""67199581"", ""570207471"", ""64657863"", ""2238599521"", ""70224634"", ""353415324"", ""22333797"", ""79939817"", ""28024611"", ""37896521"", ""816602323"", ""1653865512"", ""753372828"", ""426705135"", ""300301612"", ""299810381"", ""126800237"", ""221496556"", ""182773459"", ""160322522"", ""25890025"", ""306360991"", ""1473495092"", ""456241433"", ""1434582547"", ""354599880"", ""237826797"", ""67514751"", ""365091707"", ""440357927"", ""1660163972"", ""431686303"", ""305511310"", ""1115596490"", ""91762941"", ""550639277"", ""2613271906"", ""2202765880"", ""2485980511"", ""2402247031"", ""132881607"", ""95508032"", ""2724171849"", ""588398207"", ""123031832"", ""2418421612"", ""2836793474"", ""201478313"", ""299433449"", ""29861339"", ""597669698"", ""2728366397"", ""532529170"", ""374357782"", ""22556210"", ""786522835"", ""2489876530"", ""2758925727"", ""2372146301"", ""330470425"", ""2173335774"", ""713434534"", ""2173233478"", ""756524040"", ""400360169"", ""2786640289"", ""24919031"", ""10099362"", ""59121444"", ""486943719"", ""2562759720"", ""36628902"", ""563317865"", ""19351022"", ""380117713"", ""24717770"", ""2848823938"", ""22341241"", ""214664543"", ""116562889"", ""23485619"", ""535034690"", ""1434392514"", ""1859273077"", ""1346931367"", ""32724229"", ""508211969"", ""1022159918"", ""332317099"", ""539398544"", ""56509416"", ""586052805"", ""292777349"", ""1140165348"", ""1010612442"", ""629133339"", ""214809773"", ""16382144"", ""722220812"", ""388511114"", ""230045723"", ""2569565560"", ""607921050"", ""531612461"", ""38495355"", ""210684851"", ""2405747680"", ""405561109"", ""2290346153"", ""206904125"", ""2173107253"", ""281202163"", ""836650753"", ""416377136"", ""236787928"", ""2625459624"", ""558690729"", ""520727534"", ""1474440043"", ""26603138"", ""2601614204"", ""601021985"", ""118961714"", ""300418874"", ""373934991"", ""2967215441"", ""1588930196"", ""79641364"", ""393554543"", ""1532731093"", ""474158904"", ""1276752132"", ""1957490102"", ""2758836630"", ""53733680"", ""339394522"", ""392886711"", ""323076264"", ""755080"", ""1941430938"", ""1968627024"", ""421365211"", ""2318025810"", ""438224887"", ""85194290"", ""2954915265"", ""252153555"", ""175584371"", ""546999470"", ""145753406"", ""1589845357"", ""134240162"", ""101666602"", ""326489988"", ""800973974"", ""562134171"", ""987487946"", ""130936004"", ""1473888217"", ""900013537"", ""433846307"", ""18979423"", ""599506487"", ""14427344"", ""892765262"", ""241653940"", ""346137929"", ""59896768"", ""543698228"", ""388000176"", ""239984104"", ""39546181"", ""2512189647"", ""234781802"", ""351370999"", ""243447325"", ""606837229"", ""120321537"", ""73838906"", ""83972548"", ""2733936220"", ""83748727"", ""61119090"", ""872421962"", ""227729848"", ""27385166"", ""948866394"", ""2933799228"", ""753001742"", ""20436211"", ""578919489"", ""1196986207"", ""346761373"", ""2546977356"", ""78869025"", ""264862915"", ""2790337410"", ""464329417"", ""413991220"", ""42372388"", ""468935148"", ""269902419"", ""167887227"", ""1689993914"", ""2418639158"", ""75576664"", ""1453381872"", ""113854826"", ""401260919"", ""1532684660"", ""729193195"", ""16583554"", ""1923585654"", ""537472373"", ""279766660"", ""120283561"", ""83907824"", ""1594122277"", ""1733025583"", ""447015162"", ""352090345"", ""606459060"", ""2282954094"", ""564555574"", ""300916291"", ""50019729"", ""342908446"", ""54661105"", ""844060855"", ""627413256"", ""35289779"", ""2654901794"", ""864927037"", ""1169909520"", ""1173940586"", ""738723848"", ""18745364""]",42,16,58
969021517,2,93.0,-0.10074561834335327,2147800.0,2,0.5,"[""charliehebdo-all-rnr-threads"", ""sydneysiege-all-rnr-threads""]","[""51241574"", ""807095""]",1,1,2
235865079,3,60.333333333333336,-0.4182502230008443,12682485.0,3,0.6666666666666666,"[""charliehebdo-all-rnr-threads"", ""ferguson-all-rnr-threads""]","[""87416722"", ""14464766"", ""5402612""]",2,1,3
406829745,14,75.5,-0.3175715846674783,2150516.0,5,0.5,"[""charliehebdo-all-rnr-threads"", ""sydneysiege-all-rnr-threads""]","[""14173315"", ""1652541"", ""380648579"", ""19341389"", ""7744592""]",7,7,14
1711365822,3,70.0,-0.3111897309621175,2180553.0,3,0.6666666666666666,"[""charliehebdo-all-rnr-threads"", ""sydneysiege-all-rnr-threads""]","[""380648579"", ""1068121346"", ""33519870""]",2,1,3
15012486,10,121.2,-0.22214432954788207,6830462.0,104,0.6,"[""charliehebdo-all-rnr-threads"", ""ottawashooting-all-rnr-threads"", ""sydneysiege-all-rnr-threads""]","[""184468243"", ""190624049"", ""1511722304"", ""846871074"", ""2782806799"", ""53375822"", ""2601685062"", ""1176823969"", ""2886799455"", ""2339262414"", ""1043529588"", ""69897552"", ""29238700"", ""35889865"", ""2311817771"", ""123622674"", ""20981239"", ""1305332574"", ""395335393"", ""481295316"", ""62121453"", ""23153001"", ""18195001"", ""207267005"", ""91857604"", ""2434111364"", ""16843404"", ""523996194"", ""583137547"", ""490112666"", ""2915138085"", ""19024627"", ""89592667"", ""65003619"", ""200641413"", ""69903520"", ""754701355"", ""32489614"", ""231559189"", ""353353761"", ""2533076789"", ""100246984"", ""2844132738"", ""191231615"", ""247123062"", ""54525097"", ""313608234"", ""455931830"", ""2892277057"", ""2875534515"", ""17734425"", ""156283168"", ""171278582"", ""135071981"", ""971303113"", ""2377011783"", ""764143424"", ""2190716904"", ""14707322"", ""1583196864"", ""2434406185"", ""2294804946"", ""20727451"", ""16285681"", ""876736688"", ""47066924"", ""2786765641"", ""125675717"", ""40355797"", ""349784771"", ""1636738092"", ""496668868"", ""2445574598"", ""225201101"", ""47903271"", ""174273428"", ""2154102183"", ""2244285696"", ""38284217"", ""2768705528"", ""2298094741"", ""2734161712"", ""2370908751"", ""1167434527"", ""2807613817"", ""353147411"", ""165057262"", ""2958255480"", ""1885156260"", ""537389558"", ""1325179705"", ""245066085"", ""2795002772"", ""370895495"", ""47946063"", ""29578815"", ""82682487"", ""24839123"", ""93349233"", ""2208412405"", ""11462742"", ""167365470"", ""972632749"", ""52082937""]",6,4,10
25958881,3,110.0,-0.3341071605682373,2165424.0,3,0.6666666666666666,"[""charliehebdo-all-rnr-threads"", ""sydneysiege-all-rnr-threads""]","[""171802941"", ""7587032"", ""16834659""]",2,1,3
1547659670,5,44.4,-0.13611891269683837,2206761.0,4,0.8,"[""charliehebdo-all-rnr-threads"", ""sydneysiege-all-rnr-threads""]","[""1652541"", ""292777349"", ""2738397743"", ""428333""]",4,1,5
21962518,5,94.0,-0.6887470245361328,2160261.0,2,0.6,"[""charliehebdo-all-rnr-threads"", ""sydneysiege-all-rnr-threads""]","[""1652541"", ""380648579""]",3,2,5
168491473,4,99.5,-0.4746483266353607,2198932.0,3,0.25,"[""charliehebdo-all-rnr-threads"", ""sydneysiege-all-rnr-threads""]","[""380648579"", ""28785486"", ""23041630""]",1,3,4
836209867,3,115.66666666666667,-0.4949811299641927,6387632.0,2,0.6666666666666666,"[""charliehebdo-all-rnr-threads"", ""germanwings-crash-all-rnr-threads""]","[""28785486"", ""51241574""]",2,1,3
16145763,11,117.9090909090909,-0.23524536869742654,12679392.0,65,0.9090909090909091,"[""charliehebdo-all-rnr-threads"", ""ferguson-all-rnr-threads""]","[""1618273526"", ""25888849"", ""293711508"", ""2402065418"", ""118953812"", ""15832394"", ""26814800"", ""228915951"", ""28785486"", ""57721915"", ""204622930"", ""17270046"", ""182479555"", ""248751535"", ""16082186"", ""406453671"", ""387883426"", ""288791720"", ""14997959"", ""461080033"", ""1177749511"", ""256205859"", ""1588807634"", ""225970038"", ""2389731670"", ""1095548593"", ""270339848"", ""1102225280"", ""125000580"", ""28243015"", ""16743453"", ""55455536"", ""19015873"", ""196162820"", ""345133819"", ""107143385"", ""112818961"", ""43159856"", ""21262764"", ""14200380"", ""300579583"", ""121969438"", ""159618862"", ""1257847405"", ""16145763"", ""214238133"", ""302204027"", ""874880474"", ""148429316"", ""552551826"", ""239974498"", ""557129196"", ""1035152924"", ""15347644"", ""103760972"", ""70613313"", ""312398474"", ""54328637"", ""79481809"", ""534702573"", ""154661884"", ""29960497"", ""16890616"", ""2743676351"", ""2542667881""]",10,1,11
28101457,3,116.0,-0.4231643279393514,6820458.0,3,0.3333333333333333,"[""charliehebdo-all-rnr-threads"", ""ottawashooting-all-rnr-threads""]","[""15996661"", ""28785486"", ""807095""]",1,2,3
199149993,14,97.0,-0.47478177717753817,2219103.0,3,0.7857142857142857,"[""charliehebdo-all-rnr-threads"", ""sydneysiege-all-rnr-threads""]","[""380648579"", ""51241574"", ""1056552596""]",11,3,14
153132339,13,111.38461538461539,-0.4975210107289828,2212076.0,8,0.46153846153846156,"[""charliehebdo-all-rnr-threads"", ""sydneysiege-all-rnr-threads""]","[""868112707"", ""1652541"", ""51241574"", ""380648579"", ""428333"", ""52660746"", ""16343974"", ""24506246""]",6,7,13
801546008,3,125.0,-0.541377862294515,12858798.0,2,0.3333333333333333,"[""charliehebdo-all-rnr-threads"", ""ferguson-all-rnr-threads""]","[""380648579"", ""14675395""]",1,2,3
325726862,2,124.5,-0.005918681621551514,13174795.0,2,0.5,"[""charliehebdo-all-rnr-threads"", ""ferguson-all-rnr-threads""]","[""51241574"", ""24165761""]",1,1,2
2149973089,3,101.66666666666667,-0.5532250006993612,2198258.0,2,0.6666666666666666,"[""charliehebdo-all-rnr-threads"", ""sydneysiege-all-rnr-threads""]","[""51241574"", ""5402612""]",2,1,3
24138795,7,119.14285714285714,-0.22152602672576904,12886153.0,47,0.2857142857142857,"[""charliehebdo-all-rnr-threads"", ""ferguson-all-rnr-threads""]","[""319750177"", ""46595889"", ""965435300"", ""247042796"", ""51241574"", ""363441237"", ""360363286"", ""27952719"", ""40594485"", ""287959772"", ""42214993"", ""25827410"", ""24293557"", ""858833564"", ""2216354337"", ""1393229090"", ""538149299"", ""19074289"", ""534464483"", ""35374269"", ""20529504"", ""24138795"", ""177814855"", ""1593847680"", ""28056419"", ""243243853"", ""32366354"", ""74884785"", ""2521712376"", ""247104369"", ""96914360"", ""125037923"", ""276106961"", ""133926878"", ""981050484"", ""548020559"", ""1708679340"", ""2437432268"", ""19655788"", ""2194939510"", ""2780988299"", ""2537088941"", ""1703531550"", ""153919561"", ""29960497"", ""42110064"", ""550304492""]",2,5,7
266547371,2,51.0,-0.7994977831840515,5550208.0,2,1.0,"[""charliehebdo-all-rnr-threads"", ""putinmissing-all-rnr-threads""]","[""15438913"", ""51241574""]",2,0,2
195036383,20,115.1,-0.3184214740991592,6813615.0,3,0.95,"[""charliehebdo-all-rnr-threads"", ""ottawashooting-all-rnr-threads""]","[""788524"", ""2097571"", ""16343974""]",19,1,20
2530450641,4,47.0,-0.6616542339324951,2163880.0,3,0.75,"[""charliehebdo-all-rnr-threads"", ""sydneysiege-all-rnr-threads""]","[""1960878613"", ""87416722"", ""7587032""]",3,1,4
1687518794,2,9.0,0.27311068773269653,6397012.0,2,0.5,"[""charliehebdo-all-rnr-threads"", ""germanwings-crash-all-rnr-threads""]","[""2097571"", ""64643056""]",1,1,2
57023952,11,94.54545454545455,-0.3986855853687633,2171859.0,6,0.5454545454545454,"[""charliehebdo-all-rnr-threads"", ""sydneysiege-all-rnr-threads""]","[""733838438"", ""7587032"", ""807095"", ""15438913"", ""87416722"", ""64643056""]",6,5,11
2898190371,14,62.57142857142857,-0.28192664469991413,2160701.0,5,0.35714285714285715,"[""charliehebdo-all-rnr-threads"", ""sydneysiege-all-rnr-threads""]","[""1704140293"", ""7587032"", ""3108351"", ""742143"", ""1367531""]",5,9,14
2147851824,7,95.42857142857143,-0.30480137041636873,2214420.0,4,0.5714285714285714,"[""charliehebdo-all-rnr-threads"", ""sydneysiege-all-rnr-threads""]","[""487600344"", ""47624589"", ""423662810"", ""87818409""]",4,3,7
18945060,4,133.5,-0.2680776119232178,2208926.0,4,0.5,"[""charliehebdo-all-rnr-threads"", ""sydneysiege-all-rnr-threads""]","[""15438913"", ""51241574"", ""1877831"", ""49460512""]",2,2,4
22336731,6,106.16666666666667,-0.3597910404205322,19187192.0,5,0.16666666666666666,"[""charliehebdo-all-rnr-threads"", ""germanwings-crash-all-rnr-threads"", ""ferguson-all-rnr-threads""]","[""1877831"", ""51241574"", ""807095"", ""13393052"", ""146218381""]",1,5,6
10929352,4,115.25,-0.43582022190093994,6820839.0,3,0.75,"[""charliehebdo-all-rnr-threads"", ""ottawashooting-all-rnr-threads""]","[""5402612"", ""51241574"", ""428333""]",3,1,4
1108499101,2,132.0,-0.5063355267047882,2199011.0,2,0.5,"[""charliehebdo-all-rnr-threads"", ""sydneysiege-all-rnr-threads""]","[""2799960092"", ""51241574""]",1,1,2
226621859,5,110.4,-0.19209825992584229,5524904.0,2,1.0,"[""charliehebdo-all-rnr-threads"", ""putinmissing-all-rnr-threads""]","[""2539073085"", ""793879086""]",5,0,5
2915138085,13,104.23076923076923,-0.25238821598199696,2146985.0,6,0.15384615384615385,"[""charliehebdo-all-rnr-threads"", ""sydneysiege-all-rnr-threads""]","[""7587032"", ""49491544"", ""50348344"", ""2461887810"", ""15012486"", ""171117515""]",2,11,13
468657693,4,81.5,-0.6299013197422028,6821397.0,2,0.5,"[""charliehebdo-all-rnr-threads"", ""ottawashooting-all-rnr-threads"", ""sydneysiege-all-rnr-threads""]","[""380648579"", ""16076032""]",2,2,4
2589541577,2,99.5,-0.3618876338005066,2208739.0,2,1.0,"[""charliehebdo-all-rnr-threads"", ""sydneysiege-all-rnr-threads""]","[""380648579"", ""15400294""]",2,0,2
180901428,3,101.33333333333333,-0.20164247353871664,2161675.0,3,0.3333333333333333,"[""charliehebdo-all-rnr-threads"", ""sydneysiege-all-rnr-threads""]","[""380648579"", ""788524"", ""1562935142""]",1,2,3
188869825,3,119.33333333333333,-0.10566705465316772,2199844.0,3,1.0,"[""charliehebdo-all-rnr-threads"", ""sydneysiege-all-rnr-threads""]","[""380648579"", ""28785486"", ""64643056""]",3,0,3
103972238,23,114.52173913043478,-0.38687521996705426,19288332.0,9,0.4782608695652174,"[""charliehebdo-all-rnr-threads"", ""germanwings-crash-all-rnr-threads"", ""sydneysiege-all-rnr-threads"", ""ferguson-all-rnr-threads""]","[""17134268"", ""16936858"", ""7587032"", ""15108702"", ""347451363"", ""28785486"", ""1367531"", ""16834659"", ""5402612""]",11,12,23
44948272,2,136.5,-0.5001727342605591,2174573.0,2,0.5,"[""charliehebdo-all-rnr-threads"", ""sydneysiege-all-rnr-threads""]","[""156464691"", ""24506246""]",1,1,2
1298174406,3,81.0,-0.6123744249343872,2151419.0,1,0.3333333333333333,"[""charliehebdo-all-rnr-threads"", ""sydneysiege-all-rnr-threads""]","[""87416722""]",1,2,3
747822822,6,78.0,-0.3723272383213043,2156546.0,14,0.6666666666666666,"[""charliehebdo-all-rnr-threads"", ""sydneysiege-all-rnr-threads""]","[""54963857"", ""470541011"", ""18198948"", ""305781062"", ""95088481"", ""46078438"", ""747822822"", ""382810104"", ""197083089"", ""716425710"", ""416161639"", ""194659403"", ""17719208"", ""532162352""]",4,2,6
223637055,2,120.0,-0.4720308184623718,6613704.0,2,0.5,"[""charliehebdo-all-rnr-threads"", ""germanwings-crash-all-rnr-threads""]","[""3108351"", ""1367531""]",1,1,2
520401044,4,74.25,-0.2772775888442993,2206833.0,4,0.5,"[""charliehebdo-all-rnr-threads"", ""sydneysiege-all-rnr-threads""]","[""487600344"", ""14138785"", ""1367531"", ""16343974""]",2,2,4
924584022,2,66.0,-0.30880945920944214,12695670.0,2,0.5,"[""charliehebdo-all-rnr-threads"", ""ferguson-all-rnr-threads""]","[""759251"", ""1367531""]",1,1,2
2684118603,3,74.66666666666667,-0.4385879437128703,2191885.0,3,0.3333333333333333,"[""charliehebdo-all-rnr-threads"", ""sydneysiege-all-rnr-threads""]","[""407871140"", ""3108351"", ""1367531""]",1,2,3
46818339,9,114.33333333333333,-0.2078742053773668,5654483.0,3,0.1111111111111111,"[""charliehebdo-all-rnr-threads"", ""putinmissing-all-rnr-threads""]","[""271413771"", ""14293310"", ""36309919""]",1,8,9
78898625,28,56.357142857142854,-0.01650965213775633,13212952.0,15,0.5,"[""charliehebdo-all-rnr-threads"", ""germanwings-crash-all-rnr-threads"", ""ottawashooting-all-rnr-threads"", ""sydneysiege-all-rnr-threads""]","[""81122301"", ""19636948"", ""1626294277"", ""1652541"", ""132231788"", ""171643578"", ""171802941"", ""19038934"", ""15438913"", ""15754281"", ""28785486"", ""25210650"", ""64643056"", ""742143"", ""1367531""]",14,14,28
148063984,3,105.0,-0.4631374279658,6813058.0,3,1.0,"[""charliehebdo-all-rnr-threads"", ""ottawashooting-all-rnr-threads""]","[""380648579"", ""868112707"", ""51241574""]",3,0,3
122934798,6,110.33333333333333,-0.07994097471237183,2152355.0,6,0.16666666666666666,"[""charliehebdo-all-rnr-threads"", ""sydneysiege-all-rnr-threads""]","[""868112707"", ""17152053"", ""28785486"", ""245354027"", ""5698002"", ""403576718""]",1,5,6
2835363378,3,120.33333333333333,-0.6787835955619812,2197617.0,2,1.0,"[""charliehebdo-all-rnr-threads"", ""sydneysiege-all-rnr-threads""]","[""51241574"", ""428333""]",3,0,3
19819752,2,62.0,-0.3499121069908142,5449960.0,2,1.0,"[""charliehebdo-all-rnr-threads"", ""putinmissing-all-rnr-threads""]","[""324964171"", ""51241574""]",2,0,2
492529570,5,129.8,-0.5194449782371521,8779066.0,5,0.6,"[""charliehebdo-all-rnr-threads"", ""germanwings-crash-all-rnr-threads"", ""sydneysiege-all-rnr-threads""]","[""45564482"", ""51241574"", ""15438913"", ""14940354"", ""17469289""]",3,2,5
193963770,3,123.66666666666667,-0.28125449021657306,6386307.0,2,0.3333333333333333,"[""charliehebdo-all-rnr-threads"", ""germanwings-crash-all-rnr-threads""]","[""16343974"", ""51241574""]",1,2,3
18712930,2,132.5,-0.787386566400528,6819122.0,2,1.0,"[""charliehebdo-all-rnr-threads"", ""ottawashooting-all-rnr-threads""]","[""51241574"", ""807095""]",2,0,2
738723848,4,108.5,-0.6200155466794968,2208744.0,3,1.0,"[""charliehebdo-all-rnr-threads"", ""sydneysiege-all-rnr-threads""]","[""1367531"", ""51241574"", ""292777349""]",4,0,4
15468048,2,128.0,-0.4703989028930664,12837327.0,2,0.5,"[""charliehebdo-all-rnr-threads"", ""ferguson-all-rnr-threads""]","[""33092289"", ""718294442""]",1,1,2
226997507,5,127.6,-0.19219155311584474,6796515.0,3,0.4,"[""charliehebdo-all-rnr-threads"", ""ottawashooting-all-rnr-threads""]","[""358347117"", ""51241574"", ""64643056""]",2,3,5
1652541,34,110.70588235294117,-0.48415663663078756,13453757.0,387,0.6470588235294118,"[""charliehebdo-all-rnr-threads"", ""germanwings-crash-all-rnr-threads"", ""ottawashooting-all-rnr-threads"", ""sydneysiege-all-rnr-threads""]","[""212830274"", ""1266433206"", ""22583142"", ""113666095"", ""2409213534"", ""2305228178"", ""970845552"", ""362659950"", ""1503342588"", ""266204332"", ""867087306"", ""131017910"", ""43521065"", ""59513871"", ""2799605018"", ""153383179"", ""232246300"", ""21962518"", ""101747128"", ""95217333"", ""248370497"", ""606310859"", ""523996194"", ""187528119"", ""216495966"", ""22529583"", ""1291274232"", ""39498918"", ""2915297052"", ""256883732"", ""81019662"", ""2614001430"", ""324198458"", ""32250581"", ""2847978979"", ""71618160"", ""277768943"", ""162126760"", ""39067136"", ""2933943867"", ""1908917335"", ""2892277057"", ""2560148358"", ""867183860"", ""983701297"", ""69042326"", ""42334423"", ""153132339"", ""2712357938"", ""21696802"", ""2200208405"", ""39776847"", ""280529380"", ""1247654684"", ""69771400"", ""533667289"", ""285175425"", ""2180441964"", ""25687273"", ""100780738"", ""2838043548"", ""69226432"", ""282409167"", ""118224513"", ""20228338"", ""42641841"", ""1634488962"", ""624645333"", ""503580426"", ""250393818"", ""300867408"", ""109135513"", ""296034423"", ""1273480106"", ""2874372412"", ""255062000"", ""2279551026"", ""2788719575"", ""15977238"", ""452711049"", ""999907196"", ""96966077"", ""384001769"", ""39612468"", ""41109216"", ""77856380"", ""453889433"", ""2511071191"", ""2560950470"", ""50345655"", ""27836427"", ""299148448"", ""2561761900"", ""271365315"", ""58302091"", ""2821078376"", ""2800508450"", ""2916758172"", ""2678945448"", ""376611825"", ""321202634"", ""86953414"", ""292845056"", ""173382311"", ""1873157144"", ""238271990"", ""16831371"", ""250785175"", ""40346977"", ""370885480"", ""318463648"", ""395997951"", ""325163248"", ""369437673"", ""67732952"", ""220862884"", ""2831689129"", ""128921313"", ""269331703"", ""2930966744"", ""1052484990"", ""1286090778"", ""68109869"", ""1547659670"", ""2735348328"", ""1307123292"", ""714530598"", ""2815235802"", ""502313818"", ""347955226"", ""237488620"", ""17200400"", ""1686700296"", ""900943398"", ""123628014"", ""1285986758"", ""1660870934"", ""2946108430"", ""2949833486"", ""1133192222"", ""84429722"", ""123674506"", ""601966827"", ""714922136"", ""259300744"", ""2350316353"", ""48304732"", ""25206663"", ""21403782"", ""158355469"", ""579049958"", ""2746498917"", ""1852665702"", ""49597647"", ""354917016"", ""145855451"", ""66685550"", ""241982231"", ""69171795"", ""59272572"", ""868082467"", ""2651807532"", ""1415648214"", ""47502031"", ""17521439"", ""2543189090"", ""339312080"", ""297112500"", ""38828622"", ""1444255201"", ""69032114"", ""131416090"", ""14749979"", ""43835707"", ""175929814"", ""39728961"", ""296841302"", ""51640767"", ""2804724755"", ""290808547"", ""2325214996"", ""128917051"", ""1142338446"", ""1220078930"", ""134151257"", ""320579930"", ""27219829"", ""532751180"", ""2595322428"", ""2768705528"", ""2907401280"", ""2574426653"", ""921429380"", ""465290365"", ""249322219"", ""2149902227"", ""2661135751"", ""16662272"", ""57493001"", ""450662601"", ""1111570514"", ""14968480"", ""584695875"", ""2456119072"", ""1927566248"", ""25872740"", ""427261364"", ""174365756"", ""2317247166"", ""2480543874"", ""328506362"", ""1459887708"", ""25238426"", ""43889340"", ""3014055604"", ""10767712"", ""38283217"", ""865577994"", ""326888401"", ""198730266"", ""78898625"", ""607311691"", ""36624294"", ""2839646410"", ""197499997"", ""383516019"", ""24400524"", ""73502815"", ""2625755323"", ""252412220"", ""1415745792"", ""2813377586"", ""17709553"", ""100775509"", ""77792145"", ""375795665"", ""282692943"", ""2875761863"", ""456179845"", ""58341062"", ""68845525"", ""2432336336"", ""2865457323"", ""1244099858"", ""2622559649"", ""244198931"", ""517656712"", ""364853654"", ""2620056154"", ""2482271094"", ""197172614"", ""1129438412"", ""1516228110"", ""2949224176"", ""314763763"", ""268982264"", ""13120122"", ""1117535029"", ""2798966141"", ""348896135"", ""131999950"", ""138991060"", ""3009234685"", ""120233447"", ""500028700"", ""239042058"", ""2453850531"", ""2685603133"", ""2495801377"", ""21321652"", ""2372002118"", ""45032044"", ""2949027096"", ""294881874"", ""125673335"", ""2370908751"", ""2385559400"", ""75963259"", ""2646465920"", ""14250415"", ""266554539"", ""168225378"", ""117509053"", ""2404805857"", ""1280663072"", ""40278110"", ""251098739"", ""2269705771"", ""285505398"", ""122294990"", ""262062797"", ""169563224"", ""2632928909"", ""2371820574"", ""497485493"", ""1656511472"", ""23763413"", ""2723735572"", ""333182056"", ""280592005"", ""40270353"", ""1080276308"", ""357019947"", ""312639744"", ""3097907065"", ""2888761394"", ""23103000"", ""2598218616"", ""133677123"", ""59843216"", ""584360052"", ""2243770033"", ""139102545"", ""23302751"", ""22345955"", ""309264200"", ""2820517345"", ""431590274"", ""1348798826"", ""14071491"", ""47909467"", ""1246640292"", ""1084735669"", ""14327636"", ""167592087"", ""406829745"", ""292629799"", ""20715638"", ""1049464566"", ""2174389920"", ""1681128194"", ""330990433"", ""2615230232"", ""2935523322"", ""24156429"", ""301910658"", ""242815160"", ""369174235"", ""1269852703"", ""1365166501"", ""108131088"", ""177187090"", ""2241029670"", ""2888034375"", ""109536111"", ""1422670094"", ""40819260"", ""213202497"", ""2389777327"", ""439052086"", ""1950044576"", ""920300060"", ""2761102197"", ""2417900712"", ""2726639233"", ""148516959"", ""111364144"", ""715206841"", ""394189517"", ""162561603"", ""891509504"", ""67761361"", ""109554469"", ""1487097990"", ""820986276"", ""2704216071"", ""24040205"", ""1549679828"", ""43720213"", ""1567522411"", ""134941111"", ""2820425244"", ""629028228"", ""2900148061"", ""846068634"", ""2295725031"", ""27301308"", ""563506837"", ""44369449"", ""2459809351"", ""1041049706"", ""310220033"", ""41550422"", ""2206868222"", ""588284880"", ""2787487678"", ""136754171""]",22,12,34
2389777327,3,64.0,-0.16943514347076416,2180513.0,3,0.6666666666666666,"[""charliehebdo-all-rnr-threads"", ""sydneysiege-all-rnr-threads""]","[""1652541"", ""14173315"", ""5402612""]",2,1,3
138713188,8,83.375,0.064705029129982,6814596.0,5,0.25,"[""charliehebdo-all-rnr-threads"", ""ottawashooting-all-rnr-threads"", ""sydneysiege-all-rnr-threads""]","[""329121956"", ""263371799"", ""7587032"", ""292777349"", ""16031927""]",2,6,8
2734350850,17,72.3529411764706,-0.2047357769573436,6815092.0,7,0.11764705882352941,"[""charliehebdo-all-rnr-threads"", ""ottawashooting-all-rnr-threads""]","[""532779460"", ""7587032"", ""292777349"", ""2461887810"", ""55195680"", ""1367531"", ""793879086""]",2,15,17
29870604,5,121.8,-0.4635643005371094,8548340.0,4,0.6,"[""charliehebdo-all-rnr-threads"", ""germanwings-crash-all-rnr-threads"", ""sydneysiege-all-rnr-threads""]","[""14173315"", ""51241574"", ""8839632"", ""428333""]",3,2,5
874824648,3,132.66666666666666,-0.6262293656667074,6795087.0,3,0.6666666666666666,"[""charliehebdo-all-rnr-threads"", ""ottawashooting-all-rnr-threads"", ""sydneysiege-all-rnr-threads""]","[""28785486"", ""292777349"", ""51241574""]",2,1,3
2471649080,3,95.66666666666667,-0.09464057286580403,6820101.0,3,1.0,"[""charliehebdo-all-rnr-threads"", ""ottawashooting-all-rnr-threads""]","[""26040618"", ""380648579"", ""8736882""]",3,0,3
21643658,2,40.0,-0.02218681573867798,2211715.0,2,1.0,"[""charliehebdo-all-rnr-threads"", ""sydneysiege-all-rnr-threads""]","[""64643056"", ""1269181292""]",2,0,2
963145339,2,77.0,-0.652470737695694,6785461.0,2,0.5,"[""charliehebdo-all-rnr-threads"", ""ottawashooting-all-rnr-threads""]","[""16957390"", ""64643056""]",1,1,2
778057,4,103.0,-0.2534704953432083,6818664.0,15,0.5,"[""charliehebdo-all-rnr-threads"", ""ottawashooting-all-rnr-threads"", ""sydneysiege-all-rnr-threads""]","[""163575535"", ""80986170"", ""2829798301"", ""1532402708"", ""216973490"", ""17133044"", ""237549490"", ""47396544"", ""17408916"", ""44161696"", ""186467976"", ""70600593"", ""9651232"", ""16469809"", ""120283404""]",2,2,4
1122694848,2,69.0,-0.24972105026245117,2187570.0,1,0.5,"[""charliehebdo-all-rnr-threads"", ""sydneysiege-all-rnr-threads""]","[""7587032""]",1,1,2
2829195081,3,41.333333333333336,-0.31850993633270264,6558922.0,3,0.6666666666666666,"[""charliehebdo-all-rnr-threads"", ""germanwings-crash-all-rnr-threads""]","[""2566535282"", ""292777349"", ""21182691""]",2,1,3
2223008040,6,108.16666666666667,-0.07310028870900472,2208062.0,4,0.6666666666666666,"[""charliehebdo-all-rnr-threads"", ""sydneysiege-all-rnr-threads""]","[""3108351"", ""14293310"", ""16834659"", ""428333""]",4,2,6
255062000,9,140.44444444444446,-0.4579818977249993,2154244.0,7,0.3333333333333333,"[""charliehebdo-all-rnr-threads"", ""sydneysiege-all-rnr-threads""]","[""1652541"", ""14138785"", ""807095"", ""18424289"", ""64643056"", ""1367531"", ""428333""]",3,6,9
15740635,7,121.0,-0.5086603675569806,6821183.0,5,0.8571428571428571,"[""charliehebdo-all-rnr-threads"", ""ottawashooting-all-rnr-threads""]","[""149913262"", ""380648579"", ""87416722"", ""747398809"", ""5402612""]",6,1,7
267876593,3,102.66666666666667,-0.3281402389208476,6763296.0,2,1.0,"[""charliehebdo-all-rnr-threads"", ""ottawashooting-all-rnr-threads""]","[""757313467"", ""87416722""]",3,0,3
18580155,2,58.5,-0.38016146421432495,12577622.0,2,0.5,"[""charliehebdo-all-rnr-threads"", ""ferguson-all-rnr-threads""]","[""13393052"", ""328967731""]",1,1,2
337130991,4,92.75,-0.19795098900794983,2262386.0,2,0.75,"[""charliehebdo-all-rnr-threads"", ""sydneysiege-all-rnr-threads""]","[""55911799"", ""51241574""]",3,1,4
26165656,2,95.0,-0.786645770072937,6817919.0,2,1.0,"[""charliehebdo-all-rnr-threads"", ""ottawashooting-all-rnr-threads""]","[""380648579"", ""51241574""]",2,0,2
15617140,3,99.33333333333333,-0.23257660865783691,13186866.0,3,0.3333333333333333,"[""charliehebdo-all-rnr-threads"", ""sydneysiege-all-rnr-threads"", ""ferguson-all-rnr-threads""]","[""497534338"", ""51241574"", ""14090948""]",1,2,3
2723735572,53,79.30188679245283,-0.1766207476831832,12370992.0,14,0.6415094339622641,"[""charliehebdo-all-rnr-threads"", ""putinmissing-all-rnr-threads"", ""ottawashooting-all-rnr-threads"", ""sydneysiege-all-rnr-threads""]","[""14173315"", ""1652541"", ""17004618"", ""51241574"", ""15108702"", ""2097571"", ""807095"", ""10774652"", ""28785486"", ""759251"", ""1367531"", ""16031927"", ""322572436"", ""428333""]",34,19,53
322572436,5,129.6,-0.6000598669052124,2212650.0,19,1.0,"[""charliehebdo-all-rnr-threads"", ""sydneysiege-all-rnr-threads""]","[""2909294196"", ""274478755"", ""2723735572"", ""159653717"", ""622969430"", ""1426878962"", ""305171317"", ""178232832"", ""2804586564"", ""1238567425"", ""21308092"", ""2715180013"", ""16834659"", ""540903074"", ""103855686"", ""322572436"", ""2194579500"", ""902921690"", ""2919349733""]",5,0,5
178232832,3,66.0,-0.1154445211092631,2171724.0,3,0.3333333333333333,"[""charliehebdo-all-rnr-threads"", ""sydneysiege-all-rnr-threads""]","[""9624742"", ""1125937411"", ""322572436""]",1,2,3
505322398,6,121.33333333333333,-0.03669961293538412,13182653.0,3,0.3333333333333333,"[""charliehebdo-all-rnr-threads"", ""ferguson-all-rnr-threads""]","[""28785486"", ""573788425"", ""14090948""]",2,4,6
841058988,4,88.0,-0.5464512407779694,6802603.0,2,0.75,"[""charliehebdo-all-rnr-threads"", ""ottawashooting-all-rnr-threads""]","[""28785486"", ""1367531""]",3,1,4
281202163,7,114.85714285714286,-0.755119902747018,2194930.0,2,0.7142857142857143,"[""charliehebdo-all-rnr-threads"", ""sydneysiege-all-rnr-threads""]","[""15754281"", ""292777349""]",5,2,7
561985218,3,92.66666666666667,0.11831466356913249,12851131.0,2,0.6666666666666666,"[""charliehebdo-all-rnr-threads"", ""ferguson-all-rnr-threads""]","[""401651305"", ""51241574""]",2,1,3
1315224110,4,101.0,-0.14082011580467224,6804713.0,2,1.0,"[""charliehebdo-all-rnr-threads"", ""ottawashooting-all-rnr-threads""]","[""203123011"", ""51241574""]",4,0,4
23153001,39,120.3076923076923,-0.40298233888088136,6826392.0,10,0.5641025641025641,"[""charliehebdo-all-rnr-threads"", ""ottawashooting-all-rnr-threads"", ""sydneysiege-all-rnr-threads""]","[""868112707"", ""5402612"", ""51241574"", ""25235198"", ""1375289149"", ""236488883"", ""380648579"", ""7744592"", ""15012486"", ""428333""]",22,17,39
2264503075,9,85.55555555555556,-0.08409980932871501,2162178.0,7,0.5555555555555556,"[""charliehebdo-all-rnr-threads"", ""sydneysiege-all-rnr-threads""]","[""14173315"", ""1367531"", ""91279573"", ""3108351"", ""28785486"", ""22993014"", ""16834659""]",5,4,9
261000330,3,135.0,-0.29392226537068683,2211860.0,3,1.0,"[""charliehebdo-all-rnr-threads"", ""sydneysiege-all-rnr-threads""]","[""156464691"", ""28785486"", ""37874853""]",3,0,3
233885425,6,84.33333333333333,-0.14083470900853476,2217188.0,4,0.8333333333333334,"[""charliehebdo-all-rnr-threads"", ""sydneysiege-all-rnr-threads""]","[""742143"", ""87416722"", ""16834659"", ""5402612""]",5,1,6
82901787,2,139.5,-0.1521071195602417,12701997.0,2,1.0,"[""charliehebdo-all-rnr-threads"", ""ferguson-all-rnr-threads""]","[""87416722"", ""2836421""]",2,0,2
2302407630,5,66.0,-0.48458375930786135,2161091.0,3,0.8,"[""charliehebdo-all-rnr-threads"", ""sydneysiege-all-rnr-threads""]","[""43182702"", ""87416722"", ""16834659""]",4,1,5
701094366,11,99.45454545454545,-0.45624821294437756,12696158.0,8,0.09090909090909091,"[""charliehebdo-all-rnr-threads"", ""ottawashooting-all-rnr-threads"", ""ferguson-all-rnr-threads"", ""sydneysiege-all-rnr-threads""]","[""9624742"", ""1994321"", ""15108702"", ""4970411"", ""3108351"", ""952112047"", ""18622869"", ""2836421""]",1,10,11
2342489587,6,78.66666666666667,-0.4152795672416687,6828780.0,4,0.3333333333333333,"[""charliehebdo-all-rnr-threads"", ""ottawashooting-all-rnr-threads""]","[""147580943"", ""19038934"", ""1367531"", ""30313925""]",2,4,6
20686232,9,119.33333333333333,-0.465498944123586,6826794.0,3,0.5555555555555556,"[""charliehebdo-all-rnr-threads"", ""ottawashooting-all-rnr-threads"", ""sydneysiege-all-rnr-threads""]","[""1367531"", ""807095"", ""5402612""]",5,4,9
567326156,2,39.0,-0.17838114500045776,6822560.0,2,1.0,"[""charliehebdo-all-rnr-threads"", ""ottawashooting-all-rnr-threads""]","[""1367531"", ""428333""]",2,0,2
2900148061,13,46.69230769230769,0.037518758040208086,2211255.0,9,0.46153846153846156,"[""charliehebdo-all-rnr-threads"", ""sydneysiege-all-rnr-threads""]","[""868112707"", ""1652541"", ""51241574"", ""17984709"", ""149913262"", ""3108351"", ""47722134"", ""16343974"", ""1367531""]",6,7,13
28096105,12,99.16666666666667,-0.20454171299934387,12831859.0,22,0.25,"[""charliehebdo-all-rnr-threads"", ""ottawashooting-all-rnr-threads"", ""ferguson-all-rnr-threads"", ""sydneysiege-all-rnr-threads""]","[""2254402176"", ""2825224526"", ""1138527853"", ""2799431611"", ""1263002017"", ""1394537838"", ""2857657243"", ""2833164631"", ""2303514120"", ""351195189"", ""763688156"", ""428333"", ""810910340"", ""950736588"", ""64766298"", ""1715933432"", ""401710943"", ""42389136"", ""469638342"", ""2239722660"", ""22138134"", ""722653""]",3,9,12
305294287,6,56.333333333333336,-0.38542575637499493,8538744.0,2,0.16666666666666666,"[""charliehebdo-all-rnr-threads"", ""germanwings-crash-all-rnr-threads"", ""sydneysiege-all-rnr-threads""]","[""1375289149"", ""428333""]",1,5,6
356235103,2,39.0,-0.276364266872406,6819029.0,2,0.5,"[""charliehebdo-all-rnr-threads"", ""ottawashooting-all-rnr-threads""]","[""217104488"", ""2097571""]",1,1,2
176708451,2,59.0,0.005630910396575928,12822099.0,2,0.5,"[""charliehebdo-all-rnr-threads"", ""ferguson-all-rnr-threads""]","[""495464885"", ""51241574""]",1,1,2
302903787,2,35.0,-0.5576618909835815,12703848.0,2,0.5,"[""charliehebdo-all-rnr-threads"", ""ferguson-all-rnr-threads""]","[""759251"", ""51241574""]",1,1,2
534685142,2,28.5,-0.48753103613853455,2177405.0,2,1.0,"[""charliehebdo-all-rnr-threads"", ""sydneysiege-all-rnr-threads""]","[""14293310"", ""51241574""]",2,0,2
413532500,3,114.66666666666667,-0.22272922595342,12734499.0,3,0.6666666666666666,"[""charliehebdo-all-rnr-threads"", ""ferguson-all-rnr-threads""]","[""2725579568"", ""61419696"", ""428333""]",2,1,3
2653260771,2,34.5,0.5394302010536194,6379335.0,2,0.5,"[""charliehebdo-all-rnr-threads"", ""germanwings-crash-all-rnr-threads""]","[""2280470022"", ""1299769218""]",1,1,2
17664062,3,112.66666666666667,-0.7010908722877502,2188234.0,3,0.6666666666666666,"[""charliehebdo-all-rnr-threads"", ""sydneysiege-all-rnr-threads""]","[""16589206"", ""87416722"", ""1299769218""]",2,1,3
533578801,2,76.5,-0.12755411863327026,12689022.0,2,1.0,"[""charliehebdo-all-rnr-threads"", ""ferguson-all-rnr-threads""]","[""25049056"", ""14722589""]",2,0,2
19952601,3,70.66666666666667,-0.45796287059783936,6824962.0,3,1.0,"[""charliehebdo-all-rnr-threads"", ""ottawashooting-all-rnr-threads""]","[""380648579"", ""51241574"", ""8736882""]",3,0,3
18379848,5,105.6,-0.13972456455230714,2185957.0,5,0.4,"[""charliehebdo-all-rnr-threads"", ""sydneysiege-all-rnr-threads""]","[""868112707"", ""7587032"", ""380648579"", ""21182691"", ""5402612""]",2,3,5
228332540,5,114.4,-0.482257342338562,19080567.0,5,0.6,"[""charliehebdo-all-rnr-threads"", ""germanwings-crash-all-rnr-threads"", ""sydneysiege-all-rnr-threads"", ""ferguson-all-rnr-threads""]","[""1630896181"", ""254873869"", ""24165761"", ""64643056"", ""5402612""]",3,2,5
350042055,5,97.4,-0.24516748189926146,12884919.0,3,0.6,"[""charliehebdo-all-rnr-threads"", ""sydneysiege-all-rnr-threads"", ""ferguson-all-rnr-threads""]","[""5988062"", ""64643056"", ""2163076560""]",3,2,5
2216598879,5,118.2,-0.19631896018981934,12916686.0,3,0.2,"[""charliehebdo-all-rnr-threads"", ""ferguson-all-rnr-threads""]","[""14715424"", ""64643056"", ""66533920""]",1,4,5
1148205248,2,55.5,-0.3406287431716919,2215387.0,1,1.0,"[""charliehebdo-all-rnr-threads"", ""sydneysiege-all-rnr-threads""]","[""7587032""]",2,0,2
17876008,4,127.5,-0.5194266885519028,2209415.0,4,0.5,"[""charliehebdo-all-rnr-threads"", ""sydneysiege-all-rnr-threads""]","[""51241574"", ""156464691"", ""16973333"", ""7587032""]",2,2,4
1337411749,3,43.666666666666664,-0.27117933829625446,12874894.0,2,0.3333333333333333,"[""charliehebdo-all-rnr-threads"", ""ferguson-all-rnr-threads""]","[""109065990"", ""428333""]",1,2,3
195059447,9,116.88888888888889,-0.4443010555373298,2162953.0,6,0.6666666666666666,"[""charliehebdo-all-rnr-threads"", ""sydneysiege-all-rnr-threads""]","[""868112707"", ""51241574"", ""7587032"", ""380648579"", ""87416722"", ""21182691""]",6,3,9
113028815,2,108.5,-0.7171735763549805,6508074.0,2,1.0,"[""charliehebdo-all-rnr-threads"", ""germanwings-crash-all-rnr-threads""]","[""21866939"", ""87416722""]",2,0,2
15507696,5,34.4,0.14034204483032225,2163196.0,3,0.8,"[""charliehebdo-all-rnr-threads"", ""sydneysiege-all-rnr-threads""]","[""292777349"", ""87416722"", ""428333""]",4,1,5
1408458926,28,117.21428571428571,-0.06274148821830748,2706987.0,27,0.03571428571428571,"[""charliehebdo-all-rnr-threads"", ""sydneysiege-all-rnr-threads""]","[""154435961"", ""33203801"", ""71804710"", ""171953871"", ""61436584"", ""36252186"", ""16330790"", ""187303839"", ""22516998"", ""118672200"", ""838673408"", ""18725815"", ""164397041"", ""384779793"", ""501768982"", ""9507342"", ""239964092"", ""22162815"", ""272388054"", ""167494843"", ""238575113"", ""299294766"", ""255527829"", ""646483"", ""166233427"", ""514019413"", ""2808121994""]",1,27,28
86495094,2,88.0,0.09361815452575684,2194740.0,2,1.0,"[""charliehebdo-all-rnr-threads"", ""sydneysiege-all-rnr-threads""]","[""90918950"", ""268662889""]",2,0,2
956452369,4,133.75,-0.11590942740440369,2190889.0,3,0.5,"[""charliehebdo-all-rnr-threads"", ""sydneysiege-all-rnr-threads""]","[""90918950"", ""157009365"", ""15220768""]",2,2,4
2204086600,2,38.5,0.5244858264923096,6810788.0,2,0.5,"[""charliehebdo-all-rnr-threads"", ""ottawashooting-all-rnr-threads""]","[""15438913"", ""1367531""]",1,1,2
33519870,3,91.66666666666667,-0.5700657566388448,12691687.0,58,0.3333333333333333,"[""charliehebdo-all-rnr-threads"", ""ferguson-all-rnr-threads""]","[""19118069"", ""8941562"", ""24665933"", ""316979554"", ""25834897"", ""2347707326"", ""278684255"", ""21630064"", ""1575138829"", ""187215601"", ""329267988"", ""246604433"", ""412239022"", ""2522138451"", ""2172677811"", ""20691578"", ""108743813"", ""366748134"", ""18244206"", ""180610640"", ""518043939"", ""14860306"", ""33519870"", ""932498976"", ""180169477"", ""550499847"", ""854926250"", ""2370662504"", ""1711365822"", ""13651772"", ""404460410"", ""48290701"", ""2559436158"", ""43721859"", ""473261135"", ""18383618"", ""17672594"", ""1439700691"", ""486989690"", ""1094512128"", ""2694875537"", ""51317263"", ""19220522"", ""276200059"", ""942147613"", ""353560078"", ""291516326"", ""79228319"", ""1102675910"", ""376472551"", ""9336402"", ""158425344"", ""1648909459"", ""14522779"", ""14789146"", ""1717260037"", ""885246932"", ""1447417682""]",1,2,3
180610640,3,127.33333333333333,-0.46825234095255536,2200936.0,2,1.0,"[""charliehebdo-all-rnr-threads"", ""sydneysiege-all-rnr-threads""]","[""33519870"", ""428333""]",3,0,3
7589572,5,119.2,-0.354951810836792,2192158.0,70,0.2,"[""charliehebdo-all-rnr-threads"", ""sydneysiege-all-rnr-threads""]","[""2359238814"", ""2720869403"", ""344801735"", ""38699127"", ""880507676"", ""2957821871"", ""534721187"", ""132092633"", ""332981989"", ""2499275057"", ""2448260294"", ""556154434"", ""2443498549"", ""540187029"", ""233344316"", ""57098848"", ""1624699663"", ""2525846526"", ""487846153"", ""112961565"", ""2545441463"", ""2594777088"", ""26989237"", ""2765809157"", ""2579863970"", ""2931707559"", ""337167005"", ""223973393"", ""143855198"", ""994395258"", ""24036615"", ""824859420"", ""25206663"", ""319558317"", ""24141445"", ""2798640021"", ""19738889"", ""2240360555"", ""2665217864"", ""19858550"", ""2951345235"", ""17615105"", ""1708410986"", ""1208611675"", ""573933740"", ""2888783532"", ""361135947"", ""113015879"", ""1693249255"", ""20282201"", ""460502356"", ""464568950"", ""1684053877"", ""115139031"", ""152318142"", ""2195112884"", ""2940150100"", ""759920736"", ""176069994"", ""2607703608"", ""119074207"", ""2238197664"", ""1546750824"", ""249346041"", ""1348798826"", ""2802294698"", ""334544645"", ""70593494"", ""2400779016"", ""57111234""]",1,4,5
40331982,6,78.83333333333333,-0.07467370231946309,2205193.0,4,1.0,"[""charliehebdo-all-rnr-threads"", ""sydneysiege-all-rnr-threads""]","[""1367531"", ""20402945"", ""807095"", ""1994321""]",6,0,6
60477982,2,128.5,-0.3594158887863159,2192623.0,2,1.0,"[""charliehebdo-all-rnr-threads"", ""sydneysiege-all-rnr-threads""]","[""868112707"", ""7587032""]",2,0,2
174365756,12,108.25,-0.4674096554517746,2219019.0,7,0.75,"[""charliehebdo-all-rnr-threads"", ""sydneysiege-all-rnr-threads""]","[""868112707"", ""1652541"", ""7587032"", ""380648579"", ""292777349"", ""491960101"", ""428333""]",9,3,12
976596115,5,58.6,-0.5825222849845886,2193494.0,2,0.4,"[""charliehebdo-all-rnr-threads"", ""sydneysiege-all-rnr-threads""]","[""7587032"", ""919283569""]",2,3,5
455931830,3,126.66666666666667,-0.5449526906013489,6642845.0,2,0.6666666666666666,"[""charliehebdo-all-rnr-threads"", ""germanwings-crash-all-rnr-threads""]","[""15012486"", ""15754281""]",2,1,3
104299137,3,120.66666666666667,-0.4226914644241333,2213372.0,3,1.0,"[""charliehebdo-all-rnr-threads"", ""sydneysiege-all-rnr-threads""]","[""15754281"", ""2467791"", ""9609632""]",3,0,3
229743093,3,94.66666666666667,-0.330866018931071,2163599.0,3,0.6666666666666666,"[""charliehebdo-all-rnr-threads"", ""sydneysiege-all-rnr-threads""]","[""14173315"", ""23041630"", ""51241574""]",2,1,3
37896521,4,87.75,-0.6331773400306702,2218801.0,3,1.0,"[""charliehebdo-all-rnr-threads"", ""sydneysiege-all-rnr-threads""]","[""22993014"", ""292777349"", ""51241574""]",4,0,4
22450386,2,92.5,-0.7199552655220032,2162308.0,1,0.5,"[""charliehebdo-all-rnr-threads"", ""sydneysiege-all-rnr-threads""]","[""51241574""]",1,1,2
15246579,2,105.0,-0.5978718400001526,12688401.0,2,1.0,"[""charliehebdo-all-rnr-threads"", ""ferguson-all-rnr-threads""]","[""158426909"", ""51241574""]",2,0,2
18294906,14,111.71428571428571,-0.29914507269859314,12919145.0,40,0.35714285714285715,"[""charliehebdo-all-rnr-threads"", ""sydneysiege-all-rnr-threads"", ""ferguson-all-rnr-threads""]","[""67413764"", ""85641619"", ""77713796"", ""51241574"", ""244366948"", ""1918825932"", ""715052108"", ""2268080331"", ""47146660"", ""2305758626"", ""205543658"", ""2566329759"", ""2704690603"", ""2730032553"", ""104077046"", ""15896580"", ""277670569"", ""396186567"", ""1093638847"", ""328928589"", ""14715424"", ""523218328"", ""18389705"", ""404460410"", ""608531157"", ""42921216"", ""283958013"", ""14090948"", ""65699341"", ""981050484"", ""1923263588"", ""15250661"", ""338005354"", ""16730467"", ""235239752"", ""33627414"", ""1020954092"", ""2592306463"", ""18294906"", ""768245738""]",5,9,14
42971403,4,108.5,-0.29759010672569275,2217541.0,4,0.75,"[""charliehebdo-all-rnr-threads"", ""sydneysiege-all-rnr-threads""]","[""380648579"", ""16343974"", ""868112707"", ""218730857""]",3,1,4
218503228,2,100.5,-0.4616974890232086,2219847.0,1,1.0,"[""charliehebdo-all-rnr-threads"", ""sydneysiege-all-rnr-threads""]","[""380648579""]",2,0,2
24000700,2,45.5,-0.45059704780578613,2188189.0,2,0.5,"[""charliehebdo-all-rnr-threads"", ""sydneysiege-all-rnr-threads""]","[""292777349"", ""331672974""]",1,1,2
64657863,4,118.25,-0.534693568944931,6819488.0,4,0.75,"[""charliehebdo-all-rnr-threads"", ""ottawashooting-all-rnr-threads"", ""sydneysiege-all-rnr-threads""]","[""87416722"", ""292777349"", ""428333"", ""807095""]",3,1,4
823640412,3,51.333333333333336,-0.26458513736724854,2319700.0,3,0.3333333333333333,"[""charliehebdo-all-rnr-threads"", ""sydneysiege-all-rnr-threads""]","[""4126501"", ""76858507"", ""1994321""]",1,2,3
24156429,9,128.22222222222223,-0.3300955229335361,2193135.0,9,0.4444444444444444,"[""charliehebdo-all-rnr-threads"", ""sydneysiege-all-rnr-threads""]","[""1652541"", ""87165980"", ""2566535282"", ""171802941"", ""380648579"", ""742143"", ""103065157"", ""22993014"", ""428333""]",4,5,9
302564474,3,122.0,-0.5358064969380697,6552355.0,2,1.0,"[""charliehebdo-all-rnr-threads"", ""germanwings-crash-all-rnr-threads""]","[""302564474"", ""32855189""]",3,0,3
54727574,4,125.25,-0.40021054446697235,2166432.0,4,0.5,"[""charliehebdo-all-rnr-threads"", ""sydneysiege-all-rnr-threads""]","[""16343974"", ""868112707"", ""428333"", ""7587032""]",2,2,4
156357436,2,125.5,-0.4375946819782257,6372466.0,2,1.0,"[""charliehebdo-all-rnr-threads"", ""germanwings-crash-all-rnr-threads""]","[""2280470022"", ""868112707""]",2,0,2
19038934,44,124.22727272727273,-0.4216930351474069,6834989.0,481,0.8409090909090909,"[""charliehebdo-all-rnr-threads"", ""ottawashooting-all-rnr-threads"", ""sydneysiege-all-rnr-threads""]","[""16072089"", ""256499010"", ""14988258"", ""139199721"", ""798115730"", ""174124516"", ""298605465"", ""232413911"", ""25381903"", ""29120704"", ""256596656"", ""89595486"", ""40509497"", ""242506891"", ""288555453"", ""196681973"", ""108686197"", ""2339452234"", ""253119733"", ""24646881"", ""512990257"", ""36422625"", ""522452889"", ""273006611"", ""243926925"", ""113769934"", ""38911395"", ""263351710"", ""70847090"", ""952408764"", ""15110640"", ""1155091850"", ""22849876"", ""490822754"", ""802731019"", ""73152491"", ""312291066"", ""444225252"", ""276211330"", ""325303078"", ""234981515"", ""24785521"", ""185863189"", ""870287911"", ""275210802"", ""171144148"", ""388114517"", ""19769774"", ""370424351"", ""15012912"", ""52053481"", ""2349544946"", ""16179061"", ""425223279"", ""1855796803"", ""2625540574"", ""43452851"", ""45632111"", ""398206059"", ""1638851473"", ""168238507"", ""1164963978"", ""160190953"", ""2342489587"", ""50791051"", ""357176903"", ""294115652"", ""2196976076"", ""2678214259"", ""27285496"", ""88857147"", ""2431432212"", ""210755379"", ""2612149370"", ""19132051"", ""2420931696"", ""2368776978"", ""2796029406"", ""868301143"", ""2445747320"", ""106756900"", ""70119256"", ""158095776"", ""16960958"", ""604277352"", ""15689894"", ""66647950"", ""401495555"", ""443754749"", ""238979179"", ""2611800945"", ""839910636"", ""397529190"", ""331297670"", ""2464274870"", ""2446095524"", ""2483222413"", ""37043257"", ""834711"", ""19111502"", ""2252228005"", ""1247032261"", ""772326630"", ""185252402"", ""2453722299"", ""850097660"", ""245882973"", ""184045217"", ""26424557"", ""2413748023"", ""279781142"", ""564817703"", ""44735216"", ""389640649"", ""623677981"", ""1857947305"", ""1379563256"", ""612660347"", ""287936121"", ""2611703782"", ""148508453"", ""1596564414"", ""471219711"", ""22279004"", ""53435162"", ""320967163"", ""589396431"", ""757282338"", ""492455514"", ""1080892105"", ""29304551"", ""2437545320"", ""63463165"", ""113465587"", ""509034236"", ""405725325"", ""220561258"", ""952685738"", ""415550654"", ""1336660494"", ""339911220"", ""42559475"", ""120921045"", ""65520623"", ""885827208"", ""39547278"", ""2497139639"", ""146094544"", ""2833993809"", ""2541530396"", ""2275407414"", ""95666186"", ""1852665702"", ""22445118"", ""398401797"", ""180975613"", ""277525288"", ""2525132137"", ""1645266590"", ""2339132688"", ""1013638513"", ""40491446"", ""2744076299"", ""2803669124"", ""2641197996"", ""288389092"", ""2364793669"", ""30554699"", ""201563247"", ""287321052"", ""2337752683"", ""30373506"", ""1385273570"", ""45224683"", ""201727015"", ""265023219"", ""1145614250"", ""512627961"", ""193745675"", ""518011368"", ""1419006355"", ""61932015"", ""316100289"", ""25428766"", ""77076143"", ""2471513118"", ""341862843"", ""2600958984"", ""592935807"", ""94226922"", ""23706022"", ""247204494"", ""468905212"", ""1336924130"", ""1395606644"", ""398149765"", ""157155075"", ""187081193"", ""500812163"", ""20059752"", ""192620272"", ""1954310454"", ""896542344"", ""853880196"", ""77578572"", ""25143051"", ""20391491"", ""198900895"", ""469661019"", ""769153303"", ""255166387"", ""488603581"", ""178955616"", ""1230267290"", ""273121006"", ""162128725"", ""38998647"", ""2865907655"", ""627680824"", ""281686218"", ""62148771"", ""2400727014"", ""90972286"", ""453856839"", ""384090604"", ""921267164"", ""1706564274"", ""29383413"", ""28369898"", ""2158900458"", ""2440951868"", ""536768874"", ""495491486"", ""494307479"", ""16510872"", ""15992923"", ""2259227762"", ""20541137"", ""54609429"", ""140060190"", ""2366754506"", ""2352684726"", ""252620528"", ""18524109"", ""379483584"", ""17300548"", ""14249498"", ""226292436"", ""27217349"", ""2371009006"", ""172469352"", ""250338868"", ""15569772"", ""193002383"", ""1058370912"", ""111137551"", ""278260486"", ""2364838764"", ""194672143"", ""78898625"", ""76976905"", ""221355278"", ""225191038"", ""416210375"", ""20532723"", ""45751480"", ""238486480"", ""875642220"", ""636528909"", ""14120069"", ""2786426979"", ""407046265"", ""2371631"", ""59430756"", ""18014327"", ""203088036"", ""801698222"", ""34536018"", ""345643533"", ""22418027"", ""2355300410"", ""541048732"", ""15765108"", ""24329944"", ""49585298"", ""390020503"", ""2819580681"", ""275628840"", ""923751684"", ""29258744"", ""2175074641"", ""2234654552"", ""186285606"", ""2588988638"", ""325137747"", ""25366062"", ""304390924"", ""886809799"", ""274496182"", ""310038488"", ""339847349"", ""23820383"", ""96832045"", ""17418879"", ""2601877159"", ""118915743"", ""349633651"", ""161406698"", ""6433472"", ""248895371"", ""2186460294"", ""1221351"", ""16990814"", ""893756430"", ""17621839"", ""89801274"", ""2260621981"", ""67641759"", ""2560595986"", ""68760726"", ""2631497205"", ""1278708559"", ""243243291"", ""1408947008"", ""14316796"", ""1375928239"", ""77593494"", ""30464024"", ""454114632"", ""1149482960"", ""732910694"", ""108422084"", ""324086895"", ""16424033"", ""1614191498"", ""424418661"", ""1564217166"", ""1385817876"", ""50012276"", ""23077575"", ""277079377"", ""594343447"", ""87055066"", ""853590434"", ""178886433"", ""101637908"", ""77879283"", ""930776510"", ""2421298825"", ""251312302"", ""412567162"", ""85733767"", ""16753407"", ""143120019"", ""728394116"", ""271952423"", ""2487067852"", ""2284145784"", ""21670152"", ""1280700488"", ""45350552"", ""313463429"", ""70043481"", ""59219024"", ""547952371"", ""587807917"", ""2756075096"", ""1238981322"", ""1408816128"", ""737079188"", ""2369390797"", ""155295992"", ""34971699"", ""2774115294"", ""382637564"", ""495997677"", ""523104566"", ""503749143"", ""2437167714"", ""24242690"", ""115886031"", ""1493344357"", ""191281511"", ""44299861"", ""67349911"", ""610267640"", ""19021923"", ""23857263"", ""2860330333"", ""2791994144"", ""338517621"", ""52160266"", ""20418836"", ""238588579"", ""218565273"", ""2412920598"", ""32662150"", ""1560856285"", ""196860764"", ""30001483"", ""258552502"", ""124225873"", ""59351690"", ""54774832"", ""183777979"", ""46285906"", ""1048283449"", ""606921897"", ""516234551"", ""987487946"", ""352146620"", ""941229320"", ""1284520375"", ""272112035"", ""312024587"", ""511970204"", ""629837701"", ""2825248386"", ""278347742"", ""205724874"", ""2638705464"", ""2184697062"", ""2846586258"", ""277985443"", ""2205121861"", ""1194737994"", ""419271392"", ""48934167"", ""15992943"", ""497660531"", ""273201959"", ""553593104"", ""16105433"", ""47116408"", ""38553095"", ""958976852"", ""2230195528"", ""279643305"", ""363935285"", ""522403192"", ""834333324"", ""245571248"", ""274307531"", ""621930944"", ""137103163"", ""590520318"", ""499790397"", ""1093320080"", ""2176810176"", ""1708089228"", ""23130850"", ""74164540"", ""22251439"", ""2607521749"", ""388058926"", ""71688199"", ""85725107"", ""2542524955"", ""1005109987"", ""18433627"", ""775646406"", ""2814031933"", ""218597862"", ""2352007196"", ""397051626"", ""393094484"", ""2736111380"", ""1658969095"", ""120980332"", ""352090345"", ""2312097570"", ""891199856"", ""1598896028"", ""2377353168"", ""244105373"", ""433675700"", ""2315682110"", ""161439565"", ""171137909"", ""1591762152"", ""301189264""]",37,7,44
187081193,6,113.66666666666667,-0.2532481948534648,2202864.0,3,0.6666666666666666,"[""charliehebdo-all-rnr-threads"", ""sydneysiege-all-rnr-threads""]","[""19038934"", ""742143"", ""5402612""]",4,2,6
2339351,2,85.5,-0.45401710271835327,6373716.0,2,0.5,"[""charliehebdo-all-rnr-threads"", ""germanwings-crash-all-rnr-threads""]","[""380648579"", ""95747671""]",1,1,2
416210375,3,46.0,-0.13857915004094443,2210233.0,2,0.6666666666666666,"[""charliehebdo-all-rnr-threads"", ""sydneysiege-all-rnr-threads""]","[""19038934"", ""380648579""]",2,1,3
753969769,2,76.5,0.24953973293304443,2222114.0,2,1.0,"[""charliehebdo-all-rnr-threads"", ""sydneysiege-all-rnr-threads""]","[""380648579"", ""49460512""]",2,0,2
2826697284,2,85.0,-0.1370832324028015,2185376.0,1,0.5,"[""charliehebdo-all-rnr-threads"", ""sydneysiege-all-rnr-threads""]","[""5402612""]",1,1,2
331658004,5,75.2,0.23552727699279785,5612013.0,28,0.2,"[""charliehebdo-all-rnr-threads"", ""putinmissing-all-rnr-threads""]","[""597789064"", ""2528512406"", ""18370911"", ""940853760"", ""64127121"", ""2675604559"", ""702591266"", ""921252660"", ""609902066"", ""418867782"", ""2806109387"", ""125150508"", ""2449982929"", ""885363181"", ""1401704990"", ""64430687"", ""4880191"", ""35227730"", ""419423030"", ""275023883"", ""331658004"", ""2888783532"", ""295789381"", ""146142164"", ""2905430920"", ""39498918"", ""309334144"", ""2301712239""]",1,4,5
27353755,5,98.4,-0.1804690718650818,2029240.0,4,0.2,"[""charliehebdo-all-rnr-threads"", ""sydneysiege-all-rnr-threads""]","[""14788739"", ""15798091"", ""465973"", ""22123727""]",1,4,5
286801248,14,121.35714285714286,-0.5331751917089734,6650410.0,10,0.07142857142857142,"[""charliehebdo-all-rnr-threads"", ""ottawashooting-all-rnr-threads"", ""sydneysiege-all-rnr-threads""]","[""635608354"", ""164075542"", ""17537467"", ""419520517"", ""380648579"", ""465973"", ""50306637"", ""29465136"", ""1878576403"", ""428140124""]",1,13,14
526631013,5,101.0,-0.6290314435958863,6624626.0,2,0.8,"[""charliehebdo-all-rnr-threads"", ""ottawashooting-all-rnr-threads""]","[""51241574"", ""465973""]",4,1,5
842574937,8,67.0,-0.4852459877729416,13018287.0,2,0.0,"[""charliehebdo-all-rnr-threads"", ""ferguson-all-rnr-threads""]","[""15798091"", ""7607852""]",0,8,8
21230017,3,90.66666666666667,-0.6572393178939819,6565977.0,3,0.0,"[""charliehebdo-all-rnr-threads"", ""germanwings-crash-all-rnr-threads""]","[""15798091"", ""742143"", ""2653613168""]",0,3,3
2840119379,3,75.0,-0.28759578863779706,2002753.0,3,0.3333333333333333,"[""charliehebdo-all-rnr-threads"", ""sydneysiege-all-rnr-threads""]","[""87818409"", ""15798091"", ""7587032""]",1,2,3
68956490,15,109.0,-0.5121005654335022,19454432.0,14,0.2,"[""charliehebdo-all-rnr-threads"", ""germanwings-crash-all-rnr-threads"", ""sydneysiege-all-rnr-threads"", ""ferguson-all-rnr-threads""]","[""7702542"", ""15798091"", ""954124423"", ""270569708"", ""84652988"", ""14511951"", ""147994804"", ""195271137"", ""159491022"", ""97327765"", ""807095"", ""759251"", ""7587032"", ""16031927""]",3,12,15
5867842,4,43.75,-0.14451715350151062,6564064.0,15,0.25,"[""charliehebdo-all-rnr-threads"", ""germanwings-crash-all-rnr-threads""]","[""5867842"", ""2391019725"", ""2457768185"", ""2459278543"", ""27049546"", ""39262148"", ""116766267"", ""462304626"", ""5734902"", ""125975224"", ""1747392930"", ""130831912"", ""7429552"", ""1137111630"", ""164228366""]",1,3,4
244763443,2,96.0,-0.35775864124298096,2002066.0,2,0.0,"[""charliehebdo-all-rnr-threads"", ""sydneysiege-all-rnr-threads""]","[""2799960092"", ""16525194""]",0,2,2
243576302,7,116.42857142857143,-0.34299577133996145,2089333.0,4,0.0,"[""charliehebdo-all-rnr-threads"", ""sydneysiege-all-rnr-threads""]","[""46078438"", ""15439395"", ""107210124"", ""23949317""]",0,7,7
458085775,4,98.5,-0.4348568320274353,6835755.0,4,0.5,"[""charliehebdo-all-rnr-threads"", ""ottawashooting-all-rnr-threads"", ""sydneysiege-all-rnr-threads""]","[""2738397743"", ""2097571"", ""23949317"", ""130778462""]",2,2,4
97863902,23,100.08695652173913,-0.39227399359578674,2044797.0,5,0.0,"[""charliehebdo-all-rnr-threads"", ""sydneysiege-all-rnr-threads""]","[""16973333"", ""15348883"", ""117366399"", ""33315010"", ""16343974""]",0,23,23
142257829,2,129.5,0.05444371700286865,1994215.0,2,0.0,"[""charliehebdo-all-rnr-threads"", ""sydneysiege-all-rnr-threads""]","[""55911799"", ""15348883""]",0,2,2
36611990,9,86.33333333333333,-0.2650708225038316,12844349.0,4,0.0,"[""charliehebdo-all-rnr-threads"", ""ferguson-all-rnr-threads""]","[""458008892"", ""17672825"", ""14849562"", ""15348883""]",0,9,9
2237451721,25,88.24,-0.2991364669799805,2203840.0,6,0.08,"[""charliehebdo-all-rnr-threads"", ""sydneysiege-all-rnr-threads""]","[""407779393"", ""1359226843"", ""15348883"", ""17004618"", ""49279876"", ""17765045""]",2,23,25
369437673,39,115.61538461538461,-0.2771447560726068,6772559.0,4,0.10256410256410256,"[""charliehebdo-all-rnr-threads"", ""ottawashooting-all-rnr-threads"", ""sydneysiege-all-rnr-threads""]","[""1652541"", ""2163076560"", ""14291684"", ""15348883""]",4,35,39
104616554,2,104.0,-0.5504130423069,2028851.0,2,0.0,"[""charliehebdo-all-rnr-threads"", ""sydneysiege-all-rnr-threads""]","[""23190207"", ""374712154""]",0,2,2
218460252,2,97.5,-0.6755155324935913,6639343.0,2,0.5,"[""charliehebdo-all-rnr-threads"", ""ottawashooting-all-rnr-threads""]","[""102420077"", ""15966995""]",1,1,2
2873005749,10,77.7,-0.5557128667831421,2029435.0,2,0.0,"[""charliehebdo-all-rnr-threads"", ""sydneysiege-all-rnr-threads""]","[""459390022"", ""374712154""]",0,10,10
43644895,7,44.0,0.022341132164001465,2084414.0,3,0.0,"[""charliehebdo-all-rnr-threads"", ""sydneysiege-all-rnr-threads""]","[""128364810"", ""459390022"", ""20891396""]",0,7,7
244033117,3,73.33333333333333,-0.40572547912597656,12494991.0,2,0.6666666666666666,"[""charliehebdo-all-rnr-threads"", ""ferguson-all-rnr-threads""]","[""16116288"", ""15438913""]",2,1,3
19877641,6,119.66666666666667,0.02447762091954549,1992025.0,2,0.0,"[""charliehebdo-all-rnr-threads"", ""sydneysiege-all-rnr-threads""]","[""250603308"", ""305134471""]",0,6,6
2725911162,8,56.75,0.14871421456336975,2134228.0,5,0.125,"[""charliehebdo-all-rnr-threads"", ""sydneysiege-all-rnr-threads""]","[""28139873"", ""2738397743"", ""305134471"", ""807095"", ""877551276""]",1,7,8
520875081,3,69.33333333333333,0.19473830858866373,6642320.0,3,0.3333333333333333,"[""charliehebdo-all-rnr-threads"", ""ottawashooting-all-rnr-threads""]","[""6433472"", ""31135856"", ""305134471""]",1,2,3
20542381,7,114.14285714285714,-0.3669010656220572,2005643.0,4,0.0,"[""charliehebdo-all-rnr-threads"", ""sydneysiege-all-rnr-threads""]","[""2248932158"", ""29242390"", ""21360768"", ""305134471""]",0,7,7
2484304264,10,80.0,-0.19485724568367005,2158734.0,6,0.1,"[""charliehebdo-all-rnr-threads"", ""sydneysiege-all-rnr-threads""]","[""22657914"", ""801629904"", ""342894187"", ""16343974"", ""83638901"", ""164397041""]",1,9,10
323132701,2,142.0,-0.29640236496925354,12512436.0,2,0.0,"[""charliehebdo-all-rnr-threads"", ""ferguson-all-rnr-threads""]","[""29242390"", ""195271137""]",0,2,2
169237647,2,111.5,-0.3732238709926605,2048370.0,2,0.0,"[""charliehebdo-all-rnr-threads"", ""sydneysiege-all-rnr-threads""]","[""11741632"", ""2579312316""]",0,2,2
11462742,24,83.0,0.05321542173624039,6659377.0,18,0.375,"[""charliehebdo-all-rnr-threads"", ""ottawashooting-all-rnr-threads"", ""sydneysiege-all-rnr-threads""]","[""148116121"", ""8736882"", ""27825918"", ""51241574"", ""2097571"", ""97382927"", ""6473022"", ""16299754"", ""289998339"", ""384438102"", ""14216661"", ""18999969"", ""193725962"", ""21212604"", ""22568416"", ""375721095"", ""15012486"", ""23937894""]",9,15,24
60006673,5,136.6,-0.6548815965652466,2002419.0,4,0.2,"[""charliehebdo-all-rnr-threads"", ""sydneysiege-all-rnr-threads""]","[""6473022"", ""16589206"", ""16675569"", ""14224719""]",1,4,5
21330040,13,117.53846153846153,-0.07682522443624643,12593298.0,12,0.07692307692307693,"[""charliehebdo-all-rnr-threads"", ""ferguson-all-rnr-threads""]","[""344613908"", ""522285305"", ""14173315"", ""1851229334"", ""6482142"", ""487600344"", ""19062754"", ""2097571"", ""2175876524"", ""24824450"", ""221517172"", ""742143""]",1,12,13
568119166,2,114.0,-0.23604342341423035,2027059.0,2,0.0,"[""charliehebdo-all-rnr-threads"", ""sydneysiege-all-rnr-threads""]","[""16675569"", ""16973333""]",0,2,2
368041715,5,107.0,-0.11520345211029052,2030226.0,4,0.2,"[""charliehebdo-all-rnr-threads"", ""sydneysiege-all-rnr-threads""]","[""98627870"", ""22021978"", ""459390022"", ""7587032""]",1,4,5
296310272,6,96.5,-0.2588505844275157,2036011.0,4,0.3333333333333333,"[""charliehebdo-all-rnr-threads"", ""sydneysiege-all-rnr-threads""]","[""17537467"", ""459390022"", ""16834659"", ""1920286333""]",2,4,6
1223839332,2,59.0,-0.21779537200927734,2025713.0,2,0.5,"[""charliehebdo-all-rnr-threads"", ""sydneysiege-all-rnr-threads""]","[""35466620"", ""459390022""]",1,1,2
16076032,7,126.57142857142857,-0.32924399205616545,6648740.0,59,0.0,"[""charliehebdo-all-rnr-threads"", ""ottawashooting-all-rnr-threads""]","[""1566336733"", ""245051131"", ""2408883295"", ""756445699"", ""16076032"", ""18005085"", ""2494335530"", ""803537880"", ""45243327"", ""393469195"", ""190280139"", ""18524109"", ""19346439"", ""20374262"", ""22253327"", ""80919423"", ""22328632"", ""14176926"", ""27996915"", ""727472528"", ""27618702"", ""43392266"", ""1939657772"", ""55186341"", ""209568851"", ""958324310"", ""1122715279"", ""468657693"", ""138781309"", ""526176904"", ""399478922"", ""169287046"", ""45916809"", ""2957163159"", ""80807165"", ""565539035"", ""19537801"", ""47036166"", ""377207363"", ""28560311"", ""1008666679"", ""355956690"", ""18590231"", ""464002910"", ""101557323"", ""157009365"", ""2414612677"", ""37481465"", ""20383"", ""194713944"", ""2565997189"", ""582086981"", ""15236305"", ""230474638"", ""56782850"", ""85535913"", ""1358771935"", ""255340030"", ""1131822504""]",0,7,7
14176926,5,103.6,-0.039315080642700194,6654090.0,1,0.0,"[""charliehebdo-all-rnr-threads"", ""ottawashooting-all-rnr-threads""]","[""16076032""]",0,5,5
22253327,4,113.25,-0.05167001485824585,12582654.0,4,0.0,"[""charliehebdo-all-rnr-threads"", ""ferguson-all-rnr-threads""]","[""53789862"", ""166710918"", ""270016438"", ""16076032""]",0,4,4
80807165,3,94.0,0.29616061846415204,1995189.0,9,0.0,"[""charliehebdo-all-rnr-threads"", ""sydneysiege-all-rnr-threads""]","[""154065130"", ""16076032"", ""1062927150"", ""80807165"", ""15686545"", ""2184439175"", ""263343389"", ""2910639596"", ""370328941""]",0,3,3
27618702,6,86.66666666666667,-0.08915297190348308,6601894.0,2,0.0,"[""charliehebdo-all-rnr-threads"", ""germanwings-crash-all-rnr-threads""]","[""134196350"", ""16076032""]",0,6,6
56782850,3,116.66666666666667,-0.1869312326113383,6626675.0,1,0.0,"[""charliehebdo-all-rnr-threads"", ""ottawashooting-all-rnr-threads""]","[""16076032""]",0,3,3
2653613168,2,117.5,0.3214010000228882,1995984.0,26,0.0,"[""charliehebdo-all-rnr-threads"", ""sydneysiege-all-rnr-threads""]","[""553928442"", ""2902287501"", ""2287426041"", ""418565055"", ""2795924584"", ""281519746"", ""1472233825"", ""343635218"", ""1119305256"", ""69795969"", ""89578891"", ""587140940"", ""31319544"", ""2445433106"", ""104653497"", ""310721799"", ""2739249944"", ""271297553"", ""2588158874"", ""2837193419"", ""2356127598"", ""517747314"", ""83243621"", ""21230017"", ""85535913"", ""161756251""]",0,2,2
281519746,14,111.14285714285714,-0.4389313203947885,7633001.0,5,0.07142857142857142,"[""charliehebdo-all-rnr-threads"", ""putinmissing-all-rnr-threads"", ""sydneysiege-all-rnr-threads""]","[""15438913"", ""2653613168"", ""16992416"", ""255753616"", ""374712154""]",1,13,14
553928442,5,93.8,-0.5690167188644409,8574059.0,4,0.0,"[""charliehebdo-all-rnr-threads"", ""germanwings-crash-all-rnr-threads"", ""sydneysiege-all-rnr-threads""]","[""208019751"", ""83638901"", ""16973333"", ""2653613168""]",0,5,5
2445433106,2,133.5,0.24415206909179688,1985775.0,1,0.0,"[""charliehebdo-all-rnr-threads"", ""sydneysiege-all-rnr-threads""]","[""2653613168""]",0,2,2
214558609,6,90.5,-0.4223526318868001,5654981.0,6,0.16666666666666666,"[""charliehebdo-all-rnr-threads"", ""putinmissing-all-rnr-threads""]","[""52003080"", ""483930658"", ""22369602"", ""24157295"", ""22662704"", ""228480162""]",1,5,6
2495955023,2,32.0,-0.0350877046585083,2032208.0,2,0.5,"[""charliehebdo-all-rnr-threads"", ""sydneysiege-all-rnr-threads""]","[""14401607"", ""5402612""]",1,1,2
2223435566,5,55.0,-0.03961539268493652,12721207.0,2,0.2,"[""charliehebdo-all-rnr-threads"", ""ferguson-all-rnr-threads""]","[""2396242676"", ""64643056""]",1,4,5
2342163477,7,92.14285714285714,-0.20013487339019775,2007873.0,2,0.0,"[""charliehebdo-all-rnr-threads"", ""sydneysiege-all-rnr-threads""]","[""973005421"", ""64643056""]",0,7,7
707502001,2,53.0,0.13922053575515747,6639368.0,2,0.5,"[""charliehebdo-all-rnr-threads"", ""ottawashooting-all-rnr-threads""]","[""25067168"", ""5402612""]",1,1,2
200468277,3,90.66666666666667,-0.4663297136624654,1997510.0,3,0.3333333333333333,"[""charliehebdo-all-rnr-threads"", ""sydneysiege-all-rnr-threads""]","[""64643056"", ""1125937411"", ""25067168""]",1,2,3
376679692,6,108.0,-0.1545732319355011,2020159.0,6,0.16666666666666666,"[""charliehebdo-all-rnr-threads"", ""sydneysiege-all-rnr-threads""]","[""16973333"", ""171802941"", ""7587032"", ""25067168"", ""37034483"", ""115378178""]",1,5,6
241643059,3,101.0,-0.6030696034431458,6709709.0,3,0.3333333333333333,"[""charliehebdo-all-rnr-threads"", ""ottawashooting-all-rnr-threads""]","[""33203801"", ""128364810"", ""5402612""]",1,2,3
1125937411,3,106.33333333333333,-0.16352397203445435,2005477.0,34,0.0,"[""charliehebdo-all-rnr-threads"", ""sydneysiege-all-rnr-threads""]","[""2705994475"", ""1656466868"", ""75001302"", ""225282844"", ""1317304904"", ""2715823845"", ""512920622"", ""178232832"", ""20975688"", ""709314217"", ""1263443612"", ""200468277"", ""244015944"", ""1125937411"", ""2916669926"", ""980594161"", ""1725610087"", ""743901649"", ""1734738025"", ""2584501496"", ""60722659"", ""2563918750"", ""2295239155"", ""1187074374"", ""314169551"", ""2554278218"", ""2400459716"", ""2894512415"", ""1883700643"", ""2458244786"", ""16237403"", ""27234309"", ""20874917"", ""228924029""]",0,3,3
14289960,7,92.85714285714286,-0.26566221032823834,12661785.0,4,0.14285714285714285,"[""charliehebdo-all-rnr-threads"", ""ferguson-all-rnr-threads""]","[""20548283"", ""1716581"", ""14849562"", ""16164636""]",1,6,7
19750998,9,87.44444444444444,-0.20601772599750096,2033843.0,5,0.7777777777777778,"[""charliehebdo-all-rnr-threads"", ""sydneysiege-all-rnr-threads""]","[""868112707"", ""7587032"", ""1020058453"", ""292777349"", ""1367531""]",7,2,9
287839361,2,112.5,-0.42106372117996216,12992255.0,2,0.0,"[""charliehebdo-all-rnr-threads"", ""ferguson-all-rnr-threads""]","[""216299334"", ""14090948""]",0,2,2
458861182,4,114.0,-0.1901167929172516,2001811.0,2,0.0,"[""charliehebdo-all-rnr-threads"", ""sydneysiege-all-rnr-threads""]","[""171802941"", ""216299334""]",0,4,4
117006605,2,128.5,-0.20476055145263672,2032290.0,2,0.5,"[""charliehebdo-all-rnr-threads"", ""sydneysiege-all-rnr-threads""]","[""243318995"", ""9609632""]",1,1,2
821700726,3,106.0,-0.3294389049212138,6561593.0,2,0.3333333333333333,"[""charliehebdo-all-rnr-threads"", ""germanwings-crash-all-rnr-threads""]","[""2280470022"", ""243318995""]",1,2,3
370274402,13,114.3076923076923,-0.2987654438385597,2156435.0,8,0.0,"[""charliehebdo-all-rnr-threads"", ""sydneysiege-all-rnr-threads""]","[""254873869"", ""106118793"", ""850302560"", ""18991263"", ""17001490"", ""1707427058"", ""18725815"", ""1571428436""]",0,13,13
326709238,6,123.5,-0.29405184586842853,8561968.0,4,0.0,"[""charliehebdo-all-rnr-threads"", ""germanwings-crash-all-rnr-threads"", ""sydneysiege-all-rnr-threads""]","[""2280470022"", ""22993014"", ""18991263"", ""20043786""]",0,6,6
2484423203,2,134.0,-0.5073121190071106,2003377.0,2,0.0,"[""charliehebdo-all-rnr-threads"", ""sydneysiege-all-rnr-threads""]","[""7587032"", ""14700117""]",0,2,2
243376460,4,79.0,-0.5723359435796738,1974364.0,3,0.0,"[""charliehebdo-all-rnr-threads"", ""sydneysiege-all-rnr-threads""]","[""268676434"", ""130557513"", ""14700117""]",0,4,4
493524550,3,84.66666666666667,-0.28624685605367023,6692304.0,3,0.3333333333333333,"[""charliehebdo-all-rnr-threads"", ""ottawashooting-all-rnr-threads""]","[""742143"", ""14700117"", ""249339016""]",1,2,3
546886420,4,84.0,0.1350257694721222,12521737.0,4,0.25,"[""charliehebdo-all-rnr-threads"", ""sydneysiege-all-rnr-threads"", ""ferguson-all-rnr-threads""]","[""14173315"", ""15727317"", ""18668407"", ""807095""]",1,3,4
55590022,3,128.0,-0.27001887559890747,12499123.0,2,0.6666666666666666,"[""charliehebdo-all-rnr-threads"", ""ferguson-all-rnr-threads""]","[""18668407"", ""62510409""]",2,1,3
27457454,9,135.88888888888889,-0.5026979512638516,8602840.0,7,0.1111111111111111,"[""charliehebdo-all-rnr-threads"", ""germanwings-crash-all-rnr-threads"", ""sydneysiege-all-rnr-threads""]","[""2417387923"", ""176044176"", ""2365877526"", ""27457454"", ""326078926"", ""1485225582"", ""291763454""]",1,8,9
291763454,14,119.78571428571429,-0.44412838561194284,2026586.0,4,0.2857142857142857,"[""charliehebdo-all-rnr-threads"", ""sydneysiege-all-rnr-threads""]","[""46078438"", ""330378192"", ""27457454"", ""282977213""]",4,10,14
23022488,3,87.66666666666667,-0.3863735993703206,2010102.0,2,0.0,"[""charliehebdo-all-rnr-threads"", ""sydneysiege-all-rnr-threads""]","[""15384969"", ""17027378""]",0,3,3
60296618,10,80.0,-0.2438895046710968,5690578.0,14,0.0,"[""charliehebdo-all-rnr-threads"", ""putinmissing-all-rnr-threads""]","[""213038249"", ""25662690"", ""502510877"", ""60296618"", ""98583506"", ""2952048011"", ""15170972"", ""32126019"", ""2261336599"", ""293607250"", ""36309919"", ""2608747130"", ""2862018075"", ""135862543""]",0,10,10
293607250,5,73.6,-0.0533797025680542,18359697.0,4,0.2,"[""charliehebdo-all-rnr-threads"", ""putinmissing-all-rnr-threads"", ""ferguson-all-rnr-threads""]","[""18725815"", ""42389136"", ""469509327"", ""60296618""]",1,4,5
254781783,4,82.25,0.08967407047748566,12713399.0,3,0.0,"[""charliehebdo-all-rnr-threads"", ""ferguson-all-rnr-threads""]","[""1609475190"", ""558040899"", ""18839937""]",0,4,4
137832626,5,109.4,0.09167134761810303,12688533.0,4,0.2,"[""charliehebdo-all-rnr-threads"", ""ferguson-all-rnr-threads""]","[""14940354"", ""341908197"", ""50192480"", ""558040899""]",1,4,5
2882743727,2,97.5,-0.00724339485168457,5582516.0,2,0.0,"[""charliehebdo-all-rnr-threads"", ""putinmissing-all-rnr-threads""]","[""8628872"", ""49444292""]",0,2,2
2262932935,3,90.66666666666667,-0.45030858119328815,2023344.0,2,0.0,"[""charliehebdo-all-rnr-threads"", ""sydneysiege-all-rnr-threads""]","[""501768982"", ""238575113""]",0,3,3
258796139,7,96.28571428571429,-0.2500591959272112,2041894.0,3,0.0,"[""charliehebdo-all-rnr-threads"", ""sydneysiege-all-rnr-threads""]","[""501768982"", ""204832963"", ""7401202""]",0,7,7
2787148060,2,87.0,-0.6924813091754913,1981973.0,2,0.0,"[""charliehebdo-all-rnr-threads"", ""sydneysiege-all-rnr-threads""]","[""64643056"", ""308167013""]",0,2,2
2827604185,2,51.5,-0.26190251111984253,1984301.0,2,0.0,"[""charliehebdo-all-rnr-threads"", ""sydneysiege-all-rnr-threads""]","[""15438913"", ""16973333""]",0,2,2
23183433,3,133.66666666666666,-0.22361000378926596,6713666.0,2,0.6666666666666666,"[""charliehebdo-all-rnr-threads"", ""germanwings-crash-all-rnr-threads""]","[""15438913"", ""227837742""]",2,1,3
47685065,8,119.875,-0.10975433886051178,2154098.0,75,0.0,"[""charliehebdo-all-rnr-threads"", ""sydneysiege-all-rnr-threads""]","[""276043952"", ""113678124"", ""41247756"", ""85330589"", ""2871280115"", ""323839489"", ""38800236"", ""6214122"", ""2418740916"", ""295847373"", ""18354816"", ""2275520856"", ""175631899"", ""2859126792"", ""2725851052"", ""2242637850"", ""81043372"", ""143776014"", ""44556006"", ""139897603"", ""189224604"", ""584820979"", ""745248356"", ""1052284369"", ""237189499"", ""47685065"", ""557908357"", ""955139328"", ""90125010"", ""2158541653"", ""83182871"", ""2675168874"", ""75991116"", ""2635682959"", ""101494499"", ""1531465705"", ""2555326832"", ""2416973881"", ""2311734613"", ""331220914"", ""15804695"", ""19929890"", ""1141823460"", ""1553810046"", ""2410765508"", ""75816710"", ""20779881"", ""42867573"", ""54182995"", ""43568964"", ""978983136"", ""40044280"", ""525374261"", ""303859364"", ""1159817204"", ""2439543374"", ""2692604376"", ""121812371"", ""2504552041"", ""174630116"", ""2885631924"", ""256387480"", ""120350623"", ""93349233"", ""103511363"", ""2788642796"", ""404469799"", ""57906766"", ""117477749"", ""20142079"", ""476085146"", ""296313827"", ""158418172"", ""1614088758"", ""1454387251""]",0,8,8
85330589,4,76.25,0.24902743101119995,2067205.0,2,0.0,"[""charliehebdo-all-rnr-threads"", ""sydneysiege-all-rnr-threads""]","[""162304163"", ""47685065""]",0,4,4
16418210,2,52.0,-0.4509337544441223,6641800.0,2,0.0,"[""charliehebdo-all-rnr-threads"", ""ottawashooting-all-rnr-threads""]","[""239885144"", ""164075542""]",0,2,2
2586370488,2,114.5,-0.3022090494632721,2011653.0,2,0.5,"[""charliehebdo-all-rnr-threads"", ""sydneysiege-all-rnr-threads""]","[""239885144"", ""3108351""]",1,1,2
158399728,9,108.88888888888889,-0.15490758419036865,2001964.0,4,0.0,"[""charliehebdo-all-rnr-threads"", ""sydneysiege-all-rnr-threads""]","[""15638836"", ""38800236"", ""67725191"", ""156464691""]",0,9,9
961721755,8,90.5,-0.29840172827243805,2012969.0,6,0.0,"[""charliehebdo-all-rnr-threads"", ""sydneysiege-all-rnr-threads""]","[""532779460"", ""60022825"", ""38800236"", ""807095"", ""210951599"", ""153029181""]",0,8,8
50348344,4,129.0,0.016407251358032227,6818609.0,42,0.25,"[""charliehebdo-all-rnr-threads"", ""ottawashooting-all-rnr-threads""]","[""937769684"", ""1030435626"", ""2775294528"", ""34052333"", ""2198540330"", ""538365635"", ""21037606"", ""2589988879"", ""2903815397"", ""578756547"", ""185413809"", ""46981622"", ""2545441463"", ""27222101"", ""1048317972"", ""118737912"", ""178482866"", ""48304732"", ""47940350"", ""2891832976"", ""2503300711"", ""62591883"", ""469699513"", ""2322220906"", ""440462707"", ""602517144"", ""1400619084"", ""1667791363"", ""1498709924"", ""253131945"", ""469360443"", ""1687360158"", ""1728874453"", ""195787317"", ""2915138085"", ""55459259"", ""601342130"", ""17536326"", ""1348798826"", ""2814170438"", ""775882430"", ""223252981""]",1,3,4
55459259,3,131.66666666666666,-0.46739184856414795,2041357.0,2,0.0,"[""charliehebdo-all-rnr-threads"", ""sydneysiege-all-rnr-threads""]","[""50348344"", ""5402612""]",0,3,3
70467062,15,96.73333333333333,-0.12540379365285237,6567512.0,14,0.06666666666666667,"[""charliehebdo-all-rnr-threads"", ""germanwings-crash-all-rnr-threads""]","[""2819548282"", ""2176696315"", ""76436317"", ""2706148363"", ""388913872"", ""70467062"", ""257867744"", ""556883798"", ""436562022"", ""23417900"", ""1747392930"", ""551551599"", ""68522976"", ""5402612""]",1,14,15
68522976,2,77.5,-0.43941059708595276,12535994.0,2,0.0,"[""charliehebdo-all-rnr-threads"", ""ferguson-all-rnr-threads""]","[""70467062"", ""18839937""]",0,2,2
18725815,15,127.2,-0.2597852389017741,2155380.0,238,0.0,"[""charliehebdo-all-rnr-threads"", ""sydneysiege-all-rnr-threads""]","[""51275514"", ""2913327052"", ""2965990305"", ""2615725926"", ""247201827"", ""2525375252"", ""36324328"", ""305502995"", ""247450172"", ""977478433"", ""2299543717"", ""2501782988"", ""517958898"", ""7792422"", ""2974533261"", ""272840279"", ""17716644"", ""163945249"", ""264265349"", ""109343861"", ""75998366"", ""213274467"", ""21393709"", ""385594044"", ""295747220"", ""2514607890"", ""247347135"", ""370274402"", ""1709566308"", ""189118361"", ""507069125"", ""141154921"", ""2877276800"", ""95259631"", ""14175549"", ""2597423726"", ""30460070"", ""1907822911"", ""135311576"", ""99270811"", ""17142198"", ""99579745"", ""14080276"", ""19100952"", ""1897925491"", ""387374561"", ""2540509984"", ""716780887"", ""279085211"", ""370546854"", ""538778348"", ""133259022"", ""2178954146"", ""39498918"", ""1927008186"", ""160336748"", ""385074221"", ""23293888"", ""96977991"", ""149013351"", ""114924199"", ""150169728"", ""2904755323"", ""2409641642"", ""2842490650"", ""21835613"", ""52416173"", ""2858149972"", ""115581228"", ""429723559"", ""27354714"", ""224682566"", ""810085802"", ""725732780"", ""347883924"", ""18225367"", ""130586534"", ""531251164"", ""19763467"", ""922175335"", ""760168682"", ""422218367"", ""1618479049"", ""2720062883"", ""1583402005"", ""191914187"", ""199280280"", ""193274832"", ""114259115"", ""83191707"", ""227090737"", ""333839652"", ""20889358"", ""70650435"", ""1037286848"", ""46947026"", ""236960559"", ""50377802"", ""155943481"", ""2579332213"", ""264122287"", ""1337280985"", ""348606060"", ""407407474"", ""273392087"", ""239712408"", ""48509278"", ""36746467"", ""159612424"", ""150837442"", ""432759514"", ""284280195"", ""237315661"", ""2909686726"", ""1180458038"", ""2886856798"", ""14728168"", ""156933739"", ""103790302"", ""1240917696"", ""392983771"", ""1248104778"", ""476845869"", ""1408458926"", ""39571559"", ""1431997220"", ""20800815"", ""512553999"", ""2220373100"", ""339145127"", ""2494237140"", ""1705451886"", ""17707818"", ""2320417898"", ""31795193"", ""2274592754"", ""517439535"", ""78272041"", ""478289711"", ""15748665"", ""108952576"", ""526374978"", ""799425312"", ""2753304958"", ""236003398"", ""915728082"", ""772198776"", ""12685132"", ""92574363"", ""2666979582"", ""484240369"", ""830556926"", ""222168247"", ""215531706"", ""2739917592"", ""618561429"", ""782143255"", ""26496329"", ""39239833"", ""402995375"", ""52137117"", ""14453026"", ""274132729"", ""51130160"", ""1104507710"", ""136564617"", ""361327685"", ""250603308"", ""853722031"", ""1377528656"", ""2781545674"", ""2647259070"", ""220537847"", ""70435237"", ""395149726"", ""89929611"", ""2841200446"", ""932284093"", ""260794032"", ""30371073"", ""234339579"", ""245969745"", ""2458476536"", ""910485127"", ""14145498"", ""567654810"", ""191828335"", ""107059113"", ""33622115"", ""328668326"", ""844001984"", ""627947363"", ""36157190"", ""235520398"", ""44596531"", ""53091127"", ""745248356"", ""20976118"", ""2799355045"", ""349548603"", ""237582505"", ""18019990"", ""18725815"", ""222244723"", ""378724296"", ""225796683"", ""25180014"", ""350166250"", ""631582614"", ""231151512"", ""334189069"", ""70914003"", ""2559436158"", ""362118201"", ""2718811747"", ""376396367"", ""243094509"", ""20494522"", ""2849046734"", ""56702221"", ""182739385"", ""67210156"", ""1680832226"", ""284202434"", ""2911985528"", ""1848242569"", ""261612663"", ""233903699"", ""140482977"", ""2853619810"", ""1335141763"", ""2578754645"", ""2316328753"", ""557111376"", ""8669812"", ""293607250"", ""2026561"", ""514456333""]",0,15,15
2316328753,2,63.0,-0.3275926113128662,12914672.0,2,0.0,"[""charliehebdo-all-rnr-threads"", ""ferguson-all-rnr-threads""]","[""18725815"", ""119972954""]",0,2,2
20301302,8,73.0,-0.3352951854467392,2005074.0,6,0.375,"[""charliehebdo-all-rnr-threads"", ""sydneysiege-all-rnr-threads""]","[""299416026"", ""17537467"", ""21439144"", ""419520517"", ""153029181"", ""5402612""]",3,5,8
1343988523,2,137.0,0.2183927297592163,2095737.0,2,0.0,"[""charliehebdo-all-rnr-threads"", ""sydneysiege-all-rnr-threads""]","[""742143"", ""1851229334""]",0,2,2
19498310,4,61.0,-0.40628400444984436,2205260.0,4,0.25,"[""charliehebdo-all-rnr-threads"", ""sydneysiege-all-rnr-threads""]","[""14138785"", ""154485832"", ""7587032"", ""14569869""]",1,3,4
282438174,5,97.6,-0.18129310607910157,6803008.0,2,0.8,"[""charliehebdo-all-rnr-threads"", ""germanwings-crash-all-rnr-threads""]","[""154485832"", ""91493488""]",4,1,5
824424446,37,98.43243243243244,-0.2586648222562428,12962471.0,2,0.0,"[""charliehebdo-all-rnr-threads"", ""ferguson-all-rnr-threads""]","[""124227622"", ""174253648""]",0,37,37
100366853,4,96.0,-0.6170318722724915,2075001.0,4,0.0,"[""charliehebdo-all-rnr-threads"", ""sydneysiege-all-rnr-threads""]","[""44835347"", ""69181624"", ""374712154"", ""807095""]",0,4,4
187579804,5,89.4,-0.09861967563629151,2141346.0,4,0.2,"[""charliehebdo-all-rnr-threads"", ""sydneysiege-all-rnr-threads""]","[""85794542"", ""1367531"", ""342894187"", ""374712154""]",1,4,5
130557513,2,125.0,-0.4707574248313904,1988901.0,22,0.0,"[""charliehebdo-all-rnr-threads"", ""sydneysiege-all-rnr-threads""]","[""52416173"", ""70902287"", ""19364252"", ""2896291439"", ""98692548"", ""303170999"", ""245915556"", ""461488164"", ""1605914786"", ""38140085"", ""32241438"", ""2836403190"", ""243376460"", ""2184245491"", ""1229628884"", ""107027590"", ""1685696882"", ""93881144"", ""809982102"", ""310919044"", ""2457522827"", ""2187880722""]",0,2,2
52416173,4,71.5,-0.3315812200307846,1985914.0,3,0.0,"[""charliehebdo-all-rnr-threads"", ""sydneysiege-all-rnr-threads""]","[""18725815"", ""47448886"", ""130557513""]",0,4,4
225235528,15,98.6,-0.12869919141133626,12546504.0,85,0.26666666666666666,"[""charliehebdo-all-rnr-threads"", ""ferguson-all-rnr-threads""]","[""31528766"", ""280939062"", ""935015863"", ""291773946"", ""2554712246"", ""26302594"", ""27160406"", ""361902109"", ""372142108"", ""385195352"", ""1663314774"", ""2724657035"", ""61784324"", ""632700617"", ""224963680"", ""30319431"", ""5526652"", ""448854398"", ""593937264"", ""1489502042"", ""57474545"", ""2351052529"", ""785949679"", ""43984827"", ""1497962821"", ""39505730"", ""17054538"", ""60165404"", ""250362526"", ""357190487"", ""1053271752"", ""1361446477"", ""382615996"", ""420351613"", ""1345535262"", ""993899600"", ""2305596727"", ""126729179"", ""2414457033"", ""267413786"", ""277489977"", ""270388229"", ""1296110076"", ""2651878783"", ""113637226"", ""28596215"", ""275331952"", ""357069362"", ""2449460526"", ""60701902"", ""1047975170"", ""278598136"", ""389162304"", ""601342849"", ""315626133"", ""19315022"", ""898951392"", ""438674656"", ""1090999268"", ""245688940"", ""94484968"", ""174656818"", ""24639297"", ""2606130408"", ""356231770"", ""395984384"", ""536111589"", ""382209977"", ""2743172967"", ""246909484"", ""2183072912"", ""1902604117"", ""30131354"", ""372007380"", ""14793837"", ""498766399"", ""1317650570"", ""33924719"", ""423937628"", ""2560298892"", ""2320412192"", ""225235528"", ""240706344"", ""20058608"", ""2434854721""]",4,11,15
60165404,9,61.44444444444444,-0.02047876516977946,12670277.0,6,0.0,"[""charliehebdo-all-rnr-threads"", ""ferguson-all-rnr-threads""]","[""16807528"", ""16589206"", ""646483"", ""225235528"", ""134293369"", ""338968305""]",0,9,9
280939062,2,102.5,-0.30218183994293213,12669492.0,2,0.0,"[""charliehebdo-all-rnr-threads"", ""ferguson-all-rnr-threads""]","[""225235528"", ""14090948""]",0,2,2
210751927,3,39.666666666666664,0.22917461395263672,1993241.0,2,0.3333333333333333,"[""charliehebdo-all-rnr-threads"", ""sydneysiege-all-rnr-threads""]","[""568143078"", ""16675569""]",1,2,3
199738451,19,119.26315789473684,-0.4700936235879597,2211314.0,8,0.15789473684210525,"[""charliehebdo-all-rnr-threads"", ""sydneysiege-all-rnr-threads""]","[""17995040"", ""117366399"", ""362144301"", ""22021978"", ""46078438"", ""16681111"", ""31135856"", ""13496142""]",3,16,19
2457522827,3,88.0,-0.5635142723719279,2067875.0,3,0.0,"[""charliehebdo-all-rnr-threads"", ""sydneysiege-all-rnr-threads""]","[""140955302"", ""16343974"", ""130557513""]",0,3,3
235887538,2,140.0,-0.2914443016052246,6641062.0,2,0.5,"[""charliehebdo-all-rnr-threads"", ""ottawashooting-all-rnr-threads""]","[""16343974"", ""18643437""]",1,1,2
87081989,3,71.33333333333333,-0.1011737585067749,12661917.0,3,0.0,"[""charliehebdo-all-rnr-threads"", ""sydneysiege-all-rnr-threads"", ""ferguson-all-rnr-threads""]","[""16343974"", ""33092289"", ""65045121""]",0,3,3
1309728793,11,104.0909090909091,-0.3982515118338845,6648645.0,3,0.09090909090909091,"[""charliehebdo-all-rnr-threads"", ""ottawashooting-all-rnr-threads"", ""sydneysiege-all-rnr-threads""]","[""16343974"", ""7744592"", ""1263002017""]",1,10,11
305482111,2,81.5,-0.22506040334701538,2004766.0,2,0.0,"[""charliehebdo-all-rnr-threads"", ""sydneysiege-all-rnr-threads""]","[""27581606"", ""21749564""]",0,2,2
106857789,2,64.0,0.5041757822036743,1997325.0,2,0.0,"[""charliehebdo-all-rnr-threads"", ""sydneysiege-all-rnr-threads""]","[""15374755"", ""1707427058""]",0,2,2
1931711646,40,95.12499999999999,-0.3984503328800202,2129198.0,14,0.25,"[""charliehebdo-all-rnr-threads"", ""sydneysiege-all-rnr-threads""]","[""1960878613"", ""55186601"", ""2566535282"", ""282977213"", ""373783051"", ""3108351"", ""78586909"", ""1707427058"", ""64643056"", ""34713362"", ""16675569"", ""87818409"", ""16031927"", ""5402612""]",10,30,40
37891446,7,109.71428571428571,-0.4826083353587559,2020526.0,4,0.7142857142857143,"[""charliehebdo-all-rnr-threads"", ""sydneysiege-all-rnr-threads""]","[""14940354"", ""278067201"", ""469509327"", ""5402612""]",5,2,7
2858679020,7,121.57142857142857,-0.4456272465842111,6738600.0,4,0.2857142857142857,"[""charliehebdo-all-rnr-threads"", ""germanwings-crash-all-rnr-threads""]","[""2566535282"", ""15438913"", ""952112047"", ""7702542""]",2,5,7
236960559,2,103.5,-0.5759470462799072,12488013.0,2,0.0,"[""charliehebdo-all-rnr-threads"", ""ferguson-all-rnr-threads""]","[""26898420"", ""18725815""]",0,2,2
39498918,4,86.5,-0.4060186743736267,2199821.0,4,0.25,"[""charliehebdo-all-rnr-threads"", ""sydneysiege-all-rnr-threads""]","[""37034483"", ""18725815"", ""1652541"", ""331658004""]",1,3,4
844001984,4,99.0,0.06661486625671387,12694047.0,3,0.0,"[""charliehebdo-all-rnr-threads"", ""ferguson-all-rnr-threads""]","[""18725815"", ""282695161"", ""14849562""]",0,4,4
428140124,7,113.0,-0.45261188064302715,6563645.0,21,0.0,"[""charliehebdo-all-rnr-threads"", ""germanwings-crash-all-rnr-threads""]","[""2445142442"", ""286801248"", ""189053479"", ""68739243"", ""19513802"", ""428140124"", ""923296063"", ""2459278543"", ""54722214"", ""413157362"", ""2927507078"", ""2479491865"", ""160336594"", ""551551599"", ""293420884"", ""57608133"", ""2496042468"", ""2944067770"", ""418854161"", ""453406012"", ""95084881""]",0,7,7
2927507078,10,106.5,-0.6583149015903473,2122495.0,4,0.1,"[""charliehebdo-all-rnr-threads"", ""sydneysiege-all-rnr-threads""]","[""254873869"", ""2622553496"", ""7587032"", ""428140124""]",1,9,10
2445142442,2,52.5,-0.5860947370529175,6562547.0,1,0.0,"[""charliehebdo-all-rnr-threads"", ""germanwings-crash-all-rnr-threads""]","[""428140124""]",0,2,2
453406012,4,128.5,-0.22033360600471497,2035804.0,2,0.0,"[""charliehebdo-all-rnr-threads"", ""sydneysiege-all-rnr-threads""]","[""16930489"", ""428140124""]",0,4,4
531134841,4,50.75,-0.4908644109964371,1983777.0,4,0.5,"[""charliehebdo-all-rnr-threads"", ""sydneysiege-all-rnr-threads""]","[""3108351"", ""87818409"", ""51241574"", ""5402612""]",2,2,4
14700316,3,140.66666666666666,-0.5881553888320923,12665844.0,49,0.0,"[""charliehebdo-all-rnr-threads"", ""ferguson-all-rnr-threads""]","[""1538543972"", ""21531242"", ""2458807652"", ""237499005"", ""161873862"", ""594976909"", ""2739611487"", ""902528816"", ""847258784"", ""237606548"", ""328661674"", ""587491046"", ""38385875"", ""813682543"", ""67706546"", ""535977623"", ""2888296032"", ""154624343"", ""1302169776"", ""19808025"", ""45647641"", ""2464502209"", ""531598198"", ""559929936"", ""2629489590"", ""404460410"", ""42158226"", ""443090370"", ""614111783"", ""205988930"", ""84621880"", ""2204606340"", ""55794552"", ""207197069"", ""11553932"", ""14700316"", ""75146395"", ""51001871"", ""1396855940"", ""2491244870"", ""2601228332"", ""111294798"", ""2418677218"", ""134951801"", ""1474332679"", ""105973829"", ""157172690"", ""96823343"", ""1362124872""]",0,3,3
361327685,2,104.0,-0.2816965579986572,7492266.0,2,0.5,"[""charliehebdo-all-rnr-threads"", ""ebola-essien-all-rnr-threads""]","[""18725815"", ""1262229906""]",1,1,2
21393709,6,112.5,-0.4847139318784078,1996390.0,2,0.8333333333333334,"[""charliehebdo-all-rnr-threads"", ""sydneysiege-all-rnr-threads""]","[""18725815"", ""5402612""]",5,1,6
52137117,4,65.0,-0.2871631383895874,12665238.0,3,0.0,"[""charliehebdo-all-rnr-threads"", ""ferguson-all-rnr-threads""]","[""18725815"", ""97327765"", ""14090948""]",0,4,4
20494522,24,125.79166666666667,-0.20386593540509543,6781929.0,3,0.0,"[""charliehebdo-all-rnr-threads"", ""germanwings-crash-all-rnr-threads""]","[""18725815"", ""15164565"", ""14095052""]",0,24,24
70650435,19,110.57894736842105,-0.26533327604594986,1997992.0,5,0.15789473684210525,"[""charliehebdo-all-rnr-threads"", ""sydneysiege-all-rnr-threads""]","[""635608354"", ""16973333"", ""7587032"", ""18725815"", ""409941587""]",3,16,19
50377802,5,96.6,-0.23064855337142945,6645728.0,3,0.6,"[""charliehebdo-all-rnr-threads"", ""ottawashooting-all-rnr-threads""]","[""18725815"", ""19899606"", ""5402612""]",3,2,5
347883924,23,80.69565217391305,-0.20120567083358765,2247913.0,10,0.391304347826087,"[""charliehebdo-all-rnr-threads"", ""sydneysiege-all-rnr-threads""]","[""475492463"", ""156464691"", ""269167743"", ""171802941"", ""742143"", ""37881687"", ""18725815"", ""16675569"", ""258627226"", ""5402612""]",9,14,23
30131354,6,136.83333333333334,-0.4656675457954407,12914013.0,4,0.0,"[""charliehebdo-all-rnr-threads"", ""ferguson-all-rnr-threads""]","[""225235528"", ""46549541"", ""21368060"", ""14090948""]",0,6,6
2436705422,8,58.75,-0.09732525050640106,2080909.0,5,0.0,"[""charliehebdo-all-rnr-threads"", ""sydneysiege-all-rnr-threads""]","[""28695097"", ""323188665"", ""107210124"", ""397756361"", ""19346439""]",0,8,8
159624465,6,119.66666666666667,-0.5261967877546946,2026385.0,3,0.0,"[""charliehebdo-all-rnr-threads"", ""sydneysiege-all-rnr-threads""]","[""22021978"", ""107210124"", ""17537467""]",0,6,6
11314672,3,71.0,-0.1080785592397054,6635015.0,3,0.0,"[""charliehebdo-all-rnr-threads"", ""ottawashooting-all-rnr-threads""]","[""323188665"", ""107210124"", ""96104822""]",0,3,3
1059686779,4,84.75,0.06653445959091187,1997009.0,3,0.0,"[""charliehebdo-all-rnr-threads"", ""sydneysiege-all-rnr-threads""]","[""16973333"", ""107210124"", ""2768501""]",0,4,4
123949508,4,117.0,-0.1629677414894104,2011152.0,4,0.25,"[""charliehebdo-all-rnr-threads"", ""sydneysiege-all-rnr-threads""]","[""2799960092"", ""742143"", ""107210124"", ""39682124""]",1,3,4
2560935911,2,96.5,-0.3873246908187866,2001630.0,2,0.5,"[""charliehebdo-all-rnr-threads"", ""sydneysiege-all-rnr-threads""]","[""7587032"", ""107210124""]",1,1,2
2270819084,3,104.66666666666667,-0.13365737597147623,6633578.0,3,0.0,"[""charliehebdo-all-rnr-threads"", ""ottawashooting-all-rnr-threads"", ""sydneysiege-all-rnr-threads""]","[""20646711"", ""491960101"", ""23937894""]",0,3,3
17679507,7,71.28571428571429,-0.23545316287449428,8742238.0,5,0.5714285714285714,"[""charliehebdo-all-rnr-threads"", ""germanwings-crash-all-rnr-threads"", ""sydneysiege-all-rnr-threads""]","[""2566535282"", ""20646711"", ""6017542"", ""47992292"", ""1367531""]",4,3,7
2906297560,10,106.6,-0.5650337696075439,2052227.0,4,0.7,"[""charliehebdo-all-rnr-threads"", ""sydneysiege-all-rnr-threads""]","[""1960878613"", ""20646711"", ""1626294277"", ""2886154223""]",7,3,10
1502836238,10,97.6,-0.30583308935165404,12705257.0,2,0.0,"[""charliehebdo-all-rnr-threads"", ""ferguson-all-rnr-threads""]","[""20646711"", ""500275955""]",0,10,10
14914091,3,88.0,-0.5741729140281677,2038741.0,2,0.0,"[""charliehebdo-all-rnr-threads"", ""sydneysiege-all-rnr-threads""]","[""20646711"", ""17641218""]",0,3,3
110992398,4,137.75,-0.28609442710876465,2185063.0,3,0.0,"[""charliehebdo-all-rnr-threads"", ""sydneysiege-all-rnr-threads""]","[""69231187"", ""20646711"", ""742143""]",0,4,4
23238058,2,134.5,-0.6803240776062012,6548991.0,2,0.5,"[""charliehebdo-all-rnr-threads"", ""germanwings-crash-all-rnr-threads""]","[""2280470022"", ""20646711""]",1,1,2
48956231,4,94.75,-0.33297018706798553,2033254.0,44,0.75,"[""charliehebdo-all-rnr-threads"", ""sydneysiege-all-rnr-threads""]","[""22245277"", ""16072089"", ""2743496378"", ""256442158"", ""2887625816"", ""2873267413"", ""66352632"", ""39029722"", ""2938916683"", ""33178654"", ""2371403035"", ""314668323"", ""132198476"", ""2866349829"", ""208072082"", ""2800151052"", ""2868144805"", ""69387069"", ""248006420"", ""590192372"", ""956048851"", ""524566798"", ""35094059"", ""65753323"", ""2168956690"", ""972994254"", ""161863994"", ""909990571"", ""2869304847"", ""255099948"", ""2892242946"", ""1271553738"", ""400642039"", ""10799642"", ""19145560"", ""708176525"", ""2541580063"", ""2380429972"", ""246904991"", ""151551726"", ""715116854"", ""1039158866"", ""2479104178"", ""206155823""]",3,1,4
19145560,2,50.0,-0.11294209957122803,6547697.0,2,0.0,"[""charliehebdo-all-rnr-threads"", ""germanwings-crash-all-rnr-threads""]","[""48956231"", ""92771309""]",0,2,2
2883921829,5,109.6,-0.12763829231262208,5681897.0,3,0.0,"[""charliehebdo-all-rnr-threads"", ""putinmissing-all-rnr-threads""]","[""459310999"", ""22021978"", ""2435652986""]",0,5,5
1226575850,6,86.16666666666667,0.02909258008003235,12586571.0,4,0.16666666666666666,"[""charliehebdo-all-rnr-threads"", ""sydneysiege-all-rnr-threads"", ""ferguson-all-rnr-threads""]","[""3108351"", ""47448886"", ""10168082"", ""5402612""]",1,5,6
17692894,6,53.0,-0.6517193615436554,6570920.0,2,0.0,"[""charliehebdo-all-rnr-threads"", ""germanwings-crash-all-rnr-threads""]","[""380648579"", ""47448886""]",0,6,6
274132729,3,102.33333333333333,-0.16217851638793945,2014687.0,2,0.0,"[""charliehebdo-all-rnr-threads"", ""sydneysiege-all-rnr-threads""]","[""254873869"", ""18725815""]",0,3,3
264265349,4,83.0,-0.1200665831565857,6812587.0,4,0.25,"[""charliehebdo-all-rnr-threads"", ""ottawashooting-all-rnr-threads"", ""sydneysiege-all-rnr-threads""]","[""18725815"", ""952112047"", ""156464691"", ""82120358""]",1,3,4
43521065,10,127.8,-0.3393986105918884,8764653.0,7,0.5,"[""charliehebdo-all-rnr-threads"", ""germanwings-crash-all-rnr-threads"", ""sydneysiege-all-rnr-threads""]","[""14173315"", ""19317766"", ""1652541"", ""5402612"", ""15754281"", ""18553134"", ""428333""]",5,5,10
26810243,2,102.0,-0.6628059446811676,6637969.0,2,0.5,"[""charliehebdo-all-rnr-threads"", ""ottawashooting-all-rnr-threads""]","[""23937894"", ""428333""]",1,1,2
28086543,2,39.5,-0.5085896849632263,6609727.0,2,0.5,"[""charliehebdo-all-rnr-threads"", ""ottawashooting-all-rnr-threads""]","[""4970411"", ""954124423""]",1,1,2
269016791,5,65.2,-0.12810990810394288,12528986.0,4,0.2,"[""charliehebdo-all-rnr-threads"", ""ferguson-all-rnr-threads""]","[""254873869"", ""759251"", ""15557246"", ""25545470""]",1,4,5
2705994475,26,115.42307692307692,-0.2762368206794445,2162027.0,3,0.0,"[""charliehebdo-all-rnr-threads"", ""sydneysiege-all-rnr-threads""]","[""487600344"", ""1125937411"", ""403576718""]",0,26,26
15871190,2,98.0,-0.4616471529006958,12952865.0,2,0.0,"[""charliehebdo-all-rnr-threads"", ""ferguson-all-rnr-threads""]","[""403576718"", ""23831448""]",0,2,2
2385557324,3,93.66666666666667,-0.3216158946355184,2049063.0,3,0.3333333333333333,"[""charliehebdo-all-rnr-threads"", ""sydneysiege-all-rnr-threads""]","[""1562935142"", ""403576718"", ""14401607""]",1,2,3
67725191,2,131.5,-0.48516273498535156,1998186.0,25,0.0,"[""charliehebdo-all-rnr-threads"", ""sydneysiege-all-rnr-threads""]","[""1135432609"", ""91390494"", ""308950864"", ""2442810144"", ""2941563823"", ""1413627246"", ""1245175111"", ""331379045"", ""79707957"", ""47674279"", ""472994730"", ""49014286"", ""1396940936"", ""243321303"", ""223248683"", ""1257222925"", ""358098938"", ""2894863445"", ""158399728"", ""7076492"", ""265653847"", ""339473885"", ""1283848771"", ""36909693"", ""503071630""]",0,2,2
521489078,2,38.5,-0.01475900411605835,2301320.0,2,0.5,"[""charliehebdo-all-rnr-threads"", ""sydneysiege-all-rnr-threads""]","[""14173315"", ""143145579""]",1,1,2
150881077,3,129.66666666666666,-0.36074352264404297,2034740.0,3,0.3333333333333333,"[""charliehebdo-all-rnr-threads"", ""sydneysiege-all-rnr-threads""]","[""352036858"", ""224682566"", ""115393565""]",1,2,3
2875917137,7,85.0,-0.2585112622806004,2136781.0,4,0.2857142857142857,"[""charliehebdo-all-rnr-threads"", ""sydneysiege-all-rnr-threads""]","[""46078438"", ""1630896181"", ""2799960092"", ""224682566""]",2,5,7
51670985,3,84.33333333333333,0.18450361490249634,2010027.0,2,0.0,"[""charliehebdo-all-rnr-threads"", ""sydneysiege-all-rnr-threads""]","[""14173315"", ""224682566""]",0,3,3
115393565,3,125.66666666666667,-0.3058931827545166,2032725.0,21,0.6666666666666666,"[""charliehebdo-all-rnr-threads"", ""sydneysiege-all-rnr-threads""]","[""307971624"", ""77695588"", ""52990482"", ""35343837"", ""443374955"", ""22659990"", ""277747585"", ""354004878"", ""115393565"", ""2235111"", ""2429036059"", ""150881077"", ""17699381"", ""121789732"", ""2816670832"", ""1656622657"", ""80280391"", ""6361512"", ""266577415"", ""588375765"", ""2149505432""]",2,1,3
50221275,2,85.0,-0.304423063993454,1975382.0,1,0.0,"[""charliehebdo-all-rnr-threads"", ""sydneysiege-all-rnr-threads""]","[""254873869""]",0,2,2
2256516282,4,94.5,-0.3204824775457382,12666165.0,4,0.0,"[""charliehebdo-all-rnr-threads"", ""ferguson-all-rnr-threads""]","[""183341278"", ""15754281"", ""279390084"", ""133081159""]",0,4,4
2607703608,10,123.7,-0.4661344766616821,6822212.0,8,0.3,"[""charliehebdo-all-rnr-threads"", ""ottawashooting-all-rnr-threads""]","[""1562935142"", ""483930658"", ""7589572"", ""15108702"", ""2097571"", ""83795099"", ""69329527"", ""78706973""]",3,7,10
431590274,4,59.5,-0.25681161880493164,2000711.0,4,0.5,"[""charliehebdo-all-rnr-threads"", ""sydneysiege-all-rnr-threads""]","[""483930658"", ""19899606"", ""1652541"", ""87416722""]",2,2,4
74214410,16,106.5625,-0.15509849041700363,12757952.0,9,0.125,"[""charliehebdo-all-rnr-threads"", ""ferguson-all-rnr-threads""]","[""10102272"", ""37255058"", ""2736449935"", ""159210283"", ""14849562"", ""14090948"", ""2725579568"", ""21728303"", ""16164636""]",2,14,16
2308597885,7,100.57142857142857,-0.24063928638185775,1998254.0,3,0.0,"[""charliehebdo-all-rnr-threads"", ""sydneysiege-all-rnr-threads""]","[""286886892"", ""125753608"", ""87818409""]",0,7,7
17672825,3,121.66666666666667,-0.08407052357991536,2076155.0,36,0.0,"[""charliehebdo-all-rnr-threads"", ""sydneysiege-all-rnr-threads""]","[""2339294652"", ""159447476"", ""376933255"", ""36611990"", ""52035963"", ""773190774"", ""631125417"", ""472444729"", ""2475744649"", ""377912738"", ""20203344"", ""600151080"", ""453392594"", ""2798235864"", ""156816620"", ""2263896333"", ""14594816"", ""192100759"", ""9630322"", ""35576250"", ""79802631"", ""173516546"", ""170011616"", ""16041095"", ""39929095"", ""220262110"", ""131442549"", ""2781956756"", ""2580259364"", ""151005270"", ""1667251910"", ""199402291"", ""18777297"", ""1367844960"", ""343031653"", ""422917600""]",0,3,3
84440344,4,50.75,-0.09158800542354584,2045767.0,4,0.0,"[""charliehebdo-all-rnr-threads"", ""sydneysiege-all-rnr-threads""]","[""46017944"", ""250603308"", ""153029181"", ""238575113""]",0,4,4
2319710954,10,112.6,-0.21132517457008362,12547049.0,3,0.1,"[""charliehebdo-all-rnr-threads"", ""ferguson-all-rnr-threads""]","[""46017944"", ""236488883"", ""19906615""]",1,9,10
46026799,2,52.5,-0.36273401975631714,2028341.0,2,0.5,"[""charliehebdo-all-rnr-threads"", ""sydneysiege-all-rnr-threads""]","[""1630896181"", ""413157362""]",1,1,2
17537467,26,135.00000000000003,-0.37844385550572324,12602561.0,197,0.07692307692307693,"[""charliehebdo-all-rnr-threads"", ""ottawashooting-all-rnr-threads"", ""ferguson-all-rnr-threads"", ""sydneysiege-all-rnr-threads""]","[""98318105"", ""286801248"", ""163087827"", ""344645806"", ""1369778664"", ""1952614448"", ""58134552"", ""1962596220"", ""159624465"", ""1616440789"", ""728542435"", ""133435893"", ""368340787"", ""746919546"", ""351538535"", ""93804616"", ""393102360"", ""302530270"", ""222299436"", ""113578227"", ""2513308740"", ""1038174848"", ""216419976"", ""264154911"", ""2504058366"", ""1359226843"", ""69357291"", ""2209557522"", ""186809475"", ""137873483"", ""89915107"", ""168424708"", ""541209016"", ""143597109"", ""272889377"", ""605283640"", ""405705870"", ""133200761"", ""26552390"", ""714357390"", ""521761797"", ""50931748"", ""1360529616"", ""1686700296"", ""239875508"", ""485315252"", ""2787045658"", ""253533891"", ""470072295"", ""296310272"", ""266525276"", ""741641330"", ""57900744"", ""403436252"", ""1615069758"", ""30657692"", ""16665639"", ""224451183"", ""2168110979"", ""885944552"", ""619276411"", ""77752606"", ""2378914268"", ""30122242"", ""27001817"", ""273017211"", ""103588513"", ""1564968534"", ""2423923734"", ""47534393"", ""1341216391"", ""191083128"", ""540036538"", ""54414861"", ""2168092940"", ""167046760"", ""359136927"", ""66685550"", ""1539887251"", ""76061012"", ""2666471250"", ""930946476"", ""2759365803"", ""126042897"", ""1213293126"", ""35515215"", ""2420857560"", ""25928003"", ""1940498390"", ""2799617017"", ""15400294"", ""1648568587"", ""58566981"", ""292510032"", ""746034968"", ""127926130"", ""1487929944"", ""88160640"", ""77913591"", ""129419436"", ""462142965"", ""1194737994"", ""2726339299"", ""121261104"", ""2597974921"", ""526002942"", ""2176927618"", ""150974182"", ""14260960"", ""2813305829"", ""325824503"", ""294025033"", ""2285166306"", ""200108931"", ""620650075"", ""226457710"", ""1498709924"", ""102037970"", ""2163402666"", ""79676374"", ""32981486"", ""2486762587"", ""2272570615"", ""94102935"", ""1468323792"", ""2880181350"", ""342721044"", ""1966124460"", ""534966457"", ""17537467"", ""723090685"", ""347350223"", ""231067486"", ""16897506"", ""121364614"", ""50294215"", ""73571300"", ""56867700"", ""1151095778"", ""51417874"", ""433851538"", ""919453033"", ""307630778"", ""1485192062"", ""383861671"", ""86026819"", ""1263002017"", ""815489784"", ""2237356825"", ""2242637850"", ""113837847"", ""108403307"", ""1141763906"", ""294860063"", ""2889273374"", ""2800508450"", ""27826729"", ""1230267290"", ""2937295972"", ""48684811"", ""1630630458"", ""1225414310"", ""2921439702"", ""424415890"", ""229680261"", ""2242427281"", ""448611998"", ""1061358956"", ""903818041"", ""554602025"", ""85742591"", ""250154970"", ""22021978"", ""293445832"", ""463203468"", ""174716572"", ""55628042"", ""38017472"", ""2831088410"", ""2504665885"", ""768577789"", ""180355694"", ""264868817"", ""2381434507"", ""142991027"", ""20301302"", ""2833216531"", ""1337770478"", ""120350623"", ""635444177"", ""2657848051"", ""181984719"", ""1026724087"", ""272986179"", ""2893904635"", ""2471852986"", ""884724134""]",2,24,26
129419436,2,135.0,-0.4568643867969513,1998135.0,2,0.0,"[""charliehebdo-all-rnr-threads"", ""sydneysiege-all-rnr-threads""]","[""17537467"", ""177886974""]",0,2,2
2209557522,4,92.25,-0.1879430115222931,2023974.0,4,0.25,"[""charliehebdo-all-rnr-threads"", ""sydneysiege-all-rnr-threads""]","[""1960878613"", ""17537467"", ""258627226"", ""14260960""]",1,3,4
120350623,6,85.0,-0.03863447904586792,2155816.0,4,0.0,"[""charliehebdo-all-rnr-threads"", ""sydneysiege-all-rnr-threads""]","[""18628451"", ""17537467"", ""47685065"", ""12716032""]",0,6,6
235598808,2,117.5,-0.2523616552352905,2018624.0,2,0.0,"[""charliehebdo-all-rnr-threads"", ""sydneysiege-all-rnr-threads""]","[""83795099"", ""1960878613""]",0,2,2
517747314,6,40.166666666666664,0.2346381942431132,2099862.0,5,0.0,"[""charliehebdo-all-rnr-threads"", ""sydneysiege-all-rnr-threads""]","[""196994616"", ""2653613168"", ""14353202"", ""83795099"", ""14159148""]",0,6,6
611516397,4,135.0,0.022567003965377808,2012042.0,2,0.5,"[""charliehebdo-all-rnr-threads"", ""sydneysiege-all-rnr-threads""]","[""83795099"", ""7587032""]",2,2,4
402495088,12,108.0,-0.1219113419453303,12760939.0,5,0.0,"[""charliehebdo-all-rnr-threads"", ""ferguson-all-rnr-threads""]","[""168828976"", ""244452760"", ""97327765"", ""2461887810"", ""1571428436""]",0,12,12
32351459,2,117.0,-0.6805076897144318,2003254.0,2,0.0,"[""charliehebdo-all-rnr-threads"", ""sydneysiege-all-rnr-threads""]","[""788524"", ""15143478""]",0,2,2
414138120,2,118.0,-0.1352001428604126,2036504.0,2,0.5,"[""charliehebdo-all-rnr-threads"", ""sydneysiege-all-rnr-threads""]","[""15400294"", ""788524""]",1,1,2
460502356,2,70.5,0.22936654090881348,2007779.0,2,0.0,"[""charliehebdo-all-rnr-threads"", ""sydneysiege-all-rnr-threads""]","[""7589572"", ""2190056023""]",0,2,2
256456300,2,128.0,-0.4754452407360077,1977980.0,2,0.5,"[""charliehebdo-all-rnr-threads"", ""sydneysiege-all-rnr-threads""]","[""15754281"", ""7587032""]",1,1,2
279483370,4,90.75,-0.3007527142763138,2004814.0,3,0.0,"[""charliehebdo-all-rnr-threads"", ""sydneysiege-all-rnr-threads""]","[""55911799"", ""48705816"", ""7587032""]",0,4,4
354668309,5,110.4,-0.5071343660354615,12479362.0,2,0.0,"[""charliehebdo-all-rnr-threads"", ""ferguson-all-rnr-threads""]","[""27966935"", ""7587032""]",0,5,5
63112335,2,76.0,-0.5053844153881073,2025370.0,2,0.0,"[""charliehebdo-all-rnr-threads"", ""sydneysiege-all-rnr-threads""]","[""210951599"", ""282977213""]",0,2,2
27734496,19,90.15789473684211,-0.34859027360614975,12321499.0,4,0.15789473684210525,"[""charliehebdo-all-rnr-threads"", ""putinmissing-all-rnr-threads"", ""ottawashooting-all-rnr-threads""]","[""106272927"", ""10774652"", ""64643056"", ""20052487""]",3,16,19
65045121,16,79.0,-0.1613902747631073,2121144.0,80,0.0,"[""charliehebdo-all-rnr-threads"", ""sydneysiege-all-rnr-threads""]","[""18426337"", ""270762898"", ""486675609"", ""880165526"", ""501825960"", ""134420171"", ""443117695"", ""89778644"", ""73095261"", ""288357228"", ""2256180015"", ""305318105"", ""223818409"", ""14582189"", ""169661423"", ""113704009"", ""261093402"", ""868574348"", ""828767000"", ""233296333"", ""91119778"", ""21453194"", ""2958546556"", ""40546642"", ""39991397"", ""131945477"", ""18798031"", ""91812903"", ""39225614"", ""2543690883"", ""339856642"", ""2464231395"", ""143067985"", ""623803412"", ""134399130"", ""1194468258"", ""527790406"", ""1632334700"", ""243355171"", ""765941791"", ""2262547827"", ""256681564"", ""2883428362"", ""1063910054"", ""124786455"", ""52404825"", ""569225542"", ""2960414303"", ""2873979164"", ""216809385"", ""259329721"", ""37961036"", ""439533068"", ""168321389"", ""361514032"", ""450758855"", ""149428536"", ""277156263"", ""403338386"", ""283704719"", ""347089062"", ""1318795249"", ""346044349"", ""2828409654"", ""23607137"", ""17422137"", ""2721029516"", ""489885788"", ""246530969"", ""1282932415"", ""42974891"", ""65045121"", ""87081989"", ""16681111"", ""61144740"", ""2335217159"", ""83422949"", ""296407595"", ""7454012"", ""75113883""]",0,16,16
50791051,13,124.0,-0.45376797822805554,5706622.0,10,0.6923076923076923,"[""charliehebdo-all-rnr-threads"", ""sydneysiege-all-rnr-threads"", ""prince-toronto-all-rnr-threads""]","[""17659340"", ""19636948"", ""9609632"", ""2738397743"", ""383685824"", ""7401202"", ""19038934"", ""1020058453"", ""37874853"", ""428333""]",9,4,13
250603308,5,93.2,-0.21642732620239258,2002737.0,33,0.0,"[""charliehebdo-all-rnr-threads"", ""sydneysiege-all-rnr-threads""]","[""56459872"", ""365745957"", ""47435872"", ""2728366757"", ""559706820"", ""19877641"", ""2841084447"", ""275701123"", ""289082375"", ""567240884"", ""158674126"", ""11776352"", ""118903135"", ""18725815"", ""228600018"", ""757269528"", ""511322355"", ""1006155421"", ""2899924184"", ""22831663"", ""562795561"", ""532286311"", ""2928066304"", ""453205828"", ""187096540"", ""84440344"", ""2427918180"", ""261228864"", ""250603308"", ""223659845"", ""284645097"", ""211105315"", ""2469783866""]",0,5,5
264122287,2,128.0,-0.6142476201057434,12663564.0,2,0.0,"[""charliehebdo-all-rnr-threads"", ""ferguson-all-rnr-threads""]","[""18725815"", ""183341278""]",0,2,2
46078438,26,84.42307692307692,-0.04519840387197641,2100478.0,90,0.07692307692307693,"[""charliehebdo-all-rnr-threads"", ""sydneysiege-all-rnr-threads""]","[""307388232"", ""2914673670"", ""272418128"", ""1045556737"", ""1246536608"", ""747822822"", ""2731482801"", ""264166713"", ""198553539"", ""1638966961"", ""455724651"", ""199738451"", ""1298734488"", ""636741360"", ""1974332563"", ""114533091"", ""2737811904"", ""215352821"", ""222918631"", ""61755415"", ""1605800497"", ""2841798801"", ""2829408083"", ""36326077"", ""198030688"", ""195280174"", ""142697222"", ""284551366"", ""2378914268"", ""530920210"", ""291763454"", ""44333533"", ""2657849431"", ""116985382"", ""179131312"", ""1358213737"", ""6774982"", ""460705232"", ""1631123834"", ""20423769"", ""2539258598"", ""20262783"", ""2875917137"", ""2525820541"", ""236807166"", ""215240822"", ""53581284"", ""2223745470"", ""2386921782"", ""2530864540"", ""2960414303"", ""1377307112"", ""2273282888"", ""243576302"", ""2582687036"", ""132881607"", ""351891114"", ""1144064870"", ""484240369"", ""2242421732"", ""2551157894"", ""1425756199"", ""397546532"", ""136938837"", ""2259880764"", ""20771519"", ""551593596"", ""2741792876"", ""50294215"", ""49579771"", ""1184253228"", ""799145192"", ""1408710426"", ""46078438"", ""471616489"", ""745248356"", ""474397837"", ""191389346"", ""531686698"", ""1949814078"", ""353848742"", ""89104271"", ""350509019"", ""77739297"", ""197196168"", ""95356537"", ""23932960"", ""606152631"", ""29577416"", ""24006632""]",2,24,26
77739297,8,75.875,-0.0699043720960617,6786164.0,8,0.25,"[""charliehebdo-all-rnr-threads"", ""ottawashooting-all-rnr-threads"", ""sydneysiege-all-rnr-threads""]","[""329121956"", ""93766096"", ""46078438"", ""16834659"", ""16832632"", ""22993014"", ""2768501"", ""5402612""]",2,6,8
340279079,11,96.0,-0.23601861433549362,2082922.0,3,0.0,"[""charliehebdo-all-rnr-threads"", ""sydneysiege-all-rnr-threads""]","[""15250661"", ""540628749"", ""374712154""]",0,11,11
1934989190,2,130.0,-0.48475369811058044,2022322.0,22,0.0,"[""charliehebdo-all-rnr-threads"", ""sydneysiege-all-rnr-threads""]","[""2869579500"", ""2370378739"", ""416608213"", ""25488725"", ""19111502"", ""254767849"", ""175243720"", ""1142208854"", ""21161061"", ""2770504122"", ""254809254"", ""169287046"", ""98595881"", ""2497874076"", ""2351162450"", ""24762949"", ""878401676"", ""909894727"", ""21131522"", ""892884318"", ""1872372360"", ""44315494""]",0,2,2
24762949,5,111.4,-0.5565506935119628,12497962.0,2,0.2,"[""charliehebdo-all-rnr-threads"", ""ferguson-all-rnr-threads""]","[""1934989190"", ""62510409""]",1,4,5
878401676,2,140.0,-0.5370298027992249,12500482.0,2,0.5,"[""charliehebdo-all-rnr-threads"", ""ferguson-all-rnr-threads""]","[""1934989190"", ""14464766""]",1,1,2
909894727,21,111.0952380952381,-0.0842360087803432,3933388.0,6,0.047619047619047616,"[""charliehebdo-all-rnr-threads"", ""gurlitt-all-rnr-threads""]","[""2882008626"", ""419520517"", ""3108351"", ""1934989190"", ""742143"", ""16675569""]",1,20,21
280288703,2,121.0,-0.30163097381591797,12505986.0,2,0.0,"[""charliehebdo-all-rnr-threads"", ""ferguson-all-rnr-threads""]","[""14090948"", ""20052487""]",0,2,2
326142499,14,96.5,-0.15441211206572397,19218082.0,6,0.21428571428571427,"[""charliehebdo-all-rnr-threads"", ""germanwings-crash-all-rnr-threads"", ""sydneysiege-all-rnr-threads"", ""ferguson-all-rnr-threads""]","[""77528520"", ""244452760"", ""508110571"", ""64643056"", ""20052487"", ""11265832""]",3,11,14
55949344,23,75.30434782608695,-0.298577720704286,19510297.0,8,0.08695652173913043,"[""charliehebdo-all-rnr-threads"", ""germanwings-crash-all-rnr-threads"", ""sydneysiege-all-rnr-threads"", ""ferguson-all-rnr-threads""]","[""1630896181"", ""122557484"", ""16935292"", ""16589206"", ""89185283"", ""82048287"", ""20052487"", ""21123640""]",2,21,23
59503113,2,121.0,0.0670003890991211,2004526.0,2,0.0,"[""charliehebdo-all-rnr-threads"", ""sydneysiege-all-rnr-threads""]","[""16675569"", ""87818409""]",0,2,2
193927117,2,138.5,-0.04125553369522095,6570431.0,2,0.0,"[""charliehebdo-all-rnr-threads"", ""germanwings-crash-all-rnr-threads""]","[""2280470022"", ""87818409""]",0,2,2
1744765753,4,118.5,-0.5841875970363617,2037843.0,2,0.0,"[""charliehebdo-all-rnr-threads"", ""sydneysiege-all-rnr-threads""]","[""6246092"", ""25235151""]",0,4,4
1301364216,5,105.0,-0.3778125882148743,1984956.0,3,0.0,"[""charliehebdo-all-rnr-threads"", ""sydneysiege-all-rnr-threads""]","[""148653311"", ""5402612"", ""25235151""]",0,5,5
152499321,3,107.66666666666667,-0.30220329761505127,1983847.0,3,0.0,"[""charliehebdo-all-rnr-threads"", ""sydneysiege-all-rnr-threads""]","[""7587032"", ""153029181"", ""25235151""]",0,3,3
501381054,4,139.25,-0.623151421546936,6757262.0,4,0.25,"[""charliehebdo-all-rnr-threads"", ""germanwings-crash-all-rnr-threads""]","[""607082634"", ""495464885"", ""87818409"", ""1367531""]",1,3,4
28305154,24,95.125,-0.41946061452229816,1981350.0,3,0.0,"[""charliehebdo-all-rnr-threads"", ""sydneysiege-all-rnr-threads""]","[""16589206"", ""23041630"", ""315163250""]",0,24,24
474150173,4,79.75,-0.32141314446926117,6648961.0,4,0.0,"[""charliehebdo-all-rnr-threads"", ""ottawashooting-all-rnr-threads""]","[""193725962"", ""132231788"", ""315163250"", ""156123647""]",0,4,4
323499989,6,91.0,-0.30766494075457257,12909917.0,5,0.3333333333333333,"[""charliehebdo-all-rnr-threads"", ""ottawashooting-all-rnr-threads"", ""ferguson-all-rnr-threads"", ""sydneysiege-all-rnr-threads""]","[""315163250"", ""264268489"", ""412682869"", ""1426406143"", ""16675569""]",2,4,6
2156961082,4,53.75,0.28123316168785095,12663846.0,4,0.0,"[""charliehebdo-all-rnr-threads"", ""ferguson-all-rnr-threads""]","[""99786592"", ""279390084"", ""14321959"", ""5971922""]",0,4,4
2475902143,4,67.25,-0.16221930086612701,2061735.0,3,0.0,"[""charliehebdo-all-rnr-threads"", ""sydneysiege-all-rnr-threads""]","[""838673408"", ""177886974"", ""64643056""]",0,4,4
2879416903,2,136.0,-0.41451436281204224,2008143.0,1,0.5,"[""charliehebdo-all-rnr-threads"", ""sydneysiege-all-rnr-threads""]","[""64643056""]",1,1,2
2785975828,5,67.8,-0.5611242413520813,2017796.0,3,0.6,"[""charliehebdo-all-rnr-threads"", ""sydneysiege-all-rnr-threads""]","[""1367531"", ""2097571"", ""64643056""]",3,2,5
1464666841,5,128.2,-0.2393191933631897,2478501.0,2,0.0,"[""charliehebdo-all-rnr-threads"", ""sydneysiege-all-rnr-threads""]","[""532779460"", ""374712154""]",0,5,5
296505265,3,62.666666666666664,-0.6826768318812052,2050612.0,2,0.3333333333333333,"[""charliehebdo-all-rnr-threads"", ""sydneysiege-all-rnr-threads""]","[""14173315"", ""19341389""]",1,2,3
8432682,10,93.6,-0.16141576766967775,6907963.0,3,0.0,"[""charliehebdo-all-rnr-threads"", ""ottawashooting-all-rnr-threads""]","[""152646096"", ""742143"", ""13493302""]",0,10,10
23196051,4,97.0,0.03666916489601135,12520465.0,2,0.75,"[""charliehebdo-all-rnr-threads"", ""ferguson-all-rnr-threads""]","[""87818409"", ""15896580""]",3,1,4
25343810,2,90.5,-0.10185730457305908,12529735.0,2,0.0,"[""charliehebdo-all-rnr-threads"", ""ferguson-all-rnr-threads""]","[""76388579"", ""319777415""]",0,2,2
38241210,11,134.54545454545453,-0.0476386926390908,2037517.0,2,0.0,"[""charliehebdo-all-rnr-threads"", ""sydneysiege-all-rnr-threads""]","[""34210188"", ""76388579""]",0,11,11
383866418,2,133.0,-0.7635505795478821,12673793.0,2,0.0,"[""charliehebdo-all-rnr-threads"", ""ferguson-all-rnr-threads""]","[""49698134"", ""76388579""]",0,2,2
133200761,2,135.5,-0.488004595041275,2023414.0,2,0.0,"[""charliehebdo-all-rnr-threads"", ""sydneysiege-all-rnr-threads""]","[""103849564"", ""17537467""]",0,2,2
1686700296,5,121.6,-0.49547758102416994,13434939.0,3,0.4,"[""charliehebdo-all-rnr-threads"", ""germanwings-crash-all-rnr-threads"", ""ottawashooting-all-rnr-threads""]","[""1652541"", ""17537467"", ""162304163""]",2,3,5
34033504,3,59.666666666666664,-0.33396536111831665,2010253.0,2,0.6666666666666666,"[""charliehebdo-all-rnr-threads"", ""sydneysiege-all-rnr-threads""]","[""25067168"", ""5402612""]",2,1,3
520011678,8,99.625,-0.2455364540219307,2120120.0,44,0.0,"[""charliehebdo-all-rnr-threads"", ""sydneysiege-all-rnr-threads""]","[""255730745"", ""550528049"", ""1090556088"", ""139142932"", ""15250981"", ""348551536"", ""2605930819"", ""462924454"", ""100806458"", ""402090275"", ""107789892"", ""434786858"", ""45092362"", ""15730804"", ""788018329"", ""141154921"", ""30378270"", ""16931849"", ""750430579"", ""520011678"", ""434609176"", ""2336779008"", ""511079248"", ""390421144"", ""43737335"", ""2193440388"", ""159285637"", ""627830911"", ""2871588796"", ""7587032"", ""178069913"", ""760085006"", ""899975857"", ""108688171"", ""2264985163"", ""18503976"", ""1170076507"", ""280079232"", ""2651936329"", ""2551394742"", ""26178536"", ""87818409"", ""62692433"", ""57268394""]",0,8,8
546924455,2,84.5,-0.577616274356842,2033881.0,2,0.5,"[""charliehebdo-all-rnr-threads"", ""sydneysiege-all-rnr-threads""]","[""21866939"", ""7587032""]",1,1,2
371295497,3,133.33333333333334,-0.2982809742291768,8572725.0,3,0.0,"[""charliehebdo-all-rnr-threads"", ""germanwings-crash-all-rnr-threads"", ""sydneysiege-all-rnr-threads""]","[""16675569"", ""7587032"", ""5402612""]",0,3,3
1420213766,3,78.66666666666667,-0.47691208124160767,1983751.0,2,0.0,"[""charliehebdo-all-rnr-threads"", ""sydneysiege-all-rnr-threads""]","[""7587032"", ""2768501""]",0,3,3
101557323,2,47.0,-0.40510109066963196,6646831.0,2,0.0,"[""charliehebdo-all-rnr-threads"", ""ottawashooting-all-rnr-threads""]","[""157009365"", ""16076032""]",0,2,2
268194728,21,107.9047619047619,-0.2935399895622617,6991917.0,3,0.0,"[""charliehebdo-all-rnr-threads"", ""ottawashooting-all-rnr-threads""]","[""405743388"", ""157009365"", ""260661314""]",0,21,21
96800761,3,78.0,-0.6627597610155741,12519707.0,3,0.0,"[""charliehebdo-all-rnr-threads"", ""ferguson-all-rnr-threads""]","[""87297341"", ""157009365"", ""15956067""]",0,3,3
15586316,2,108.5,-0.7749369442462921,6642212.0,10,0.0,"[""charliehebdo-all-rnr-threads"", ""ottawashooting-all-rnr-threads""]","[""157009365"", ""12135762"", ""2490142490"", ""468879754"", ""271953715"", ""1569614916"", ""22642989"", ""2826961293"", ""1127915888"", ""992900209""]",0,2,2
330459560,18,109.05555555555556,-0.30502772993511623,12520464.0,14,0.8888888888888888,"[""charliehebdo-all-rnr-threads"", ""ferguson-all-rnr-threads""]","[""433173729"", ""157009365"", ""245649240"", ""123728076"", ""404460410"", ""288025586"", ""85742591"", ""181064035"", ""856919184"", ""619393302"", ""330459560"", ""384733570"", ""178607982"", ""12004852""]",16,2,18
2353360606,2,105.0,-0.4707487225532532,12685034.0,2,0.0,"[""charliehebdo-all-rnr-threads"", ""ferguson-all-rnr-threads""]","[""157009365"", ""2468828556""]",0,2,2
153029181,10,112.0,0.08869260549545288,2028252.0,178,0.0,"[""charliehebdo-all-rnr-threads"", ""sydneysiege-all-rnr-threads""]","[""399541381"", ""51607683"", ""305502995"", ""401183991"", ""195251002"", ""500537497"", ""299174890"", ""25440868"", ""363509031"", ""102837987"", ""264132205"", ""84798253"", ""2383360362"", ""518096170"", ""1572696284"", ""64884827"", ""2431932690"", ""173467227"", ""150227715"", ""54194375"", ""152499321"", ""303834061"", ""32798162"", ""516971079"", ""2918005698"", ""224936475"", ""234020300"", ""192809732"", ""452480732"", ""148891886"", ""1334459611"", ""17984709"", ""1707327366"", ""19749940"", ""211365709"", ""1892037781"", ""48347146"", ""159040671"", ""2581772612"", ""47239788"", ""50878334"", ""63638663"", ""21197799"", ""1863511730"", ""246194416"", ""93524104"", ""798034514"", ""1632524730"", ""35605386"", ""174802474"", ""23031901"", ""2716912782"", ""411340320"", ""395278285"", ""2784183844"", ""265936127"", ""19954761"", ""2925914498"", ""17450452"", ""21059384"", ""821108359"", ""154523730"", ""2378914268"", ""623706361"", ""1337986381"", ""19102918"", ""146765658"", ""16814613"", ""469124011"", ""151793456"", ""204288809"", ""477542318"", ""1409186066"", ""2905065581"", ""1227227953"", ""778337"", ""961721755"", ""2574786265"", ""139631790"", ""442165878"", ""2236728919"", ""2284965018"", ""2886586060"", ""111415215"", ""42166808"", ""25941064"", ""501522646"", ""206554234"", ""1055197866"", ""1911208674"", ""2878116436"", ""320716056"", ""1724090454"", ""2319945642"", ""505832308"", ""25709850"", ""249860705"", ""2726339299"", ""313198995"", ""258289977"", ""1394500728"", ""42601407"", ""588177972"", ""527308519"", ""2920445660"", ""257395153"", ""247705465"", ""715418064"", ""511084543"", ""289732005"", ""26716598"", ""269596401"", ""4996341"", ""883679520"", ""226857183"", ""308425996"", ""55794552"", ""176087223"", ""260532533"", ""2526736988"", ""258995248"", ""1660636646"", ""1468323792"", ""18354050"", ""48512272"", ""635315113"", ""2336670397"", ""999907196"", ""2926217803"", ""331981133"", ""2877961729"", ""390136814"", ""339711830"", ""230693588"", ""81484701"", ""473202232"", ""2925076892"", ""18680823"", ""121587626"", ""1949375239"", ""1600261771"", ""24820235"", ""18114648"", ""751130238"", ""1644408697"", ""1159834147"", ""1856082044"", ""50236686"", ""377891222"", ""2502895924"", ""150947037"", ""1391753906"", ""2665457419"", ""365850418"", ""1144000506"", ""1315921093"", ""129018139"", ""306673996"", ""2675348876"", ""250435493"", ""101650503"", ""1485225582"", ""17702179"", ""2450756893"", ""175452918"", ""497750790"", ""2350935702"", ""1739847991"", ""55500067"", ""988404866"", ""20301302"", ""84440344"", ""2608969241"", ""2394694361"", ""349004622"", ""166527530"", ""2359281306"", ""217737647""]",0,10,10
258289977,2,99.0,0.11801069974899292,2019188.0,2,0.0,"[""charliehebdo-all-rnr-threads"", ""sydneysiege-all-rnr-threads""]","[""377163508"", ""153029181""]",0,2,2
81484701,2,21.5,0.2548450231552124,1995679.0,1,0.0,"[""charliehebdo-all-rnr-threads"", ""sydneysiege-all-rnr-threads""]","[""153029181""]",0,2,2
1315921093,3,101.33333333333333,-0.42118606964747113,2030835.0,3,0.3333333333333333,"[""charliehebdo-all-rnr-threads"", ""sydneysiege-all-rnr-threads""]","[""16834659"", ""377163508"", ""153029181""]",1,2,3
306673996,4,69.5,-0.3684515953063965,2133627.0,3,0.0,"[""charliehebdo-all-rnr-threads"", ""sydneysiege-all-rnr-threads""]","[""18965916"", ""16675569"", ""153029181""]",0,4,4
2925076892,13,108.38461538461539,-0.18529619161899274,2133286.0,2,0.0,"[""charliehebdo-all-rnr-threads"", ""sydneysiege-all-rnr-threads""]","[""156464691"", ""153029181""]",0,13,13
2726339299,5,114.0,-0.3645323634147644,2122074.0,4,0.2,"[""charliehebdo-all-rnr-threads"", ""sydneysiege-all-rnr-threads""]","[""17537467"", ""2768501"", ""153029181"", ""44835347""]",1,4,5
53091127,4,89.25,0.35439327359199524,2004364.0,3,0.0,"[""charliehebdo-all-rnr-threads"", ""sydneysiege-all-rnr-threads""]","[""18725815"", ""36311109"", ""21548431""]",0,4,4
141154921,2,123.5,-0.32744115591049194,2020640.0,2,0.0,"[""charliehebdo-all-rnr-threads"", ""sydneysiege-all-rnr-threads""]","[""18725815"", ""520011678""]",0,2,2
160336748,3,135.0,-0.47615164518356323,12521507.0,3,0.3333333333333333,"[""charliehebdo-all-rnr-threads"", ""ferguson-all-rnr-threads""]","[""18725815"", ""119972954"", ""2097571""]",1,2,3
14360516,7,117.85714285714286,-0.20989285196576798,6835370.0,7,0.2857142857142857,"[""charliehebdo-all-rnr-threads"", ""ottawashooting-all-rnr-threads"", ""sydneysiege-all-rnr-threads""]","[""299416026"", ""189118361"", ""47707475"", ""380648579"", ""18999969"", ""972651"", ""5402612""]",2,5,7
2214510864,7,118.85714285714286,-0.6092543431690761,2125331.0,5,0.5714285714285714,"[""charliehebdo-all-rnr-threads"", ""sydneysiege-all-rnr-threads""]","[""14173315"", ""2884771"", ""16664681"", ""2467791"", ""87818409""]",4,3,7
428308662,13,121.38461538461539,-0.2946125589884244,1977764.0,3,0.0,"[""charliehebdo-all-rnr-threads"", ""sydneysiege-all-rnr-threads""]","[""14173315"", ""489475164"", ""1562935142""]",0,13,13
2862319827,3,87.33333333333333,-0.2967612346013387,2164752.0,3,0.3333333333333333,"[""charliehebdo-all-rnr-threads"", ""sydneysiege-all-rnr-threads""]","[""14173315"", ""28785486"", ""15754281""]",1,2,3
20748745,14,116.28571428571429,-0.4422781297138759,6784300.0,72,0.0,"[""charliehebdo-all-rnr-threads"", ""ottawashooting-all-rnr-threads""]","[""980590310"", ""59799989"", ""361496218"", ""607651527"", ""2745538651"", ""40725770"", ""414142583"", ""2760050529"", ""948354164"", ""2801061038"", ""1546633573"", ""119788492"", ""14499704"", ""2366083352"", ""373601625"", ""175272959"", ""392739061"", ""2187560031"", ""30974710"", ""2725366949"", ""358091193"", ""1658154254"", ""347273098"", ""517640840"", ""540323881"", ""775646406"", ""522498017"", ""176657599"", ""346080985"", ""22407854"", ""37624597"", ""45641358"", ""16195430"", ""817660009"", ""2809029093"", ""94419041"", ""422277246"", ""2732949270"", ""2419181035"", ""485703398"", ""610233199"", ""363761111"", ""1669056901"", ""1909281625"", ""2861422121"", ""45657792"", ""569546005"", ""2787338146"", ""860807707"", ""37984883"", ""1635639588"", ""271646568"", ""201295178"", ""276075970"", ""2182711838"", ""20748745"", ""321448767"", ""2822619188"", ""545473909"", ""267375047"", ""115125517"", ""2909583695"", ""260607004"", ""2211194534"", ""25109607"", ""299190586"", ""421610271"", ""17264634"", ""2407460690"", ""146408874"", ""23531441"", ""2447290136""]",0,14,14
299190586,7,91.71428571428571,-0.40311920642852783,19300780.0,5,0.2857142857142857,"[""charliehebdo-all-rnr-threads"", ""germanwings-crash-all-rnr-threads"", ""ferguson-all-rnr-threads""]","[""14465607"", ""17995040"", ""195271137"", ""72882689"", ""20748745""]",2,5,7
2366083352,12,115.75,-0.3895205756028493,1990848.0,2,0.0,"[""charliehebdo-all-rnr-threads"", ""sydneysiege-all-rnr-threads""]","[""20748745"", ""374712154""]",0,12,12
1232348810,3,92.33333333333333,-0.47467132409413654,2035718.0,3,0.6666666666666666,"[""charliehebdo-all-rnr-threads"", ""sydneysiege-all-rnr-threads""]","[""380648579"", ""16012783"", ""14515799""]",2,1,3
856010760,2,113.0,0.350369393825531,6561592.0,16,0.0,"[""charliehebdo-all-rnr-threads"", ""germanwings-crash-all-rnr-threads""]","[""264241703"", ""422479459"", ""42374436"", ""2325539309"", ""96325366"", ""67706546"", ""1348659986"", ""313373071"", ""542122849"", ""853590739"", ""1534181328"", ""1499919524"", ""2256931663"", ""254141015"", ""270388220"", ""2464502209""]",0,2,2
67706546,14,127.64285714285714,-0.5204570591449738,12691597.0,11,0.2857142857142857,"[""charliehebdo-all-rnr-threads"", ""ottawashooting-all-rnr-threads"", ""ferguson-all-rnr-threads""]","[""14717197"", ""140149359"", ""51241574"", ""807095"", ""17735875"", ""14700316"", ""856010760"", ""13393052"", ""14855994"", ""10168082"", ""428333""]",4,10,14
86785588,3,88.66666666666667,-0.2006602684656779,6868599.0,3,0.0,"[""charliehebdo-all-rnr-threads"", ""ottawashooting-all-rnr-threads""]","[""148653311"", ""48705816"", ""142375993""]",0,3,3
1697751708,2,67.5,-0.3122129440307617,5442051.0,2,0.0,"[""charliehebdo-all-rnr-threads"", ""putinmissing-all-rnr-threads""]","[""48705816"", ""36309919""]",0,2,2
236488883,7,128.42857142857142,-0.45516788959503174,19306340.0,72,0.5714285714285714,"[""charliehebdo-all-rnr-threads"", ""germanwings-crash-all-rnr-threads"", ""ferguson-all-rnr-threads""]","[""395175296"", ""389843381"", ""790783038"", ""1164186643"", ""1957543394"", ""272962444"", ""144444997"", ""236742555"", ""41108256"", ""236488883"", ""216119786"", ""2764799813"", ""2319710954"", ""2404454630"", ""2267805854"", ""2978767414"", ""810171746"", ""506913732"", ""2354866949"", ""390824842"", ""715188631"", ""377718414"", ""1061331264"", ""564647612"", ""336629397"", ""573198799"", ""2491821019"", ""112384861"", ""400401971"", ""824328062"", ""44112246"", ""617469402"", ""2962306260"", ""307913758"", ""23153001"", ""120948837"", ""2561258142"", ""21109943"", ""190931694"", ""2792257547"", ""1921398986"", ""1324033783"", ""468626967"", ""379012811"", ""2534908328"", ""2264215582"", ""483242858"", ""382442247"", ""10916492"", ""92492429"", ""2324769967"", ""1869596526"", ""2208368042"", ""433685408"", ""15249113"", ""433006127"", ""747639205"", ""146379532"", ""25109607"", ""2559497896"", ""371273158"", ""60260463"", ""2164734226"", ""385962979"", ""408150347"", ""44369257"", ""1138683673"", ""15381476"", ""229193461"", ""2189088222"", ""13003922"", ""20313130""]",4,3,7
47726591,2,94.0,-0.42490261793136597,2005883.0,2,0.5,"[""charliehebdo-all-rnr-threads"", ""sydneysiege-all-rnr-threads""]","[""14138785"", ""64643056""]",1,1,2
2824462458,2,117.0,-0.10309082269668579,2025013.0,2,0.5,"[""charliehebdo-all-rnr-threads"", ""sydneysiege-all-rnr-threads""]","[""17919393"", ""3108351""]",1,1,2
934537771,3,126.0,-0.7366631428400675,1970211.0,2,0.0,"[""charliehebdo-all-rnr-threads"", ""sydneysiege-all-rnr-threads""]","[""407871140"", ""3108351""]",0,3,3
20148675,2,54.5,-0.6367391049861908,1990540.0,2,0.5,"[""charliehebdo-all-rnr-threads"", ""sydneysiege-all-rnr-threads""]","[""3108351"", ""742143""]",1,1,2
1477840074,3,81.0,0.04686542352040609,12664164.0,3,0.3333333333333333,"[""charliehebdo-all-rnr-threads"", ""ferguson-all-rnr-threads""]","[""788524"", ""279390084"", ""20374262""]",1,2,3
17995040,8,126.125,-0.5852867066860199,2157284.0,124,0.0,"[""charliehebdo-all-rnr-threads"", ""sydneysiege-all-rnr-threads""]","[""18878975"", ""2843186387"", ""2958887420"", ""18042071"", ""379980949"", ""2817657692"", ""27637361"", ""2534846484"", ""2528383177"", ""41174721"", ""18566907"", ""191324405"", ""54194375"", ""175243720"", ""2671154298"", ""1902427388"", ""531746232"", ""199738451"", ""50084663"", ""1352019991"", ""1669056901"", ""255269018"", ""413374229"", ""2886314685"", ""66246374"", ""16491845"", ""2282397654"", ""2746240046"", ""119295989"", ""902814223"", ""95562312"", ""506730928"", ""2857116782"", ""203681518"", ""220771828"", ""556543428"", ""1942234530"", ""39522916"", ""18408983"", ""63210767"", ""124578766"", ""82144210"", ""2267779982"", ""827681827"", ""544816882"", ""756331316"", ""212102564"", ""2617572566"", ""2413247540"", ""14322902"", ""467460248"", ""2168092940"", ""1306355250"", ""120181792"", ""617229652"", ""102470285"", ""2909443215"", ""2869123535"", ""25394922"", ""94185085"", ""61025402"", ""282411225"", ""373047072"", ""43157410"", ""2893095517"", ""37320198"", ""78465328"", ""279161209"", ""2852925778"", ""264333941"", ""857121152"", ""535554692"", ""25682551"", ""84135023"", ""257580694"", ""20989433"", ""322699008"", ""2162983369"", ""241171683"", ""411902451"", ""1169981382"", ""113682461"", ""196167865"", ""482449024"", ""378642998"", ""2619037738"", ""575857218"", ""55075272"", ""22556795"", ""1151095778"", ""2590165561"", ""23951702"", ""1720757281"", ""26028952"", ""90173213"", ""715539325"", ""303328398"", ""406842374"", ""1902151532"", ""19811220"", ""718337384"", ""69141993"", ""361022019"", ""1311199069"", ""45518891"", ""52571657"", ""414598744"", ""24598043"", ""23186530"", ""290005817"", ""531633071"", ""1514163732"", ""1584035035"", ""2833154944"", ""1157168911"", ""2614565633"", ""299190586"", ""27414346"", ""24980793"", ""388511114"", ""450043127"", ""907030550"", ""2357327292"", ""2272348681""]",0,8,8
16491845,2,67.0,-0.5459967851638794,2023292.0,2,0.5,"[""charliehebdo-all-rnr-threads"", ""sydneysiege-all-rnr-threads""]","[""17995040"", ""16834659""]",1,1,2
23951702,5,101.4,-0.33498884439468385,2210745.0,3,0.0,"[""charliehebdo-all-rnr-threads"", ""sydneysiege-all-rnr-threads""]","[""35051304"", ""17995040"", ""149913262""]",0,5,5
388511114,4,46.5,-0.2105008363723755,1984282.0,2,0.75,"[""charliehebdo-all-rnr-threads"", ""sydneysiege-all-rnr-threads""]","[""292777349"", ""17995040""]",3,1,4
239378797,11,121.18181818181819,-0.5403774543242021,6744565.0,2,0.0,"[""charliehebdo-all-rnr-threads"", ""ottawashooting-all-rnr-threads""]","[""88734887"", ""17175213""]",0,11,11
402738328,17,43.64705882352941,0.016279469518100508,2354081.0,11,0.17647058823529413,"[""charliehebdo-all-rnr-threads"", ""sydneysiege-all-rnr-threads""]","[""55911799"", ""21733692"", ""171802941"", ""7587032"", ""47707475"", ""380648579"", ""6017542"", ""23055689"", ""16675569"", ""491960101"", ""17175213""]",3,14,17
273465530,3,103.0,-0.32352544864018756,1986439.0,2,0.0,"[""charliehebdo-all-rnr-threads"", ""sydneysiege-all-rnr-threads""]","[""428333"", ""5402612""]",0,3,3
617854798,3,130.33333333333334,-0.36863001187642414,12487343.0,11,0.0,"[""charliehebdo-all-rnr-threads"", ""ferguson-all-rnr-threads""]","[""36736486"", ""2902031436"", ""15146390"", ""39559838"", ""573788425"", ""2382422754"", ""610832549"", ""22662704"", ""610829574"", ""124453808"", ""335871995""]",0,3,3
610829574,3,65.33333333333333,-0.3000916838645935,6557999.0,2,0.6666666666666666,"[""charliehebdo-all-rnr-threads"", ""germanwings-crash-all-rnr-threads""]","[""134196350"", ""617854798""]",2,1,3
107763179,10,122.7,-0.18151718378067017,12665889.0,2,0.0,"[""charliehebdo-all-rnr-threads"", ""ferguson-all-rnr-threads""]","[""11265832"", ""338335964""]",0,10,10
2462584339,7,98.0,0.15431737899780273,12651893.0,2,0.0,"[""charliehebdo-all-rnr-threads"", ""ferguson-all-rnr-threads""]","[""254873869"", ""11265832""]",0,7,7
420176985,13,77.23076923076923,-0.18216169797457182,2037144.0,5,0.6923076923076923,"[""charliehebdo-all-rnr-threads"", ""sydneysiege-all-rnr-threads""]","[""246758084"", ""16834659"", ""25210650"", ""2768501"", ""793879086""]",9,4,13
1278184561,2,33.5,-0.022344350814819336,1981460.0,2,0.0,"[""charliehebdo-all-rnr-threads"", ""sydneysiege-all-rnr-threads""]","[""19150955"", ""312696314""]",0,2,2
2491845824,2,91.0,-0.4407460689544678,6624539.0,1,0.5,"[""charliehebdo-all-rnr-threads"", ""ottawashooting-all-rnr-threads""]","[""635608354""]",1,1,2
2372174178,3,128.33333333333334,0.1912518342336019,5711929.0,3,0.0,"[""charliehebdo-all-rnr-threads"", ""putinmissing-all-rnr-threads""]","[""3039217745"", ""938829744"", ""635608354""]",0,3,3
234155392,2,41.5,0.09919893741607666,6631732.0,1,0.0,"[""charliehebdo-all-rnr-threads"", ""ottawashooting-all-rnr-threads""]","[""635608354""]",0,2,2
17078422,6,123.66666666666667,0.05407226085662842,6632603.0,1,0.16666666666666666,"[""charliehebdo-all-rnr-threads"", ""ottawashooting-all-rnr-threads""]","[""635608354""]",1,5,6
628783043,2,139.5,-0.24908447265625,1986726.0,2,0.0,"[""charliehebdo-all-rnr-threads"", ""sydneysiege-all-rnr-threads""]","[""1960878613"", ""280346532""]",0,2,2
2229646347,5,103.6,-0.2556428909301758,12669263.0,3,0.0,"[""charliehebdo-all-rnr-threads"", ""ferguson-all-rnr-threads""]","[""183341278"", ""164397041"", ""22063600""]",0,5,5
222184684,2,81.0,-0.39193928241729736,2032393.0,2,0.5,"[""charliehebdo-all-rnr-threads"", ""sydneysiege-all-rnr-threads""]","[""3108351"", ""375721095""]",1,1,2
2734110151,8,120.375,-0.6276859268546104,2244386.0,3,0.125,"[""charliehebdo-all-rnr-threads"", ""sydneysiege-all-rnr-threads""]","[""2758691533"", ""268662889"", ""427748930""]",1,7,8
359187177,12,124.33333333333333,-0.08416361113389333,2226575.0,2,0.0,"[""charliehebdo-all-rnr-threads"", ""sydneysiege-all-rnr-threads""]","[""2758691533"", ""711348452""]",0,12,12
961385502,2,89.5,-0.3884018659591675,2227263.0,2,0.5,"[""charliehebdo-all-rnr-threads"", ""sydneysiege-all-rnr-threads""]","[""76628896"", ""2758691533""]",1,1,2
119058143,2,111.5,-0.631022185087204,1986982.0,2,0.0,"[""charliehebdo-all-rnr-threads"", ""sydneysiege-all-rnr-threads""]","[""358127438"", ""19899606""]",0,2,2
20136892,3,94.0,-0.37982698281606037,2010672.0,25,0.0,"[""charliehebdo-all-rnr-threads"", ""sydneysiege-all-rnr-threads""]","[""40422510"", ""610361577"", ""1370252941"", ""262325178"", ""17534514"", ""19496638"", ""25029562"", ""408376159"", ""80009464"", ""1546921225"", ""29709142"", ""38243468"", ""2447863003"", ""19508700"", ""18883978"", ""374419022"", ""1553907199"", ""39228511"", ""558802194"", ""184443817"", ""28131012"", ""20136892"", ""23610946"", ""309930155"", ""20132974""]",0,3,3
311828651,2,75.5,-0.6330354511737823,13000874.0,2,0.0,"[""charliehebdo-all-rnr-threads"", ""ferguson-all-rnr-threads""]","[""33388399"", ""35866054""]",0,2,2
131582916,6,138.83333333333334,-0.5844197968641917,2022288.0,5,0.16666666666666666,"[""charliehebdo-all-rnr-threads"", ""sydneysiege-all-rnr-threads""]","[""1289847366"", ""202934450"", ""21548431"", ""2163076560"", ""33388399""]",1,5,6
69335456,2,86.0,-0.3348848223686218,6631249.0,2,0.0,"[""charliehebdo-all-rnr-threads"", ""ottawashooting-all-rnr-threads""]","[""33388399"", ""628043""]",0,2,2
2431432212,11,78.72727272727273,-0.28190164132551715,6776009.0,9,0.2727272727272727,"[""charliehebdo-all-rnr-threads"", ""ottawashooting-all-rnr-threads""]","[""25110374"", ""19038934"", ""3108351"", ""33388399"", ""272172091"", ""193725962"", ""16299754"", ""203123011"", ""82120358""]",3,8,11
1599700260,6,119.16666666666667,-0.6240872740745544,5734130.0,3,0.16666666666666666,"[""charliehebdo-all-rnr-threads"", ""putinmissing-all-rnr-threads""]","[""7702542"", ""10774652"", ""228871317""]",1,5,6
2871588796,4,44.25,0.2015036940574646,2032958.0,3,0.25,"[""charliehebdo-all-rnr-threads"", ""sydneysiege-all-rnr-threads""]","[""3108351"", ""520011678"", ""16973333""]",1,3,4
1263002017,39,124.28205128205128,-0.3466286796789903,13505092.0,22,0.20512820512820512,"[""charliehebdo-all-rnr-threads"", ""germanwings-crash-all-rnr-threads"", ""ottawashooting-all-rnr-threads"", ""sydneysiege-all-rnr-threads""]","[""2958753946"", ""1309728793"", ""1263002017"", ""341096741"", ""2711210473"", ""1273060586"", ""2428257248"", ""14260960"", ""1918468500"", ""1927283102"", ""16031927"", ""2787064885"", ""28096105"", ""345071560"", ""754571738"", ""358347117"", ""78749859"", ""17537467"", ""2713044184"", ""2739754470"", ""2777537827"", ""2527815351""]",8,31,39
728542435,8,99.75,-0.32149213552474976,2174924.0,5,0.0,"[""charliehebdo-all-rnr-threads"", ""sydneysiege-all-rnr-threads""]","[""20973388"", ""183767243"", ""254873869"", ""17537467"", ""11741632""]",0,8,8
26552390,50,119.92,-0.3623611569404602,2045109.0,4,0.46,"[""charliehebdo-all-rnr-threads"", ""sydneysiege-all-rnr-threads""]","[""39599748"", ""17537467"", ""15669672"", ""258627226""]",23,27,50
1485192062,10,117.9,-0.19866966605186462,2000460.0,3,0.1,"[""charliehebdo-all-rnr-threads"", ""sydneysiege-all-rnr-threads""]","[""6017542"", ""17537467"", ""20878297""]",1,9,10
884724134,6,81.16666666666667,-0.36350146929423016,6651193.0,2,0.0,"[""charliehebdo-all-rnr-threads"", ""ottawashooting-all-rnr-threads""]","[""17537467"", ""1702119050""]",0,6,6
1359226843,15,99.0,-0.2135586579640707,6613969.0,19,0.0,"[""charliehebdo-all-rnr-threads"", ""ottawashooting-all-rnr-threads"", ""sydneysiege-all-rnr-threads""]","[""19899606"", ""2378713202"", ""2758351305"", ""21051642"", ""280489306"", ""2378914268"", ""20043786"", ""150974182"", ""255170102"", ""1359226843"", ""1730831946"", ""1329199266"", ""18373898"", ""2163076560"", ""358347117"", ""192852583"", ""17537467"", ""2237451721"", ""292074881""]",0,15,15
433851538,10,117.6,-0.06712310314178467,12526637.0,2,0.0,"[""charliehebdo-all-rnr-threads"", ""ferguson-all-rnr-threads""]","[""17537467"", ""195271137""]",0,10,10
2270640056,3,113.33333333333333,-0.27860188484191895,2003794.0,21,0.0,"[""charliehebdo-all-rnr-threads"", ""sydneysiege-all-rnr-threads""]","[""335871995"", ""2963992696"", ""496723"", ""31698713"", ""1963541156"", ""591571749"", ""2174759425"", ""1693961953"", ""1455720032"", ""462788656"", ""292647591"", ""1559012298"", ""476473173"", ""308373783"", ""382561656"", ""140542416"", ""64924719"", ""66966924"", ""72519468"", ""2270640056"", ""808671523""]",0,3,3
1561720554,8,92.125,-0.5397258251905441,2208781.0,3,0.125,"[""charliehebdo-all-rnr-threads"", ""sydneysiege-all-rnr-threads""]","[""36311109"", ""87818409"", ""28287525""]",1,7,8
2493142851,2,43.0,-0.07210499048233032,6637450.0,2,0.5,"[""charliehebdo-all-rnr-threads"", ""ottawashooting-all-rnr-threads""]","[""2097571"", ""5402612""]",1,1,2
746980435,3,89.0,0.36213962237040204,1995265.0,3,0.3333333333333333,"[""charliehebdo-all-rnr-threads"", ""sydneysiege-all-rnr-threads""]","[""21748597"", ""7587032"", ""2097571""]",1,2,3
331393536,2,88.5,-0.40419453382492065,1980495.0,2,0.5,"[""charliehebdo-all-rnr-threads"", ""sydneysiege-all-rnr-threads""]","[""47624589"", ""87261221""]",1,1,2
961605296,32,109.21875,-0.33166520297527313,6786502.0,7,0.0625,"[""charliehebdo-all-rnr-threads"", ""ottawashooting-all-rnr-threads""]","[""47624589"", ""20304663"", ""295431169"", ""171953871"", ""48322782"", ""18999969"", ""14260960""]",2,30,32
34945490,2,134.5,-0.12645885348320007,1996003.0,2,0.0,"[""charliehebdo-all-rnr-threads"", ""sydneysiege-all-rnr-threads""]","[""742143"", ""1562935142""]",0,2,2
389548615,10,133.4,-0.11869373917579651,6560197.0,9,0.1,"[""charliehebdo-all-rnr-threads"", ""germanwings-crash-all-rnr-threads""]","[""927285830"", ""15234407"", ""30313925"", ""1562935142"", ""373416209"", ""3108351"", ""372502604"", ""972651"", ""14353202""]",1,9,10
2925094346,8,69.625,-0.2233980968594551,2224587.0,8,0.5,"[""charliehebdo-all-rnr-threads"", ""sydneysiege-all-rnr-threads""]","[""22129280"", ""15907183"", ""1562935142"", ""171802941"", ""87416722"", ""375721095"", ""15250661"", ""86516574""]",4,4,8
594976909,5,122.2,-0.4854426860809326,12650248.0,4,0.0,"[""charliehebdo-all-rnr-threads"", ""ferguson-all-rnr-threads""]","[""16343974"", ""14700316"", ""312696314"", ""17152053""]",0,5,5
2494237140,7,98.0,-0.17186624663216726,12608678.0,4,0.2857142857142857,"[""charliehebdo-all-rnr-threads"", ""ferguson-all-rnr-threads""]","[""373783051"", ""18725815"", ""277501298"", ""114479860""]",2,5,7
460705232,6,80.83333333333333,-0.5149747530619303,8541158.0,4,0.5,"[""charliehebdo-all-rnr-threads"", ""putinmissing-all-rnr-threads"", ""germanwings-crash-all-rnr-threads"", ""sydneysiege-all-rnr-threads""]","[""46078438"", ""2280470022"", ""64643056"", ""807095""]",3,3,6
198553539,17,111.41176470588235,-0.4300914687268874,2111858.0,6,0.0,"[""charliehebdo-all-rnr-threads"", ""sydneysiege-all-rnr-threads""]","[""46078438"", ""106118793"", ""46688460"", ""20043786"", ""31135856"", ""175452918""]",0,17,17
464989725,2,69.0,-0.3294033408164978,2010769.0,2,0.5,"[""charliehebdo-all-rnr-threads"", ""sydneysiege-all-rnr-threads""]","[""459390022"", ""64643056""]",1,1,2
313542861,3,104.66666666666667,-0.47653170426686603,6617142.0,2,0.0,"[""charliehebdo-all-rnr-threads"", ""ottawashooting-all-rnr-threads""]","[""148653311"", ""459390022""]",0,3,3
351889336,4,56.25,-0.22359439730644226,6691065.0,4,0.0,"[""charliehebdo-all-rnr-threads"", ""ottawashooting-all-rnr-threads"", ""sydneysiege-all-rnr-threads""]","[""22021978"", ""148653311"", ""16343974"", ""459390022""]",0,4,4
33169889,2,90.0,-0.8090295791625977,6732483.0,2,0.5,"[""charliehebdo-all-rnr-threads"", ""germanwings-crash-all-rnr-threads""]","[""117366399"", ""87416722""]",1,1,2
66367082,11,93.63636363636364,-0.0956405834718184,5800735.0,5,0.36363636363636365,"[""charliehebdo-all-rnr-threads"", ""putinmissing-all-rnr-threads""]","[""138749160"", ""117366399"", ""2197547646"", ""988324790"", ""5402612""]",4,7,11
2573619805,4,68.5,-0.23152998089790344,2036688.0,4,0.25,"[""charliehebdo-all-rnr-threads"", ""sydneysiege-all-rnr-threads""]","[""15400294"", ""24157295"", ""742143"", ""5988062""]",1,3,4
317743589,6,60.0,-0.0869000752766927,2136398.0,4,0.16666666666666666,"[""charliehebdo-all-rnr-threads"", ""sydneysiege-all-rnr-threads""]","[""15400294"", ""24157295"", ""454099919"", ""196994616""]",1,5,6
986509249,22,118.77272727272727,-0.24809802391312338,6632409.0,3,0.0,"[""charliehebdo-all-rnr-threads"", ""ottawashooting-all-rnr-threads""]","[""47707475"", ""2467791"", ""607946179""]",0,22,22
98350238,3,116.66666666666667,-0.636324147383372,2334094.0,3,0.3333333333333333,"[""charliehebdo-all-rnr-threads"", ""sydneysiege-all-rnr-threads""]","[""5402612"", ""16973333"", ""607946179""]",1,2,3
36927988,2,82.5,0.1250324249267578,6645359.0,2,0.0,"[""charliehebdo-all-rnr-threads"", ""ottawashooting-all-rnr-threads""]","[""47624589"", ""16469809""]",0,2,2
28833436,5,121.0,-0.1858752965927124,12529540.0,5,0.6,"[""charliehebdo-all-rnr-threads"", ""sydneysiege-all-rnr-threads"", ""ferguson-all-rnr-threads""]","[""47624589"", ""9507342"", ""22931893"", ""14090948"", ""22129280""]",3,2,5
86392086,3,60.666666666666664,-0.7833573420842489,6655290.0,3,0.3333333333333333,"[""charliehebdo-all-rnr-threads"", ""ottawashooting-all-rnr-threads""]","[""47624589"", ""282977213"", ""63105173""]",1,2,3
2659964124,3,105.66666666666667,-0.5175338983535767,2438463.0,3,0.3333333333333333,"[""charliehebdo-all-rnr-threads"", ""sydneysiege-all-rnr-threads""]","[""47624589"", ""171802941"", ""269167743""]",1,2,3
1708484107,2,49.5,-0.07848569750785828,2003464.0,2,0.0,"[""charliehebdo-all-rnr-threads"", ""sydneysiege-all-rnr-threads""]","[""29465136"", ""58467371""]",0,2,2
2566015532,7,94.14285714285714,-0.4039255040032523,6809055.0,7,0.2857142857142857,"[""charliehebdo-all-rnr-threads"", ""ottawashooting-all-rnr-threads"", ""sydneysiege-all-rnr-threads""]","[""443146128"", ""1020058453"", ""29465136"", ""21998314"", ""855180008"", ""164397041"", ""5402612""]",2,5,7
468758663,5,89.4,-0.34451344013214114,5834531.0,3,0.2,"[""charliehebdo-all-rnr-threads"", ""putinmissing-all-rnr-threads""]","[""47992292"", ""168376502"", ""239964092""]",1,4,5
169775701,3,84.0,-0.11047681172688802,12526852.0,2,0.3333333333333333,"[""charliehebdo-all-rnr-threads"", ""ferguson-all-rnr-threads""]","[""16589206"", ""160241472""]",1,2,3
1585970245,27,124.5925925925926,-0.4456003926418446,2237684.0,8,0.0,"[""charliehebdo-all-rnr-threads"", ""sydneysiege-all-rnr-threads""]","[""16973333"", ""14293310"", ""16589206"", ""259323371"", ""7587032"", ""491344675"", ""246860689"", ""24506246""]",0,27,27
378420614,4,74.75,-0.0914880782365799,8558349.0,3,0.25,"[""charliehebdo-all-rnr-threads"", ""germanwings-crash-all-rnr-threads"", ""sydneysiege-all-rnr-threads""]","[""2280470022"", ""16589206"", ""206979151""]",1,3,4
84429722,5,134.6,-0.7119195461273193,6566619.0,4,0.2,"[""charliehebdo-all-rnr-threads"", ""germanwings-crash-all-rnr-threads""]","[""1652541"", ""759251"", ""1367531"", ""7587032""]",1,4,5
427182981,2,30.5,-0.8832883238792419,1987639.0,2,0.0,"[""charliehebdo-all-rnr-threads"", ""sydneysiege-all-rnr-threads""]","[""3108351"", ""759251""]",0,2,2
359136927,2,75.0,-0.11815285682678223,1982714.0,2,0.0,"[""charliehebdo-all-rnr-threads"", ""sydneysiege-all-rnr-threads""]","[""17537467"", ""76858507""]",0,2,2
103588513,3,98.66666666666667,-0.6239437460899353,2010681.0,3,0.3333333333333333,"[""charliehebdo-all-rnr-threads"", ""sydneysiege-all-rnr-threads""]","[""17537467"", ""763156754"", ""375721095""]",1,2,3
635444177,2,111.0,-0.41793063282966614,2033358.0,2,0.0,"[""charliehebdo-all-rnr-threads"", ""sydneysiege-all-rnr-threads""]","[""22021978"", ""17537467""]",0,2,2
2168110979,3,104.33333333333333,-0.5342676440874735,2032187.0,3,0.0,"[""charliehebdo-all-rnr-threads"", ""sydneysiege-all-rnr-threads""]","[""17537467"", ""419520517"", ""5402612""]",0,3,3
1425756199,23,112.73913043478261,-0.49479427544966986,1993045.0,4,0.0,"[""charliehebdo-all-rnr-threads"", ""sydneysiege-all-rnr-threads""]","[""46078438"", ""31135856"", ""41789292"", ""374712154""]",0,23,23
1889179298,2,106.5,0.012791574001312256,1982747.0,2,0.0,"[""charliehebdo-all-rnr-threads"", ""sydneysiege-all-rnr-threads""]","[""31135856"", ""177886974""]",0,2,2
112556567,6,117.5,-0.5172538856665293,2198690.0,2,0.0,"[""charliehebdo-all-rnr-threads"", ""sydneysiege-all-rnr-threads""]","[""20043786"", ""31135856""]",0,6,6
14260960,2,111.5,0.7649761438369751,1988751.0,36,0.0,"[""charliehebdo-all-rnr-threads"", ""sydneysiege-all-rnr-threads""]","[""165382079"", ""2314092451"", ""24304902"", ""145021125"", ""2650967767"", ""164599226"", ""1263002017"", ""429936555"", ""961605296"", ""1448600947"", ""2278107686"", ""307835686"", ""2284428180"", ""148508453"", ""1230267290"", ""576539791"", ""1390465688"", ""2847359343"", ""565978620"", ""2888321602"", ""1029611648"", ""99176358"", ""2209557522"", ""1061358956"", ""303896480"", ""2424536971"", ""243912778"", ""441097962"", ""2823431555"", ""361456549"", ""1427757265"", ""2370392006"", ""1526215092"", ""700379942"", ""17537467"", ""2475818118""]",0,2,2
2475818118,4,118.25,-0.46863195300102234,6746119.0,4,0.5,"[""charliehebdo-all-rnr-threads"", ""ottawashooting-all-rnr-threads""]","[""275686563"", ""274831602"", ""27825918"", ""14260960""]",2,2,4
24304902,3,121.66666666666667,-0.034978767236073814,2086128.0,3,0.0,"[""charliehebdo-all-rnr-threads"", ""sydneysiege-all-rnr-threads""]","[""146218381"", ""76858507"", ""14260960""]",0,3,3
303896480,12,76.25,-0.08827753861745197,2155967.0,4,0.0,"[""charliehebdo-all-rnr-threads"", ""sydneysiege-all-rnr-threads""]","[""2566535282"", ""7587032"", ""556633808"", ""14260960""]",0,12,12
1061358956,8,112.25,-0.26352109014987946,2117133.0,3,0.25,"[""charliehebdo-all-rnr-threads"", ""sydneysiege-all-rnr-threads""]","[""21866939"", ""17537467"", ""14260960""]",2,6,8
1427757265,3,101.33333333333333,-0.1373978058497111,12476125.0,7,0.6666666666666666,"[""charliehebdo-all-rnr-threads"", ""putinmissing-all-rnr-threads"", ""ottawashooting-all-rnr-threads""]","[""359138243"", ""1571902008"", ""168687116"", ""2739792487"", ""2266295418"", ""14260960"", ""534929951""]",2,1,3
1448600947,5,127.8,-0.5876065492630005,6643392.0,2,0.2,"[""charliehebdo-all-rnr-threads"", ""ottawashooting-all-rnr-threads""]","[""375721095"", ""14260960""]",1,4,5
1230267290,9,123.33333333333333,-0.6091569463411967,6803580.0,6,0.1111111111111111,"[""charliehebdo-all-rnr-threads"", ""ottawashooting-all-rnr-threads""]","[""518991950"", ""17537467"", ""16106584"", ""19038934"", ""14260960"", ""531902156""]",1,8,9
164599226,14,108.07142857142857,-0.16129440069198608,2056476.0,2,0.7142857142857143,"[""charliehebdo-all-rnr-threads"", ""sydneysiege-all-rnr-threads""]","[""21866939"", ""14260960""]",10,4,14
2886799455,9,64.11111111111111,-0.36871016025543213,2101594.0,5,0.7777777777777778,"[""charliehebdo-all-rnr-threads"", ""sydneysiege-all-rnr-threads""]","[""22993014"", ""19318739"", ""171802941"", ""49592004"", ""15012486""]",7,2,9
518298417,3,98.66666666666667,-0.6657893459002177,2012850.0,2,0.0,"[""charliehebdo-all-rnr-threads"", ""sydneysiege-all-rnr-threads""]","[""2286056016"", ""1920286333""]",0,3,3
1420787767,4,133.75,-0.3766282796859741,12528302.0,3,0.75,"[""charliehebdo-all-rnr-threads"", ""ferguson-all-rnr-threads""]","[""14173315"", ""759251"", ""164397041""]",3,1,4
30829833,2,102.0,0.13620370626449585,6560790.0,2,0.5,"[""charliehebdo-all-rnr-threads"", ""germanwings-crash-all-rnr-threads""]","[""15438913"", ""164397041""]",1,1,2
1246499706,5,73.6,-0.18064355850219727,2037969.0,2,0.8,"[""charliehebdo-all-rnr-threads"", ""sydneysiege-all-rnr-threads""]","[""164397041"", ""9609632""]",4,1,5
484595690,4,59.25,-0.4191475361585617,2074840.0,3,0.0,"[""charliehebdo-all-rnr-threads"", ""sydneysiege-all-rnr-threads""]","[""380285402"", ""87818409"", ""164397041""]",0,4,4
2771542204,5,134.2,-0.6391105651855469,2180867.0,5,0.0,"[""charliehebdo-all-rnr-threads"", ""sydneysiege-all-rnr-threads""]","[""16973333"", ""7587032"", ""4970411"", ""16343974"", ""87818409""]",0,5,5
194160226,6,104.83333333333333,-0.625567783912023,2034762.0,5,0.16666666666666666,"[""charliehebdo-all-rnr-threads"", ""sydneysiege-all-rnr-threads""]","[""366819502"", ""3108351"", ""43182702"", ""64643056"", ""855180008""]",1,5,6
756445699,5,112.8,-0.320283305644989,6660921.0,2,0.0,"[""charliehebdo-all-rnr-threads"", ""ottawashooting-all-rnr-threads""]","[""16076032"", ""366819502""]",0,5,5
1630361768,5,140.4,0.18352773189544677,1982862.0,2,0.2,"[""charliehebdo-all-rnr-threads"", ""sydneysiege-all-rnr-threads""]","[""39599748"", ""64643056""]",1,4,5
619276411,2,92.0,-0.5212048590183258,1979235.0,2,0.0,"[""charliehebdo-all-rnr-threads"", ""sydneysiege-all-rnr-threads""]","[""271413771"", ""17537467""]",0,2,2
292629799,21,107.42857142857143,-0.4142951738266718,6820848.0,10,0.7142857142857143,"[""charliehebdo-all-rnr-threads"", ""ottawashooting-all-rnr-threads"", ""sydneysiege-all-rnr-threads""]","[""1008392934"", ""272388054"", ""1652541"", ""1367531"", ""16811829"", ""807095"", ""495464885"", ""375721095"", ""203123011"", ""5402612""]",15,6,21
20891396,7,118.85714285714286,-0.5722612908908299,2032393.0,59,0.0,"[""charliehebdo-all-rnr-threads"", ""sydneysiege-all-rnr-threads""]","[""2620831379"", ""272418128"", ""1605531337"", ""2370378739"", ""1635183072"", ""895436396"", ""145051504"", ""142885184"", ""1416070489"", ""208425829"", ""2713259612"", ""2244196914"", ""373146268"", ""587935398"", ""2850222358"", ""29621377"", ""2284428180"", ""15189196"", ""2354718919"", ""376884268"", ""190226961"", ""59612612"", ""75192299"", ""1377307112"", ""283212121"", ""64430687"", ""272174052"", ""55769601"", ""44333533"", ""27192561"", ""479432173"", ""22025945"", ""133302400"", ""112339194"", ""43644895"", ""1542962611"", ""2802123164"", ""605136938"", ""20891396"", ""23073327"", ""553533504"", ""603055879"", ""110670989"", ""110328233"", ""272748593"", ""2827694780"", ""438149280"", ""2484888469"", ""18191382"", ""239769093"", ""237196527"", ""723090685"", ""2245099266"", ""897581515"", ""52309360"", ""26507081"", ""38808541"", ""31062489"", ""29024707""]",0,7,7
2484888469,8,92.875,-0.37742728739976883,6789019.0,3,0.125,"[""charliehebdo-all-rnr-threads"", ""ottawashooting-all-rnr-threads"", ""sydneysiege-all-rnr-threads""]","[""19636948"", ""14460241"", ""20891396""]",1,7,8
1615069758,4,133.75,-0.24407824873924255,2025123.0,3,0.0,"[""charliehebdo-all-rnr-threads"", ""sydneysiege-all-rnr-threads""]","[""151432737"", ""177886974"", ""17537467""]",0,4,4
117510407,6,110.0,-0.38852595289548236,2154274.0,3,0.0,"[""charliehebdo-all-rnr-threads"", ""sydneysiege-all-rnr-threads""]","[""15438913"", ""2467959607"", ""9609632""]",0,6,6
36157190,3,123.33333333333333,-0.6651993791262308,6657942.0,3,0.3333333333333333,"[""charliehebdo-all-rnr-threads"", ""ottawashooting-all-rnr-threads""]","[""47624589"", ""18725815"", ""5402612""]",1,2,3
1877831,7,125.71428571428571,-0.043074113982064385,6827569.0,71,0.2857142857142857,"[""charliehebdo-all-rnr-threads"", ""ottawashooting-all-rnr-threads""]","[""15236329"", ""447998694"", ""2525443105"", ""376251258"", ""2769965322"", ""81260589"", ""57070379"", ""2772543686"", ""856442948"", ""354340947"", ""945988664"", ""19284721"", ""506958753"", ""2826961293"", ""15162715"", ""1176823969"", ""737304938"", ""2960521242"", ""145480589"", ""556355482"", ""543668252"", ""2875710435"", ""374974105"", ""396840637"", ""560331127"", ""628038157"", ""290677808"", ""2571833844"", ""387516768"", ""48304732"", ""18945060"", ""2923601265"", ""368229001"", ""9748652"", ""133277792"", ""306155621"", ""2495613440"", ""17774475"", ""2780648743"", ""2336979283"", ""2859783599"", ""185947193"", ""26901394"", ""2945865278"", ""2423592374"", ""488522254"", ""11203972"", ""2875761863"", ""2750347930"", ""359602169"", ""1137986071"", ""2968630504"", ""2859825620"", ""2889009596"", ""2484313128"", ""2738912233"", ""279788564"", ""345977161"", ""22336731"", ""202181866"", ""2689665578"", ""2550296946"", ""571318831"", ""149913262"", ""22096507"", ""154575265"", ""2173535357"", ""1637236532"", ""1195666020"", ""1857982483"", ""126307627""]",2,5,7
2525443105,7,119.71428571428571,-0.07776400021144322,2093045.0,3,0.0,"[""charliehebdo-all-rnr-threads"", ""sydneysiege-all-rnr-threads""]","[""6107422"", ""612473"", ""1877831""]",0,7,7
1901945432,2,45.0,0.5633151531219482,2183040.0,2,0.0,"[""charliehebdo-all-rnr-threads"", ""sydneysiege-all-rnr-threads""]","[""87012901"", ""1626294277""]",0,2,2
24293233,10,119.0,-0.19355181455612183,6717298.0,15,0.9,"[""charliehebdo-all-rnr-threads"", ""germanwings-crash-all-rnr-threads""]","[""92248316"", ""1177632823"", ""1899052010"", ""262403030"", ""1610636060"", ""148742689"", ""93118049"", ""2687803879"", ""119788492"", ""27413161"", ""3029140895"", ""133307746"", ""87012901"", ""24293233"", ""2451418584""]",9,1,10
16164636,5,136.2,-0.05601856708526611,12746767.0,23,0.0,"[""charliehebdo-all-rnr-threads"", ""ferguson-all-rnr-threads""]","[""420481816"", ""982953108"", ""1199712426"", ""587935398"", ""14289960"", ""1936402993"", ""364237570"", ""121293604"", ""30377443"", ""865806026"", ""1656207200"", ""18733823"", ""851681"", ""424284015"", ""9745992"", ""74214410"", ""43527209"", ""310065187"", ""20890466"", ""860648802"", ""262234378"", ""16164636"", ""273510876""]",0,5,5
27673910,4,99.75,-0.46390481293201447,12752530.0,2,0.0,"[""charliehebdo-all-rnr-threads"", ""ferguson-all-rnr-threads""]","[""14090948"", ""807095""]",0,4,4
2762288549,2,138.0,-0.5072231888771057,2034871.0,2,0.5,"[""charliehebdo-all-rnr-threads"", ""sydneysiege-all-rnr-threads""]","[""393469195"", ""807095""]",1,1,2
60438114,2,101.0,-0.5457504093647003,6556397.0,1,0.0,"[""charliehebdo-all-rnr-threads"", ""germanwings-crash-all-rnr-threads""]","[""759251""]",0,2,2
30626499,2,95.5,-0.19859737157821655,6650448.0,2,0.0,"[""charliehebdo-all-rnr-threads"", ""ottawashooting-all-rnr-threads""]","[""34310801"", ""759251""]",0,2,2
2675168874,6,133.33333333333334,-0.22637550036112467,2116562.0,4,0.0,"[""charliehebdo-all-rnr-threads"", ""sydneysiege-all-rnr-threads""]","[""134758540"", ""17741799"", ""162304163"", ""47685065""]",0,6,6
457437029,2,79.5,0.20348799228668213,2039648.0,2,0.5,"[""charliehebdo-all-rnr-threads"", ""sydneysiege-all-rnr-threads""]","[""868112707"", ""258627226""]",1,1,2
23813725,2,117.5,-0.24454742670059204,12522417.0,2,0.0,"[""charliehebdo-all-rnr-threads"", ""ferguson-all-rnr-threads""]","[""16153562"", ""868112707""]",0,2,2
2329326803,2,44.0,-0.28043627738952637,12526828.0,2,0.5,"[""charliehebdo-all-rnr-threads"", ""ferguson-all-rnr-threads""]","[""20772763"", ""47624589""]",1,1,2
1020058453,16,125.3125,-0.45765718817710876,8728336.0,130,0.5,"[""charliehebdo-all-rnr-threads"", ""germanwings-crash-all-rnr-threads"", ""sydneysiege-all-rnr-threads""]","[""14386498"", ""632640024"", ""242288412"", ""22435220"", ""532718922"", ""325258622"", ""25878097"", ""2456554040"", ""81302078"", ""478517996"", ""37414833"", ""248819855"", ""2240152467"", ""2938957559"", ""2861501732"", ""24793351"", ""42450774"", ""451597298"", ""2728383994"", ""132211919"", ""345678493"", ""324913775"", ""126596090"", ""809929356"", ""340356444"", ""117197185"", ""241786512"", ""2826298020"", ""188215370"", ""65520623"", ""291536737"", ""156334907"", ""15224425"", ""2206111621"", ""288721765"", ""2329758242"", ""137055786"", ""42951393"", ""19750998"", ""615420539"", ""61304417"", ""46472191"", ""17971617"", ""2761454466"", ""146606190"", ""135239971"", ""1130260891"", ""233626665"", ""45937599"", ""93310294"", ""144575681"", ""2216532829"", ""747803802"", ""65551087"", ""1060791397"", ""9550352"", ""517656712"", ""2900321062"", ""27625408"", ""2691420776"", ""174056332"", ""499568043"", ""2788448292"", ""2406353654"", ""209048522"", ""1610238266"", ""57582817"", ""2965126679"", ""108416118"", ""2566015532"", ""50791051"", ""504897651"", ""744266600"", ""2545900439"", ""2708850794"", ""94383892"", ""1535932902"", ""1483851038"", ""27285496"", ""943538226"", ""711085843"", ""2464502209"", ""922238564"", ""469365053"", ""33004556"", ""392421897"", ""1511796361"", ""1027408974"", ""21097468"", ""165768368"", ""1345618585"", ""102138959"", ""13753852"", ""932642034"", ""29209963"", ""9807472"", ""308147569"", ""2244969159"", ""2850914339"", ""63530868"", ""996952393"", ""241949363"", ""2925159691"", ""2746304403"", ""239120230"", ""176641847"", ""47940576"", ""66852479"", ""2868958838"", ""185512977"", ""24804145"", ""51894187"", ""18522298"", ""68435452"", ""628146343"", ""97465315"", ""25662129"", ""2885348567"", ""752495724"", ""558127365"", ""18931723"", ""2336664121"", ""1630953235"", ""522541696"", ""18014484"", ""548625799"", ""757738458"", ""938543239"", ""2776171557"", ""215047013""]",8,8,16
149913262,12,118.91666666666667,-0.36528902252515155,6828845.0,131,0.0,"[""charliehebdo-all-rnr-threads"", ""ottawashooting-all-rnr-threads"", ""sydneysiege-all-rnr-threads""]","[""2535168234"", ""209794571"", ""905019768"", ""1176480541"", ""153451584"", ""1963639454"", ""588640557"", ""1028647111"", ""1336896247"", ""2863774500"", ""358346497"", ""981120547"", ""455724651"", ""49964679"", ""2773630787"", ""831125178"", ""774153380"", ""457264650"", ""1667908610"", ""860616002"", ""28985499"", ""24772220"", ""1212459181"", ""706914554"", ""409389563"", ""919458265"", ""21541548"", ""22954683"", ""627911726"", ""94481411"", ""861712795"", ""168418797"", ""481458568"", ""106278712"", ""323188665"", ""47967486"", ""25596884"", ""237488620"", ""82412657"", ""15740635"", ""24581337"", ""436407665"", ""1716417475"", ""16340042"", ""281157107"", ""269488377"", ""821660419"", ""2373121802"", ""823731786"", ""17907878"", ""25206663"", ""44809643"", ""1620737587"", ""209836925"", ""765046"", ""17092811"", ""109039479"", ""25291723"", ""14322902"", ""122819549"", ""2966321176"", ""308707369"", ""120588038"", ""261749735"", ""149913262"", ""21190891"", ""2632990111"", ""1244974586"", ""374331930"", ""47681231"", ""17052499"", ""141682204"", ""243447325"", ""163863552"", ""177568437"", ""440464127"", ""794671951"", ""317731956"", ""20940614"", ""18660022"", ""554835606"", ""182690569"", ""531598198"", ""87944324"", ""20729667"", ""23672426"", ""7587032"", ""484240369"", ""66209943"", ""27047824"", ""194792466"", ""16480031"", ""118184465"", ""1042657574"", ""133316482"", ""1877831"", ""609959725"", ""2545601317"", ""250829709"", ""14860428"", ""50294215"", ""316065739"", ""59073766"", ""23951702"", ""100413913"", ""56312505"", ""456255770"", ""467792402"", ""1227017832"", ""2575616970"", ""584128060"", ""1168972057"", ""16020483"", ""193375850"", ""11776352"", ""2900148061"", ""795427111"", ""1353415634"", ""434609176"", ""511079248"", ""533788222"", ""98101047"", ""2450471977"", ""628978241"", ""464002910"", ""34153363"", ""45265619"", ""138101272"", ""40796569"", ""553549148"", ""8332612""]",0,12,12
2855109985,8,34.0,0.6444729864597321,6804401.0,5,0.0,"[""charliehebdo-all-rnr-threads"", ""ottawashooting-all-rnr-threads"", ""sydneysiege-all-rnr-threads""]","[""14293310"", ""807095"", ""3108351"", ""759251"", ""2467791""]",0,8,8
32612452,4,97.0,0.006326347589492798,6641194.0,2,0.25,"[""charliehebdo-all-rnr-threads"", ""ottawashooting-all-rnr-threads""]","[""16973333"", ""23937894""]",1,3,4
824250668,6,45.833333333333336,-0.36555833617846173,6764108.0,6,0.3333333333333333,"[""charliehebdo-all-rnr-threads"", ""ottawashooting-all-rnr-threads"", ""sydneysiege-all-rnr-threads""]","[""138749160"", ""443146128"", ""7587032"", ""289998339"", ""164397041"", ""17469289""]",2,4,6
1003681236,8,79.0,-0.21534614264965057,6560463.0,4,0.125,"[""charliehebdo-all-rnr-threads"", ""germanwings-crash-all-rnr-threads""]","[""2280470022"", ""20973388"", ""31135856"", ""164397041""]",1,7,8
428284115,6,126.0,-0.16931326190630594,1989986.0,2,0.0,"[""charliehebdo-all-rnr-threads"", ""sydneysiege-all-rnr-threads""]","[""243094509"", ""1077181999""]",0,6,6
2773542120,2,102.5,-0.2390841841697693,2002384.0,2,0.0,"[""charliehebdo-all-rnr-threads"", ""sydneysiege-all-rnr-threads""]","[""414573312"", ""419520517""]",0,2,2
1198993620,2,83.0,-0.5654549598693848,6554490.0,2,0.0,"[""charliehebdo-all-rnr-threads"", ""germanwings-crash-all-rnr-threads""]","[""15438913"", ""320418413""]",0,2,2
402070775,9,105.66666666666667,-0.2520409822463989,2219600.0,9,0.1111111111111111,"[""charliehebdo-all-rnr-threads"", ""sydneysiege-all-rnr-threads""]","[""147580943"", ""110396781"", ""16721461"", ""14173315"", ""7702542"", ""495464885"", ""952112047"", ""10313752"", ""14401607""]",1,8,9
13023332,8,63.5,0.14385879039764404,12669490.0,4,0.0,"[""charliehebdo-all-rnr-threads"", ""ferguson-all-rnr-threads""]","[""14090948"", ""14849562"", ""16900353"", ""61451642""]",0,8,8
7702542,7,99.0,-0.2706208995410374,2213455.0,71,0.0,"[""charliehebdo-all-rnr-threads"", ""sydneysiege-all-rnr-threads""]","[""48964580"", ""605856755"", ""1928949673"", ""1398582079"", ""111162630"", ""1553894574"", ""1084781941"", ""2331193790"", ""987413828"", ""273208287"", ""27637361"", ""5920872"", ""1942178947"", ""2963325208"", ""1599700260"", ""2955627577"", ""163717434"", ""884202938"", ""2172148118"", ""2892945989"", ""7702542"", ""326118600"", ""1595364620"", ""930728497"", ""517240110"", ""17980544"", ""126359064"", ""341552391"", ""22921558"", ""2858679020"", ""2780648743"", ""15973690"", ""93739841"", ""17084767"", ""448364910"", ""2561141334"", ""66510662"", ""2897067474"", ""27212395"", ""569546005"", ""17474081"", ""44526814"", ""77943492"", ""1304255893"", ""335272177"", ""55976554"", ""68956490"", ""93679001"", ""36716095"", ""2312492399"", ""2937237720"", ""35955424"", ""28747261"", ""178563267"", ""237321959"", ""2651936329"", ""2909443215"", ""2490568460"", ""19650408"", ""133355617"", ""1739650556"", ""22643800"", ""32991101"", ""1413805662"", ""105973829"", ""2302159284"", ""55075272"", ""402070775"", ""47281289"", ""19187928"", ""253346978""]",0,7,7
25545470,3,123.66666666666667,-0.419727881749471,12531351.0,20,0.6666666666666666,"[""charliehebdo-all-rnr-threads"", ""ferguson-all-rnr-threads""]","[""319750177"", ""355874599"", ""269016791"", ""33649625"", ""1228946599"", ""87054021"", ""1361200178"", ""2361666511"", ""712499900"", ""34912972"", ""141744243"", ""220024421"", ""52755239"", ""122186951"", ""372038965"", ""768580298"", ""2281131228"", ""318688089"", ""63265975"", ""25545470""]",2,1,3
1306245326,2,62.0,-0.1508183479309082,6802577.0,2,0.5,"[""charliehebdo-all-rnr-threads"", ""germanwings-crash-all-rnr-threads""]","[""99333040"", ""17561562""]",1,1,2
15943896,2,92.0,-0.5205544531345367,1990942.0,2,0.0,"[""charliehebdo-all-rnr-threads"", ""sydneysiege-all-rnr-threads""]","[""373783051"", ""23963789""]",0,2,2
58180860,4,90.5,-0.4990203380584717,6734249.0,2,0.75,"[""charliehebdo-all-rnr-threads"", ""germanwings-crash-all-rnr-threads""]","[""38162820"", ""100936791""]",3,1,4
313381710,2,97.0,-0.6776472926139832,6646121.0,2,0.5,"[""charliehebdo-all-rnr-threads"", ""ottawashooting-all-rnr-threads""]","[""264924050"", ""2461887810""]",1,1,2
2690144502,5,114.0,0.04674012660980224,12512469.0,2,0.2,"[""charliehebdo-all-rnr-threads"", ""ferguson-all-rnr-threads""]","[""158426909"", ""2461887810""]",1,4,5
145416225,2,77.0,-0.7114262282848358,12660388.0,2,0.0,"[""charliehebdo-all-rnr-threads"", ""ferguson-all-rnr-threads""]","[""123093889"", ""17782313""]",0,2,2
2730745842,2,86.0,-0.23805171251296997,1984123.0,2,0.5,"[""charliehebdo-all-rnr-threads"", ""sydneysiege-all-rnr-threads""]","[""15754281"", ""17782313""]",1,1,2
1498326793,5,54.8,-0.13206640481948853,2058782.0,2,0.0,"[""charliehebdo-all-rnr-threads"", ""sydneysiege-all-rnr-threads""]","[""11741632"", ""17782313""]",0,5,5
97519068,10,117.9,-0.24937329292297364,6821950.0,8,0.4,"[""charliehebdo-all-rnr-threads"", ""ottawashooting-all-rnr-threads"", ""sydneysiege-all-rnr-threads""]","[""14173315"", ""195903035"", ""8736882"", ""7587032"", ""51241574"", ""7401202"", ""16343974"", ""257291338""]",4,6,10
1964968338,4,110.5,-0.32276521623134613,12656416.0,3,0.5,"[""charliehebdo-all-rnr-threads"", ""ferguson-all-rnr-threads""]","[""373783051"", ""386815916"", ""16305558""]",2,2,4
1100846148,3,105.0,-0.20556227366129556,2039439.0,2,0.3333333333333333,"[""charliehebdo-all-rnr-threads"", ""sydneysiege-all-rnr-threads""]","[""2799960092"", ""29979814""]",1,2,3
2580813590,2,67.0,0.046951353549957275,12959979.0,2,0.0,"[""charliehebdo-all-rnr-threads"", ""ferguson-all-rnr-threads""]","[""186688764"", ""14722589""]",0,2,2
98627870,6,129.83333333333334,0.08041547735532124,1997590.0,22,0.0,"[""charliehebdo-all-rnr-threads"", ""sydneysiege-all-rnr-threads""]","[""27112599"", ""19007158"", ""68318434"", ""314541829"", ""134231647"", ""2758744286"", ""335871995"", ""578201402"", ""488958831"", ""1118788734"", ""1421389548"", ""101452797"", ""404460410"", ""375560433"", ""1624598599"", ""55794552"", ""28351532"", ""368041715"", ""98627870"", ""2229089473"", ""246245079"", ""469551079""]",0,6,6
1356407618,11,118.45454545454545,-0.2607258449901234,2163516.0,3,0.0,"[""charliehebdo-all-rnr-threads"", ""sydneysiege-all-rnr-threads""]","[""607082634"", ""37074513"", ""2768501""]",0,11,11
2284965018,10,87.1,-0.09964240789413452,2196375.0,6,0.1,"[""charliehebdo-all-rnr-threads"", ""sydneysiege-all-rnr-threads""]","[""2378713202"", ""9609632"", ""238575113"", ""311849071"", ""206979151"", ""153029181""]",1,9,10
2402254161,2,127.5,-0.7867395877838135,6556888.0,6,0.5,"[""charliehebdo-all-rnr-threads"", ""germanwings-crash-all-rnr-threads""]","[""2302096610"", ""1218304140"", ""135442376"", ""1179555529"", ""539416362"", ""788422862""]",1,1,2
268643072,3,109.66666666666667,-0.5975552797317505,6639703.0,2,0.3333333333333333,"[""charliehebdo-all-rnr-threads"", ""ottawashooting-all-rnr-threads"", ""sydneysiege-all-rnr-threads""]","[""51241574"", ""14293310""]",1,2,3
351120282,8,134.125,-0.20672671496868134,6798425.0,54,0.125,"[""charliehebdo-all-rnr-threads"", ""ottawashooting-all-rnr-threads""]","[""2909294196"", ""129867739"", ""2791549583"", ""351120282"", ""526575903"", ""2401037196"", ""582396858"", ""2432181727"", ""922918340"", ""26049320"", ""389816335"", ""2886191991"", ""876687512"", ""870804655"", ""1196857183"", ""2180057079"", ""207023127"", ""33622022"", ""484921417"", ""2813806196"", ""2162983369"", ""2716052092"", ""45083132"", ""37315032"", ""96007643"", ""22808305"", ""2820910516"", ""540903074"", ""17824640"", ""2428962398"", ""309317861"", ""91119778"", ""319439583"", ""2864105789"", ""20524471"", ""480618923"", ""2535150197"", ""94693288"", ""74549457"", ""140109615"", ""405229960"", ""2546554567"", ""1451377339"", ""37667747"", ""2787144125"", ""78896761"", ""274849715"", ""19747572"", ""266776743"", ""44114927"", ""423690736"", ""472962312"", ""2187880722"", ""56738138""]",1,7,8
453030125,2,139.5,-0.6749373972415924,6558846.0,8,0.0,"[""charliehebdo-all-rnr-threads"", ""germanwings-crash-all-rnr-threads""]","[""983149818"", ""2356127598"", ""3024429379"", ""227257941"", ""2710085621"", ""167791259"", ""2956012174"", ""45796414""]",0,2,2
2356127598,17,125.17647058823529,-0.2698523822952719,13286868.0,11,0.17647058823529413,"[""charliehebdo-all-rnr-threads"", ""germanwings-crash-all-rnr-threads"", ""ottawashooting-all-rnr-threads"", ""sydneysiege-all-rnr-threads""]","[""9624742"", ""196994616"", ""383733061"", ""453030125"", ""3108351"", ""2653613168"", ""17001435"", ""80803819"", ""22993014"", ""16834659"", ""14353202""]",3,14,17
2442329799,8,113.0,-0.26657480746507645,12631727.0,3,0.0,"[""charliehebdo-all-rnr-threads"", ""ferguson-all-rnr-threads""]","[""18511475"", ""21733692"", ""140149359""]",0,8,8
1268671406,16,107.6875,-0.38464562967419624,2333278.0,3,0.125,"[""charliehebdo-all-rnr-threads"", ""sydneysiege-all-rnr-threads""]","[""1960878613"", ""362144301"", ""19017675""]",2,14,16
546638842,2,113.0,-0.2915722727775574,6551457.0,2,0.5,"[""charliehebdo-all-rnr-threads"", ""germanwings-crash-all-rnr-threads""]","[""2280470022"", ""362144301""]",1,1,2
28197830,4,95.0,-0.5003013759851456,1991020.0,9,0.0,"[""charliehebdo-all-rnr-threads"", ""sydneysiege-all-rnr-threads""]","[""605889893"", ""1972416156"", ""238575113"", ""28197830"", ""31065693"", ""17386686"", ""18846244"", ""76919482"", ""2917704052""]",0,4,4
40381745,8,66.5,0.0055928826332092285,12922882.0,7,0.0,"[""charliehebdo-all-rnr-threads"", ""ottawashooting-all-rnr-threads"", ""ferguson-all-rnr-threads"", ""sydneysiege-all-rnr-threads""]","[""280784084"", ""1859593506"", ""15486071"", ""68577152"", ""18841425"", ""501768982"", ""204832963""]",0,8,8
27839828,10,118.8,-0.1188911259174347,2158048.0,7,0.4,"[""charliehebdo-all-rnr-threads"", ""sydneysiege-all-rnr-threads""]","[""16671007"", ""329121956"", ""21439144"", ""557872038"", ""270016438"", ""87818409"", ""5402612""]",4,6,10
1667861336,7,129.0,-0.4285852994237627,12521040.0,2,0.8571428571428571,"[""charliehebdo-all-rnr-threads"", ""ferguson-all-rnr-threads""]","[""63144098"", ""19915842""]",6,1,7
237321959,45,105.22222222222223,-0.41187237368689644,12536587.0,2,0.0,"[""charliehebdo-all-rnr-threads"", ""ferguson-all-rnr-threads""]","[""7702542"", ""18510860""]",0,45,45
13496142,10,81.8,-0.1642706274986267,2069495.0,50,0.0,"[""charliehebdo-all-rnr-threads"", ""sydneysiege-all-rnr-threads""]","[""405731549"", ""125119174"", ""188768573"", ""722630419"", ""599485927"", ""17897201"", ""627795671"", ""227917021"", ""2158558861"", ""28350435"", ""2395494938"", ""82443996"", ""229132625"", ""137300406"", ""47582275"", ""16664767"", ""2497811946"", ""1558203038"", ""343921236"", ""257395153"", ""259215498"", ""199738451"", ""17265337"", ""214852505"", ""2667650653"", ""215322288"", ""531704007"", ""422578796"", ""438307876"", ""47396031"", ""16052290"", ""223278386"", ""756331316"", ""611076309"", ""183150090"", ""1670258292"", ""844276891"", ""2942124741"", ""63498142"", ""22490737"", ""2254139521"", ""46505149"", ""149132653"", ""133650773"", ""30130399"", ""316405268"", ""2382436050"", ""13496142"", ""722127506"", ""272893755""]",0,10,10
62550901,2,118.5,-0.29698246717453003,2028496.0,2,0.0,"[""charliehebdo-all-rnr-threads"", ""sydneysiege-all-rnr-threads""]","[""18424289"", ""17984709""]",0,2,2
1572315950,5,123.2,-0.352678644657135,12674333.0,2,0.0,"[""charliehebdo-all-rnr-threads"", ""ferguson-all-rnr-threads""]","[""18424289"", ""14940354""]",0,5,5
2187880722,3,93.33333333333333,-0.5069018602371216,2088959.0,2,0.0,"[""charliehebdo-all-rnr-threads"", ""sydneysiege-all-rnr-threads""]","[""351120282"", ""130557513""]",0,3,3
2433195168,7,133.14285714285714,-0.4804934433528355,2196893.0,3,0.0,"[""charliehebdo-all-rnr-threads"", ""sydneysiege-all-rnr-threads""]","[""20043786"", ""99333040"", ""862374578""]",0,7,7
1147585616,2,103.5,-0.34821730852127075,12785945.0,2,0.0,"[""charliehebdo-all-rnr-threads"", ""ferguson-all-rnr-threads""]","[""53503202"", ""28443608""]",0,2,2
1008250188,2,84.5,0.4488312005996704,12702001.0,2,0.0,"[""charliehebdo-all-rnr-threads"", ""ferguson-all-rnr-threads""]","[""5513002"", ""28443608""]",0,2,2
16671007,2,141.0,-0.4652692973613739,6639714.0,28,0.5,"[""charliehebdo-all-rnr-threads"", ""ottawashooting-all-rnr-threads""]","[""2909294196"", ""2354297954"", ""887432780"", ""1471170925"", ""1928862781"", ""2424422474"", ""932705005"", ""1519965158"", ""2558068521"", ""341073304"", ""934438520"", ""2273282888"", ""2366247835"", ""900187770"", ""27839828"", ""295694732"", ""2731726966"", ""1066159118"", ""2389043373"", ""423368954"", ""252542839"", ""2326815733"", ""2821285640"", ""2579339647"", ""173836390"", ""19026168"", ""32202559"", ""34229099""]",1,1,2
2354297954,2,106.5,0.6802359819412231,3808800.0,2,0.5,"[""charliehebdo-all-rnr-threads"", ""gurlitt-all-rnr-threads""]","[""16671007"", ""553661747""]",1,1,2
32202559,2,113.0,-0.3834690749645233,6563665.0,2,0.0,"[""charliehebdo-all-rnr-threads"", ""germanwings-crash-all-rnr-threads""]","[""16671007"", ""134196350""]",0,2,2
2558068521,6,91.83333333333333,-0.17496760686238608,6644881.0,3,0.16666666666666666,"[""charliehebdo-all-rnr-threads"", ""ottawashooting-all-rnr-threads""]","[""16671007"", ""375721095"", ""257291338""]",1,5,6
887432780,17,113.52941176470588,-0.378144572762882,6650364.0,3,0.9411764705882353,"[""charliehebdo-all-rnr-threads"", ""ottawashooting-all-rnr-threads""]","[""325747234"", ""16671007"", ""1367531""]",16,1,17
2821285640,2,136.0,-0.7785306870937347,2040419.0,2,0.5,"[""charliehebdo-all-rnr-threads"", ""sydneysiege-all-rnr-threads""]","[""16671007"", ""211374036""]",1,1,2
136754171,3,50.333333333333336,-0.5504006942113241,2114753.0,3,0.3333333333333333,"[""charliehebdo-all-rnr-threads"", ""sydneysiege-all-rnr-threads""]","[""1652541"", ""16973333"", ""16031927""]",1,2,3
268982264,5,138.6,-0.5232640743255615,19218739.0,5,0.0,"[""charliehebdo-all-rnr-threads"", ""germanwings-crash-all-rnr-threads"", ""ferguson-all-rnr-threads""]","[""25049056"", ""1652541"", ""53503202"", ""379481082"", ""2461887810""]",0,5,5
2888761394,2,27.0,-0.4217259883880615,6554588.0,2,0.5,"[""charliehebdo-all-rnr-threads"", ""germanwings-crash-all-rnr-threads""]","[""1652541"", ""14173315""]",1,1,2
375795665,3,90.0,-0.7279565135637919,6639706.0,3,0.6666666666666666,"[""charliehebdo-all-rnr-threads"", ""ottawashooting-all-rnr-threads"", ""sydneysiege-all-rnr-threads""]","[""1652541"", ""375721095"", ""1367531""]",2,1,3
891509504,3,65.0,-0.6037659843762716,6644900.0,2,0.6666666666666666,"[""charliehebdo-all-rnr-threads"", ""ottawashooting-all-rnr-threads""]","[""1652541"", ""12848262""]",2,1,3
18455693,8,122.25,-0.3267858251929283,8582682.0,7,0.625,"[""charliehebdo-all-rnr-threads"", ""germanwings-crash-all-rnr-threads"", ""sydneysiege-all-rnr-threads""]","[""196994616"", ""1855737487"", ""3108351"", ""380648579"", ""28785486"", ""16675569"", ""51381252""]",5,3,8
18740607,5,110.2,-0.37336164712905884,2055061.0,3,0.0,"[""charliehebdo-all-rnr-threads"", ""sydneysiege-all-rnr-threads""]","[""952112047"", ""1851229334"", ""556633808""]",0,5,5
60088031,2,92.0,0.08795350790023804,2011650.0,2,0.0,"[""charliehebdo-all-rnr-threads"", ""sydneysiege-all-rnr-threads""]","[""263007263"", ""14588748""]",0,2,2
2728468209,4,109.0,-0.23333021998405457,6655791.0,3,0.0,"[""charliehebdo-all-rnr-threads"", ""ottawashooting-all-rnr-threads""]","[""243679064"", ""14216661"", ""14588748""]",0,4,4
2148809806,3,71.0,-0.25499822696050006,5609693.0,3,0.3333333333333333,"[""charliehebdo-all-rnr-threads"", ""putinmissing-all-rnr-threads""]","[""786764"", ""17895820"", ""16973333""]",1,2,3
244850695,5,94.2,-0.22004337310791017,6617366.0,3,0.2,"[""charliehebdo-all-rnr-threads"", ""ottawashooting-all-rnr-threads"", ""sydneysiege-all-rnr-threads""]","[""6017542"", ""786764"", ""30699754""]",1,4,5
189279445,3,121.66666666666667,-0.27117496728897095,2034163.0,2,0.0,"[""charliehebdo-all-rnr-threads"", ""sydneysiege-all-rnr-threads""]","[""951837780"", ""786764""]",0,3,3
441333646,2,113.0,-0.4685788154602051,2008674.0,2,0.0,"[""charliehebdo-all-rnr-threads"", ""sydneysiege-all-rnr-threads""]","[""147580943"", ""16012783""]",0,2,2
891199856,2,105.5,-0.43747490644454956,6653281.0,2,0.5,"[""charliehebdo-all-rnr-threads"", ""ottawashooting-all-rnr-threads""]","[""147580943"", ""19038934""]",1,1,2
604855824,2,65.5,-0.8217274844646454,6648992.0,2,0.5,"[""charliehebdo-all-rnr-threads"", ""ottawashooting-all-rnr-threads""]","[""16973333"", ""7587032""]",1,1,2
87562872,4,101.0,-0.22501081228256226,12882101.0,2,0.5,"[""charliehebdo-all-rnr-threads"", ""ferguson-all-rnr-threads""]","[""20222791"", ""1381926373""]",2,2,4
567643509,2,48.5,-0.47226279973983765,6644350.0,2,0.5,"[""charliehebdo-all-rnr-threads"", ""ottawashooting-all-rnr-threads""]","[""148653311"", ""7587032""]",1,1,2
2464274870,4,43.5,-0.13571631908416748,6654069.0,3,0.5,"[""charliehebdo-all-rnr-threads"", ""ottawashooting-all-rnr-threads""]","[""19038934"", ""47624589"", ""87818409""]",2,2,4
14401607,4,125.25,-0.06462636590003967,2040846.0,23,0.5,"[""charliehebdo-all-rnr-threads"", ""sydneysiege-all-rnr-threads""]","[""199820447"", ""262068361"", ""9609632"", ""19331942"", ""154138113"", ""335871995"", ""2182729622"", ""2472886705"", ""977910404"", ""2385557324"", ""423625300"", ""2743717021"", ""2495955023"", ""428333"", ""2483044398"", ""970608607"", ""1903011067"", ""2495801377"", ""2847603102"", ""402070775"", ""2753308284"", ""92964651"", ""2288010913""]",2,2,4
423625300,4,127.75,-0.15072782337665558,2032751.0,3,0.25,"[""charliehebdo-all-rnr-threads"", ""sydneysiege-all-rnr-threads""]","[""5402612"", ""428333"", ""14401607""]",1,3,4
283505633,4,125.75,-0.4320279061794281,6725156.0,3,0.0,"[""charliehebdo-all-rnr-threads"", ""ottawashooting-all-rnr-threads""]","[""16955991"", ""358347117"", ""171953871""]",0,4,4
76850899,4,116.5,-0.35569192469120026,6631573.0,2,0.25,"[""charliehebdo-all-rnr-threads"", ""ottawashooting-all-rnr-threads""]","[""51241574"", ""171953871""]",1,3,4
449472564,2,102.5,-0.8362852931022644,2024362.0,2,0.0,"[""charliehebdo-all-rnr-threads"", ""sydneysiege-all-rnr-threads""]","[""16973333"", ""171953871""]",0,2,2
114845341,3,91.66666666666667,0.06808896859486897,12688485.0,3,0.0,"[""charliehebdo-all-rnr-threads"", ""ottawashooting-all-rnr-threads"", ""ferguson-all-rnr-threads""]","[""9487272"", ""69004966"", ""25516222""]",0,3,3
19706851,2,136.0,-0.6093376874923706,6555557.0,2,0.0,"[""charliehebdo-all-rnr-threads"", ""germanwings-crash-all-rnr-threads""]","[""575225464"", ""483954925""]",0,2,2
370689583,7,128.0,-0.5241210545812335,2182454.0,5,0.0,"[""charliehebdo-all-rnr-threads"", ""sydneysiege-all-rnr-threads""]","[""19017675"", ""31135856"", ""358204197"", ""2188165862"", ""87818409""]",0,7,7
77528520,2,138.0,-0.4629802703857422,6553817.0,6,0.5,"[""charliehebdo-all-rnr-threads"", ""germanwings-crash-all-rnr-threads""]","[""179722950"", ""1542767918"", ""244225869"", ""50085645"", ""36340107"", ""326142499""]",1,1,2
15382667,9,115.88888888888889,-0.1087147659725613,19315453.0,7,0.6666666666666666,"[""charliehebdo-all-rnr-threads"", ""germanwings-crash-all-rnr-threads"", ""sydneysiege-all-rnr-threads"", ""ferguson-all-rnr-threads""]","[""167848621"", ""2097571"", ""14090948"", ""17919393"", ""26566469"", ""15250661"", ""258627226""]",6,3,9
22021978,44,89.5,-0.28016437725587323,2216611.0,108,0.0,"[""charliehebdo-all-rnr-threads"", ""sydneysiege-all-rnr-threads""]","[""1001236291"", ""552545225"", ""2897410400"", ""48325019"", ""32274369"", ""159624465"", ""168802748"", ""2170209896"", ""203442882"", ""20959178"", ""1973173992"", ""291127656"", ""199738451"", ""2192824389"", ""84074624"", ""228600018"", ""27845592"", ""65163368"", ""121127090"", ""215352821"", ""2427626436"", ""360183353"", ""4491811"", ""487323764"", ""425785205"", ""434525445"", ""581831550"", ""2616159025"", ""82067909"", ""18714805"", ""224484865"", ""134573483"", ""20333840"", ""351889336"", ""2411218802"", ""331037704"", ""353351870"", ""248614159"", ""122627369"", ""801623736"", ""167848621"", ""72119786"", ""340907788"", ""1518619074"", ""470460979"", ""22982668"", ""22654179"", ""2883921829"", ""2417232973"", ""305134471"", ""15319103"", ""302701427"", ""28402372"", ""459023633"", ""115190157"", ""133243776"", ""405194953"", ""108657305"", ""409533754"", ""398073907"", ""13202212"", ""43517172"", ""287805030"", ""522638276"", ""2963785677"", ""548406532"", ""45780582"", ""547071660"", ""20479435"", ""739118222"", ""242121420"", ""2686133420"", ""320563079"", ""830556926"", ""315073177"", ""564922280"", ""65393278"", ""131536866"", ""350517066"", ""910683680"", ""17537467"", ""15770226"", ""20248017"", ""892197414"", ""1151095778"", ""445452143"", ""11734152"", ""443565818"", ""443863776"", ""88728383"", ""246532728"", ""42910254"", ""1023507787"", ""15699468"", ""239345703"", ""22021978"", ""569900167"", ""1450791602"", ""1485225582"", ""2524146902"", ""368041715"", ""262297763"", ""92734920"", ""2868575395"", ""158722646"", ""635444177"", ""125400750"", ""329636026""]",0,44,44
25869176,2,82.0,0.14846086502075195,2010585.0,2,0.5,"[""charliehebdo-all-rnr-threads"", ""sydneysiege-all-rnr-threads""]","[""19533817"", ""2768501""]",1,1,2
529711774,5,76.4,-0.26723589897155764,12366136.0,5,0.4,"[""charliehebdo-all-rnr-threads"", ""putinmissing-all-rnr-threads"", ""ottawashooting-all-rnr-threads""]","[""635608354"", ""19533817"", ""22434517"", ""280822613"", ""64643056""]",2,3,5
268662889,2,122.5,-0.3165077567100525,2015051.0,32,0.5,"[""charliehebdo-all-rnr-threads"", ""sydneysiege-all-rnr-threads""]","[""117217500"", ""2734110151"", ""2871419496"", ""86495094"", ""16901935"", ""249325107"", ""254727295"", ""17132699"", ""2908504576"", ""2737271823"", ""2358666829"", ""2857799046"", ""131819846"", ""2173507532"", ""123693913"", ""2896532895"", ""191376204"", ""400580073"", ""198359255"", ""831862195"", ""336151296"", ""542880833"", ""2831023966"", ""137480382"", ""285424497"", ""249273518"", ""41327145"", ""254873869"", ""237196527"", ""49273182"", ""261814803"", ""593344418""]",1,1,2
831862195,2,135.0,-0.3247523903846741,12662759.0,2,0.0,"[""charliehebdo-all-rnr-threads"", ""ferguson-all-rnr-threads""]","[""495464885"", ""268662889""]",0,2,2
17132699,2,119.5,-0.26354295015335083,2040343.0,2,0.5,"[""charliehebdo-all-rnr-threads"", ""sydneysiege-all-rnr-threads""]","[""268662889"", ""5402612""]",1,1,2
593344418,2,122.5,-0.37877601385116577,2036477.0,2,0.0,"[""charliehebdo-all-rnr-threads"", ""sydneysiege-all-rnr-threads""]","[""64643056"", ""268662889""]",0,2,2
50998842,2,34.0,0.07558047771453857,6718154.0,2,0.5,"[""charliehebdo-all-rnr-threads"", ""germanwings-crash-all-rnr-threads""]","[""2280470022"", ""283632721""]",1,1,2
342697424,4,92.25,-0.11830800771713257,2010631.0,2,0.0,"[""charliehebdo-all-rnr-threads"", ""sydneysiege-all-rnr-threads""]","[""21866939"", ""414573312""]",0,4,4
558969189,2,34.0,0.4776250123977661,12670860.0,2,0.0,"[""charliehebdo-all-rnr-threads"", ""ferguson-all-rnr-threads""]","[""16012783"", ""7587032""]",0,2,2
7744592,8,98.75,-0.16173113882541656,8550835.0,54,0.25,"[""charliehebdo-all-rnr-threads"", ""germanwings-crash-all-rnr-threads"", ""sydneysiege-all-rnr-threads""]","[""53401994"", ""226521605"", ""1492117686"", ""40782375"", ""406829745"", ""2248861878"", ""61204624"", ""28989724"", ""2425271121"", ""1309728793"", ""1869974545"", ""468588961"", ""15922161"", ""2705783352"", ""2337682316"", ""335871995"", ""609112360"", ""371660355"", ""1259122477"", ""2459278543"", ""2654713085"", ""885350581"", ""2406957578"", ""567336756"", ""626674509"", ""2359591050"", ""522551659"", ""2555344843"", ""766208030"", ""21550743"", ""23153001"", ""2885348567"", ""2474494520"", ""1169931338"", ""374262455"", ""90891192"", ""950869819"", ""2940676170"", ""79800149"", ""1211349950"", ""40903339"", ""385919935"", ""27991457"", ""137037404"", ""424260012"", ""628636580"", ""16565372"", ""2942842270"", ""27863698"", ""31680700"", ""245993552"", ""18177163"", ""2517215350"", ""2329582889""]",2,6,8
1231224926,3,128.33333333333334,-0.14067856470743814,1987783.0,33,0.0,"[""charliehebdo-all-rnr-threads"", ""sydneysiege-all-rnr-threads""]","[""287414732"", ""2822645457"", ""244548985"", ""135794919"", ""765162589"", ""243831804"", ""136650053"", ""2877700589"", ""120597127"", ""878015430"", ""722806945"", ""2356107308"", ""1513407492"", ""2227801737"", ""28763981"", ""377723508"", ""2917526141"", ""15614186"", ""27997833"", ""383168943"", ""19408939"", ""2305276266"", ""2379135360"", ""116992110"", ""273997227"", ""293405815"", ""2522672394"", ""2916570227"", ""124447045"", ""613446992"", ""2161907369"", ""29740981"", ""61975857""]",0,3,3
1377307112,3,109.66666666666667,-0.1989527940750122,1981914.0,2,0.0,"[""charliehebdo-all-rnr-threads"", ""sydneysiege-all-rnr-threads""]","[""46078438"", ""20891396""]",0,3,3
18191382,2,125.5,-0.45977336168289185,5512496.0,2,0.5,"[""charliehebdo-all-rnr-threads"", ""prince-toronto-all-rnr-threads""]","[""22192440"", ""20891396""]",1,1,2
376884268,2,57.0,-0.0034868717193603516,5694702.0,2,0.5,"[""charliehebdo-all-rnr-threads"", ""putinmissing-all-rnr-threads""]","[""16931849"", ""20891396""]",1,1,2
60003258,3,129.0,-0.4271937410036723,12519305.0,3,0.0,"[""charliehebdo-all-rnr-threads"", ""ottawashooting-all-rnr-threads"", ""ferguson-all-rnr-threads""]","[""16343974"", ""39728435"", ""14319105""]",0,3,3
20995911,2,82.5,-0.39782971143722534,12672311.0,2,0.0,"[""charliehebdo-all-rnr-threads"", ""ferguson-all-rnr-threads""]","[""14849562"", ""296894515""]",0,2,2
46052566,2,88.5,-0.36031585931777954,2043018.0,2,0.0,"[""charliehebdo-all-rnr-threads"", ""sydneysiege-all-rnr-threads""]","[""162304163"", ""147994804""]",0,2,2
2861439818,4,90.0,-0.3888576030731201,6836317.0,2,0.25,"[""charliehebdo-all-rnr-threads"", ""germanwings-crash-all-rnr-threads""]","[""1408003598"", ""112874216""]",1,3,4
1450791602,3,137.0,-0.29812121391296387,2160569.0,3,0.0,"[""charliehebdo-all-rnr-threads"", ""sydneysiege-all-rnr-threads""]","[""22021978"", ""87818409"", ""171802941""]",0,3,3
2790570579,3,105.66666666666667,-0.08175436655680339,6657053.0,2,0.3333333333333333,"[""charliehebdo-all-rnr-threads"", ""ottawashooting-all-rnr-threads""]","[""226344539"", ""12848262""]",1,2,3
55075272,6,87.0,-0.3576652506987254,12496880.0,5,0.16666666666666666,"[""charliehebdo-all-rnr-threads"", ""ottawashooting-all-rnr-threads"", ""ferguson-all-rnr-threads"", ""sydneysiege-all-rnr-threads""]","[""7702542"", ""17995040"", ""6433472"", ""19222164"", ""20402945""]",1,5,6
264333941,3,58.0,-0.417094349861145,1965103.0,2,0.6666666666666666,"[""charliehebdo-all-rnr-threads"", ""sydneysiege-all-rnr-threads""]","[""28785486"", ""17995040""]",2,1,3
1173824917,3,104.33333333333333,-0.18104231357574463,1997312.0,2,0.0,"[""charliehebdo-all-rnr-threads"", ""sydneysiege-all-rnr-threads""]","[""30313925"", ""20512260""]",0,3,3
44299861,11,59.90909090909091,0.035491434010592376,13200753.0,4,0.5454545454545454,"[""charliehebdo-all-rnr-threads"", ""germanwings-crash-all-rnr-threads"", ""ottawashooting-all-rnr-threads""]","[""19038934"", ""15438913"", ""30313925"", ""5402612""]",6,5,11
308698101,2,102.0,-0.2160325050354004,12783042.0,2,0.0,"[""charliehebdo-all-rnr-threads"", ""ferguson-all-rnr-threads""]","[""1381926373"", ""30313925""]",0,2,2
629028228,2,135.0,-0.19846731424331665,6631582.0,2,0.5,"[""charliehebdo-all-rnr-threads"", ""ottawashooting-all-rnr-threads""]","[""1652541"", ""16311797""]",1,1,2
2680521914,2,40.5,-0.3104872703552246,1996973.0,2,0.0,"[""charliehebdo-all-rnr-threads"", ""sydneysiege-all-rnr-threads""]","[""223484404"", ""44317593""]",0,2,2
558215877,5,96.8,-0.32474517822265625,7055994.0,3,0.0,"[""charliehebdo-all-rnr-threads"", ""ottawashooting-all-rnr-threads""]","[""742143"", ""22634051"", ""107883101""]",0,5,5
51043990,8,36.75,-0.11412273347377777,2002477.0,2,0.0,"[""charliehebdo-all-rnr-threads"", ""sydneysiege-all-rnr-threads""]","[""25106021"", ""16973333""]",0,8,8
102753391,6,103.0,-0.7421382566293081,1986775.0,3,0.16666666666666666,"[""charliehebdo-all-rnr-threads"", ""sydneysiege-all-rnr-threads""]","[""365939318"", ""6017542"", ""1367531""]",1,5,6
1551514550,4,62.0,-0.6729853451251984,6651397.0,2,0.5,"[""charliehebdo-all-rnr-threads"", ""ottawashooting-all-rnr-threads"", ""sydneysiege-all-rnr-threads""]","[""1367531"", ""469194846""]",2,2,4
16267083,3,99.33333333333333,-0.006619453430175781,12528169.0,2,0.0,"[""charliehebdo-all-rnr-threads"", ""ferguson-all-rnr-threads""]","[""1367531"", ""195271137""]",0,3,3
903818041,3,117.66666666666667,-0.1529571215311686,12520293.0,2,0.0,"[""charliehebdo-all-rnr-threads"", ""ferguson-all-rnr-threads""]","[""17537467"", ""1148102359""]",0,3,3
860648802,9,99.11111111111111,-0.09462758567598131,12543155.0,6,0.0,"[""charliehebdo-all-rnr-threads"", ""ottawashooting-all-rnr-threads"", ""ferguson-all-rnr-threads"", ""sydneysiege-all-rnr-threads""]","[""45715838"", ""2163076560"", ""15164565"", ""22800916"", ""268416076"", ""16164636""]",0,9,9
1416676050,3,109.33333333333333,0.13653584321339926,6810566.0,3,0.3333333333333333,"[""charliehebdo-all-rnr-threads"", ""ottawashooting-all-rnr-threads""]","[""382027901"", ""22800916"", ""358204197""]",1,2,3
763010018,2,135.0,-0.3174733519554138,6634590.0,2,0.5,"[""charliehebdo-all-rnr-threads"", ""ottawashooting-all-rnr-threads""]","[""214007688"", ""171953871""]",1,1,2
34446512,3,69.66666666666667,0.3312927881876628,2070181.0,3,0.0,"[""charliehebdo-all-rnr-threads"", ""sydneysiege-all-rnr-threads""]","[""1375289149"", ""1630896181"", ""759251""]",0,3,3
150650920,2,76.0,-0.3021383285522461,5600788.0,1,0.5,"[""charliehebdo-all-rnr-threads"", ""putinmissing-all-rnr-threads""]","[""16343974""]",1,1,2
49243929,4,79.25,0.2524245083332062,2024011.0,3,0.0,"[""charliehebdo-all-rnr-threads"", ""sydneysiege-all-rnr-threads""]","[""16343974"", ""15907183"", ""2163076560""]",0,4,4
142838995,4,64.0,0.19336465001106262,12866298.0,4,0.0,"[""charliehebdo-all-rnr-threads"", ""ferguson-all-rnr-threads""]","[""16343974"", ""14460241"", ""2396242676"", ""14464766""]",0,4,4
390421144,3,85.0,-0.14574464162190756,2039439.0,3,0.0,"[""charliehebdo-all-rnr-threads"", ""sydneysiege-all-rnr-threads""]","[""16343974"", ""520011678"", ""499696436""]",0,3,3
178888741,6,92.66666666666667,-0.35616599520047504,12532883.0,4,0.6666666666666666,"[""charliehebdo-all-rnr-threads"", ""ferguson-all-rnr-threads""]","[""14173315"", ""16343974"", ""360738490"", ""9411482""]",4,2,6
138509803,2,84.5,-0.0026897192001342773,13004883.0,2,0.0,"[""charliehebdo-all-rnr-threads"", ""ferguson-all-rnr-threads""]","[""15164565"", ""1360789357""]",0,2,2
23078405,2,72.0,-0.2189333438873291,6628911.0,2,0.0,"[""charliehebdo-all-rnr-threads"", ""ottawashooting-all-rnr-threads""]","[""28673549"", ""737450550""]",0,2,2
259928379,3,71.0,-0.18869821230570474,2039069.0,2,0.3333333333333333,"[""charliehebdo-all-rnr-threads"", ""sydneysiege-all-rnr-threads""]","[""28673549"", ""16973333""]",1,2,3
292559322,2,68.5,-0.15682613849639893,12528133.0,2,0.5,"[""charliehebdo-all-rnr-threads"", ""ferguson-all-rnr-threads""]","[""10313752"", ""18643437""]",1,1,2
341087665,3,94.0,-0.258708655834198,2130449.0,3,0.0,"[""charliehebdo-all-rnr-threads"", ""sydneysiege-all-rnr-threads""]","[""10313752"", ""16675569"", ""230859523""]",0,3,3
41798085,2,99.0,-0.3272428512573242,2013955.0,2,0.0,"[""charliehebdo-all-rnr-threads"", ""sydneysiege-all-rnr-threads""]","[""162304163"", ""625739552""]",0,2,2
1695784514,6,128.0,-0.35409081975619,2021791.0,20,0.16666666666666666,"[""charliehebdo-all-rnr-threads"", ""sydneysiege-all-rnr-threads""]","[""274487647"", ""107734460"", ""2796860460"", ""113306701"", ""14076599"", ""100410807"", ""2258714786"", ""100667923"", ""1430721956"", ""29196462"", ""2650226143"", ""243187466"", ""108910143"", ""6124022"", ""897519212"", ""1910930526"", ""67470017"", ""85184527"", ""1695784514"", ""351433890""]",1,5,6
15557891,5,99.0,-0.37328327894210817,12510455.0,5,0.0,"[""charliehebdo-all-rnr-threads"", ""sydneysiege-all-rnr-threads"", ""ferguson-all-rnr-threads""]","[""271413771"", ""268676434"", ""87818409"", ""16012783"", ""1947301""]",0,5,5
53190110,3,141.66666666666666,-0.48941896359125775,12705926.0,3,0.0,"[""charliehebdo-all-rnr-threads"", ""ferguson-all-rnr-threads""]","[""271413771"", ""40293464"", ""252868465""]",0,3,3
952112047,4,114.0,-0.22008967399597168,2154137.0,66,0.0,"[""charliehebdo-all-rnr-threads"", ""sydneysiege-all-rnr-threads""]","[""357841916"", ""923252185"", ""2795916452"", ""33155165"", ""2911918846"", ""2727735298"", ""339249161"", ""326228723"", ""264265349"", ""2296598455"", ""1268021587"", ""1179231002"", ""1258161890"", ""701094366"", ""33247338"", ""21579414"", ""2217007286"", ""2401965265"", ""526728843"", ""2744227350"", ""15544922"", ""861951648"", ""2546312611"", ""24721342"", ""2858679020"", ""322074102"", ""531668387"", ""177830416"", ""2453547251"", ""2687427123"", ""301190816"", ""2162983369"", ""311477102"", ""2497286180"", ""553038980"", ""35897811"", ""165283481"", ""949745659"", ""2830255505"", ""49793399"", ""1651772479"", ""240514183"", ""1675930123"", ""1971635875"", ""896400632"", ""2884173593"", ""490112666"", ""369029151"", ""29484151"", ""2545601317"", ""231843348"", ""2886586060"", ""736095344"", ""2201464242"", ""22155901"", ""2464867113"", ""50940533"", ""18740607"", ""880100622"", ""1351913514"", ""1849848000"", ""402070775"", ""1631209590"", ""82412657"", ""2327615780"", ""1292608776""]",0,4,4
49793399,3,91.0,-0.5030784606933594,6622082.0,3,0.6666666666666666,"[""charliehebdo-all-rnr-threads"", ""ottawashooting-all-rnr-threads"", ""sydneysiege-all-rnr-threads""]","[""952112047"", ""393469195"", ""428333""]",2,1,3
357841916,3,93.0,-0.6410574714342753,2060190.0,2,0.6666666666666666,"[""charliehebdo-all-rnr-threads"", ""sydneysiege-all-rnr-threads""]","[""1960878613"", ""952112047""]",2,1,3
369029151,13,105.6923076923077,-0.08219261811329769,6949588.0,2,0.07692307692307693,"[""charliehebdo-all-rnr-threads"", ""ottawashooting-all-rnr-threads""]","[""952112047"", ""8736882""]",1,12,13
103849564,7,111.14285714285714,-0.524603043283735,2027089.0,27,0.0,"[""charliehebdo-all-rnr-threads"", ""sydneysiege-all-rnr-threads""]","[""356104964"", ""1492514605"", ""45302245"", ""2529955993"", ""322508660"", ""338964215"", ""368753165"", ""78513180"", ""1536797588"", ""485553698"", ""79762380"", ""399322523"", ""1313848854"", ""789148104"", ""118961714"", ""23587481"", ""1097218164"", ""2390895768"", ""67871788"", ""2280598070"", ""2646844813"", ""21476182"", ""1517701856"", ""133200761"", ""103849564"", ""2414707496"", ""358293294""]",0,7,7
21476182,3,129.33333333333334,-0.5233084956804911,2000309.0,2,0.0,"[""charliehebdo-all-rnr-threads"", ""sydneysiege-all-rnr-threads""]","[""103849564"", ""268676434""]",0,3,3
1097218164,2,90.5,0.0015468895435333252,2002048.0,2,0.0,"[""charliehebdo-all-rnr-threads"", ""sydneysiege-all-rnr-threads""]","[""103849564"", ""76858507""]",0,2,2
16153562,4,108.75,0.09549620747566223,12682730.0,33,0.0,"[""charliehebdo-all-rnr-threads"", ""ferguson-all-rnr-threads""]","[""2967017459"", ""46359680"", ""2340698592"", ""19098053"", ""2327547488"", ""1199184972"", ""573368828"", ""376589457"", ""131401034"", ""396831702"", ""387516768"", ""837466633"", ""2915646835"", ""100636437"", ""866536687"", ""1453889058"", ""2208806044"", ""23260238"", ""769864248"", ""17233797"", ""2505833077"", ""34677186"", ""22231854"", ""279599875"", ""797194555"", ""16153562"", ""23813725"", ""1531290481"", ""25130247"", ""270788979"", ""1072430060"", ""2695579098"", ""121837950""]",0,4,4
396831702,6,114.5,-0.2854437629381816,6720003.0,6,0.5,"[""charliehebdo-all-rnr-threads"", ""ottawashooting-all-rnr-threads"", ""sydneysiege-all-rnr-threads""]","[""16153562"", ""34310801"", ""873299388"", ""807095"", ""37874853"", ""24630719""]",3,3,6
2340698592,3,130.0,-0.7361065347989401,12405452.0,2,0.0,"[""charliehebdo-all-rnr-threads"", ""ferguson-all-rnr-threads""]","[""16153562"", ""61149653""]",0,3,3
484240369,9,135.88888888888889,-0.43833539883295697,1993681.0,4,0.0,"[""charliehebdo-all-rnr-threads"", ""sydneysiege-all-rnr-threads""]","[""46078438"", ""182593031"", ""18725815"", ""149913262""]",0,9,9
2178954146,2,128.5,-0.4137648940086365,2005157.0,2,0.0,"[""charliehebdo-all-rnr-threads"", ""sydneysiege-all-rnr-threads""]","[""18725815"", ""3108351""]",0,2,2
830556926,12,132.0,-0.5425779571135838,2046373.0,2,0.0,"[""charliehebdo-all-rnr-threads"", ""sydneysiege-all-rnr-threads""]","[""18725815"", ""22021978""]",0,12,12
2773566528,9,114.77777777777777,-0.30562467045254177,2209111.0,9,0.1111111111111111,"[""charliehebdo-all-rnr-threads"", ""sydneysiege-all-rnr-threads""]","[""48300067"", ""16973333"", ""487600344"", ""109065990"", ""166233427"", ""1379288282"", ""1960878613"", ""18643437"", ""1920286333""]",1,8,9
216544692,6,136.16666666666666,-0.2107369601726532,6643375.0,3,0.0,"[""charliehebdo-all-rnr-threads"", ""ottawashooting-all-rnr-threads""]","[""147580943"", ""78890225"", ""156123647""]",0,6,6
108447563,2,96.5,-0.04537254571914673,12508267.0,2,0.0,"[""charliehebdo-all-rnr-threads"", ""ferguson-all-rnr-threads""]","[""78890225"", ""1507338108""]",0,2,2
2734879242,2,114.5,-0.48497211933135986,2027740.0,2,0.0,"[""charliehebdo-all-rnr-threads"", ""sydneysiege-all-rnr-threads""]","[""84652988"", ""162304163""]",0,2,2
25687273,3,82.33333333333333,-0.7134677569071451,6653372.0,3,0.6666666666666666,"[""charliehebdo-all-rnr-threads"", ""ottawashooting-all-rnr-threads""]","[""1652541"", ""289998339"", ""16343974""]",2,1,3
280592005,6,133.16666666666666,-0.3023017843564351,12525318.0,5,0.16666666666666666,"[""charliehebdo-all-rnr-threads"", ""ottawashooting-all-rnr-threads"", ""ferguson-all-rnr-threads""]","[""1652541"", ""42970367"", ""14216661"", ""41292655"", ""319777415""]",1,5,6
9081792,2,121.0,-0.4564477503299713,1985341.0,2,0.5,"[""charliehebdo-all-rnr-threads"", ""sydneysiege-all-rnr-threads""]","[""25999072"", ""5402612""]",1,1,2
197499997,2,63.0,-0.08202341198921204,2040269.0,2,0.5,"[""charliehebdo-all-rnr-threads"", ""sydneysiege-all-rnr-threads""]","[""1652541"", ""25999072""]",1,1,2
243831804,5,104.2,-0.0926100730895996,13051578.0,4,0.2,"[""charliehebdo-all-rnr-threads"", ""ferguson-all-rnr-threads""]","[""124227622"", ""56539746"", ""1231224926"", ""15644999""]",1,4,5
224180296,2,121.5,-0.004139900207519531,1995181.0,2,0.0,"[""charliehebdo-all-rnr-threads"", ""sydneysiege-all-rnr-threads""]","[""3108351"", ""15319103""]",0,2,2
330378192,7,107.57142857142857,-0.0092725328036717,6729426.0,44,0.14285714285714285,"[""charliehebdo-all-rnr-threads"", ""ottawashooting-all-rnr-threads"", ""sydneysiege-all-rnr-threads""]","[""57625784"", ""2426855263"", ""20724173"", ""492919257"", ""2396932903"", ""19803724"", ""2260831783"", ""614732422"", ""183128473"", ""1068809875"", ""341330045"", ""516103610"", ""2866468824"", ""108518115"", ""1687443698"", ""144679342"", ""241085704"", ""16589206"", ""1260267096"", ""1925013420"", ""94023535"", ""75192299"", ""1945862701"", ""291763454"", ""189679073"", ""175238215"", ""1524329449"", ""1664231676"", ""49206653"", ""1404087277"", ""586214104"", ""27321851"", ""330378192"", ""138018216"", ""2915059130"", ""22899644"", ""148116121"", ""467177530"", ""17359222"", ""71106714"", ""43413743"", ""1018684608"", ""15319103"", ""300061463""]",1,6,7
120668752,2,106.0,-0.5986907184123993,2025850.0,2,0.5,"[""charliehebdo-all-rnr-threads"", ""sydneysiege-all-rnr-threads""]","[""15319103"", ""807095""]",1,1,2
20165699,5,68.2,-0.7363857150077819,2056493.0,1,0.0,"[""charliehebdo-all-rnr-threads"", ""sydneysiege-all-rnr-threads""]","[""16973333""]",0,5,5
303170999,2,104.0,0.047273099422454834,1995264.0,2,0.0,"[""charliehebdo-all-rnr-threads"", ""sydneysiege-all-rnr-threads""]","[""75060487"", ""130557513""]",0,2,2
2162983369,14,87.64285714285714,-0.1006769665649959,13433560.0,9,0.35714285714285715,"[""charliehebdo-all-rnr-threads"", ""germanwings-crash-all-rnr-threads"", ""ottawashooting-all-rnr-threads"", ""sydneysiege-all-rnr-threads""]","[""351120282"", ""17995040"", ""8736882"", ""3108351"", ""2502895924"", ""28785486"", ""952112047"", ""75060487"", ""525634151""]",5,9,14
111268212,3,108.66666666666667,-0.15565232435862222,2185858.0,3,0.0,"[""charliehebdo-all-rnr-threads"", ""sydneysiege-all-rnr-threads""]","[""2097571"", ""2886154223"", ""589010907""]",0,3,3
1943929622,3,106.0,-0.014320929845174154,2020053.0,2,0.0,"[""charliehebdo-all-rnr-threads"", ""sydneysiege-all-rnr-threads""]","[""45715838"", ""2886154223""]",0,3,3
196994616,4,104.25,0.1707058548927307,6560405.0,46,0.0,"[""charliehebdo-all-rnr-threads"", ""germanwings-crash-all-rnr-threads""]","[""317743589"", ""2354568518"", ""207459026"", ""415503053"", ""2842490193"", ""366023367"", ""49569360"", ""1050747590"", ""914876178"", ""325234656"", ""1020681224"", ""394186308"", ""2935011976"", ""136571654"", ""2335689954"", ""134552828"", ""1344297120"", ""2161648412"", ""2943736121"", ""46448565"", ""231099965"", ""262070636"", ""18455693"", ""25061351"", ""2742766608"", ""1912417688"", ""37714448"", ""1031065032"", ""905465755"", ""1581605892"", ""2356127598"", ""517747314"", ""2404476623"", ""49160766"", ""290085745"", ""2294598662"", ""85604163"", ""1972407720"", ""69008365"", ""2950074623"", ""132845751"", ""1963640108"", ""2699282928"", ""452597808"", ""2937178035"", ""2529944310""]",0,4,4
295747220,2,46.0,-0.5144688487052917,6651554.0,2,0.5,"[""charliehebdo-all-rnr-threads"", ""ottawashooting-all-rnr-threads""]","[""18725815"", ""18999969""]",1,1,2
21063394,12,119.25,-0.3119441519180934,12541116.0,3,0.08333333333333333,"[""charliehebdo-all-rnr-threads"", ""ferguson-all-rnr-threads""]","[""373416209"", ""268476335"", ""159491022""]",1,11,12
350509019,5,95.0,-0.4379927158355713,2030981.0,2,0.0,"[""charliehebdo-all-rnr-threads"", ""sydneysiege-all-rnr-threads""]","[""46078438"", ""159491022""]",0,5,5
39209049,25,105.36,-0.19327338933944702,12705365.0,6,0.0,"[""charliehebdo-all-rnr-threads"", ""ferguson-all-rnr-threads""]","[""22416658"", ""159491022"", ""1507338108"", ""14849562"", ""27376958"", ""1716581""]",0,25,25
2747371108,2,123.5,-0.35961461067199707,1987531.0,2,0.5,"[""charliehebdo-all-rnr-threads"", ""sydneysiege-all-rnr-threads""]","[""365939318"", ""16834659""]",1,1,2
580041801,2,64.5,-0.05177813768386841,12679185.0,2,0.5,"[""charliehebdo-all-rnr-threads"", ""ferguson-all-rnr-threads""]","[""365939318"", ""954124423""]",1,1,2
71688199,2,71.0,0.11894544959068298,6650383.0,2,0.5,"[""charliehebdo-all-rnr-threads"", ""ottawashooting-all-rnr-threads""]","[""365939318"", ""19038934""]",1,1,2
187564961,2,89.0,0.30295276641845703,12953254.0,2,0.0,"[""charliehebdo-all-rnr-threads"", ""ferguson-all-rnr-threads""]","[""365939318"", ""14090948""]",0,2,2
315878798,28,79.82142857142857,-0.06820382816450936,2006933.0,46,0.0,"[""charliehebdo-all-rnr-threads"", ""sydneysiege-all-rnr-threads""]","[""315878798"", ""2590310822"", ""493652059"", ""1049124127"", ""2851238004"", ""1231063938"", ""570396073"", ""16850725"", ""479210348"", ""21522858"", ""138901623"", ""57078114"", ""182347444"", ""2833164631"", ""792579313"", ""257663805"", ""52872420"", ""577768293"", ""85312972"", ""1556708424"", ""1651804056"", ""1544014950"", ""959349781"", ""25654072"", ""2911685895"", ""2804155946"", ""47600280"", ""36435132"", ""889810789"", ""319932205"", ""35303857"", ""41109410"", ""2212864083"", ""1853261750"", ""2680472802"", ""27359869"", ""521761797"", ""1884135558"", ""1436692442"", ""713080381"", ""2481116335"", ""2367650918"", ""845325566"", ""523368085"", ""2447290136"", ""27811706""]",0,28,28
521761797,5,136.0,-0.48278969526290894,12521901.0,4,0.2,"[""charliehebdo-all-rnr-threads"", ""ottawashooting-all-rnr-threads"", ""ferguson-all-rnr-threads"", ""sydneysiege-all-rnr-threads""]","[""17537467"", ""1367531"", ""315878798"", ""363879015""]",1,4,5
1436692442,2,133.5,-0.1783093810081482,12581396.0,2,0.0,"[""charliehebdo-all-rnr-threads"", ""ferguson-all-rnr-threads""]","[""101848151"", ""315878798""]",0,2,2
36435132,4,97.25,-0.019495800137519836,6660852.0,2,0.25,"[""charliehebdo-all-rnr-threads"", ""ottawashooting-all-rnr-threads""]","[""410334710"", ""315878798""]",1,3,4
2296636419,7,104.57142857142857,-0.5865187559809003,1997280.0,2,0.0,"[""charliehebdo-all-rnr-threads"", ""sydneysiege-all-rnr-threads""]","[""122928586"", ""2378713202""]",0,7,7
142707054,2,125.5,-0.572414219379425,2015800.0,2,0.5,"[""charliehebdo-all-rnr-threads"", ""sydneysiege-all-rnr-threads""]","[""122928586"", ""807095""]",1,1,2
1208396532,3,123.0,-0.33867645263671875,6676553.0,2,0.3333333333333333,"[""charliehebdo-all-rnr-threads"", ""ottawashooting-all-rnr-threads""]","[""122928586"", ""64643056""]",1,2,3
628643658,2,107.0,-0.14266085624694824,2023501.0,2,0.0,"[""charliehebdo-all-rnr-threads"", ""sydneysiege-all-rnr-threads""]","[""407871140"", ""14293310""]",0,2,2
21062446,2,137.0,-0.5009840428829193,6552528.0,2,0.0,"[""charliehebdo-all-rnr-threads"", ""germanwings-crash-all-rnr-threads""]","[""807242"", ""7587032""]",0,2,2
207441433,8,95.625,-0.3169737607240677,6758660.0,27,0.125,"[""charliehebdo-all-rnr-threads"", ""germanwings-crash-all-rnr-threads""]","[""244616017"", ""1952486390"", ""6256362"", ""2367329905"", ""17442320"", ""807095"", ""207441433"", ""1394929760"", ""28314898"", ""723925663"", ""87765761"", ""22600696"", ""48999435"", ""93887048"", ""255187660"", ""1225066262"", ""597380188"", ""2926388692"", ""860820816"", ""165335229"", ""365939318"", ""97959870"", ""410070653"", ""517689879"", ""2292170091"", ""261350157"", ""630030090""]",1,7,8
469194846,3,118.0,-0.37263302008310956,2038831.0,35,0.6666666666666666,"[""charliehebdo-all-rnr-threads"", ""sydneysiege-all-rnr-threads""]","[""294144881"", ""812215344"", ""905019768"", ""16190478"", ""398073907"", ""24859202"", ""108450607"", ""39770909"", ""586447578"", ""1084264573"", ""1942570267"", ""1297207694"", ""316566075"", ""71216162"", ""1551514550"", ""2892277057"", ""216172986"", ""56670976"", ""18315361"", ""520815869"", ""1347197874"", ""2871580701"", ""872786449"", ""34153363"", ""61344211"", ""26399354"", ""872327408"", ""317308866"", ""110603598"", ""370934995"", ""1739650556"", ""69768385"", ""452382101"", ""14323460"", ""1421356142""]",2,1,3
1084264573,5,35.6,-0.043797755241394044,12249732.0,3,0.4,"[""charliehebdo-all-rnr-threads"", ""putinmissing-all-rnr-threads"", ""ottawashooting-all-rnr-threads"", ""sydneysiege-all-rnr-threads""]","[""3108351"", ""635608354"", ""469194846""]",2,3,5
69768385,5,67.0,-0.041445255279541016,2208001.0,4,0.4,"[""charliehebdo-all-rnr-threads"", ""sydneysiege-all-rnr-threads""]","[""1960878613"", ""429533485"", ""1379288282"", ""469194846""]",2,3,5
905019768,7,111.42857142857143,-0.37666123253958567,12617312.0,3,0.0,"[""charliehebdo-all-rnr-threads"", ""ferguson-all-rnr-threads""]","[""109065990"", ""149913262"", ""469194846""]",0,7,7
1399838677,4,95.5,0.25677376985549927,8600179.0,2,0.5,"[""charliehebdo-all-rnr-threads"", ""germanwings-crash-all-rnr-threads"", ""sydneysiege-all-rnr-threads""]","[""1367531"", ""15513604""]",2,2,4
193048446,2,96.5,-0.2368788719177246,6656196.0,2,0.5,"[""charliehebdo-all-rnr-threads"", ""ottawashooting-all-rnr-threads""]","[""21212604"", ""1367531""]",1,1,2
1090556088,12,110.25,-0.520918587843577,2039760.0,13,0.0,"[""charliehebdo-all-rnr-threads"", ""sydneysiege-all-rnr-threads""]","[""16930489"", ""872244828"", ""527900465"", ""2669507507"", ""23213281"", ""48691994"", ""15710392"", ""24721342"", ""532497105"", ""373783051"", ""520011678"", ""11741632"", ""175783382""]",0,12,12
2456688877,3,86.0,-0.18170404434204102,1987144.0,2,0.0,"[""charliehebdo-all-rnr-threads"", ""sydneysiege-all-rnr-threads""]","[""56760430"", ""268676434""]",0,3,3
2538899928,8,99.625,-0.18799473345279694,6655589.0,5,0.75,"[""charliehebdo-all-rnr-threads"", ""ottawashooting-all-rnr-threads""]","[""21733692"", ""272172091"", ""203123011"", ""249339016"", ""5402612""]",6,2,8
20003443,4,106.25,0.16347768902778625,4321007.0,3,0.0,"[""charliehebdo-all-rnr-threads"", ""gurlitt-all-rnr-threads""]","[""21397917"", ""42970367"", ""83638901""]",0,4,4
2159745935,2,67.0,-0.5452217161655426,1918215.0,2,0.0,"[""charliehebdo-all-rnr-threads"", ""sydneysiege-all-rnr-threads""]","[""552842384"", ""87297341""]",0,2,2
228073841,2,97.0,-0.5337961614131927,6630325.0,2,0.5,"[""charliehebdo-all-rnr-threads"", ""ottawashooting-all-rnr-threads""]","[""87297341"", ""2467791""]",1,1,2
58058688,2,30.5,0.5898356437683105,12733388.0,2,0.0,"[""charliehebdo-all-rnr-threads"", ""ferguson-all-rnr-threads""]","[""16560657"", ""17441447""]",0,2,2
21051642,3,70.0,0.256566842397054,2108240.0,3,0.0,"[""charliehebdo-all-rnr-threads"", ""sydneysiege-all-rnr-threads""]","[""17741799"", ""17441447"", ""1359226843""]",0,3,3
16071327,3,113.0,-0.010447462399800619,2003996.0,3,0.3333333333333333,"[""charliehebdo-all-rnr-threads"", ""sydneysiege-all-rnr-threads""]","[""18424289"", ""5988062"", ""64643056""]",1,2,3
2294804946,5,73.0,0.023061108589172364,2159013.0,4,0.0,"[""charliehebdo-all-rnr-threads"", ""sydneysiege-all-rnr-threads""]","[""18424289"", ""15012486"", ""2097571"", ""487600344""]",0,5,5
246801406,2,113.5,-0.18432310223579407,6633187.0,2,0.5,"[""charliehebdo-all-rnr-threads"", ""ottawashooting-all-rnr-threads""]","[""18424289"", ""272172091""]",1,1,2
22446355,8,74.875,-0.4072093963623047,2029820.0,3,0.0,"[""charliehebdo-all-rnr-threads"", ""sydneysiege-all-rnr-threads""]","[""373783051"", ""501768982"", ""954124423""]",0,8,8
505549131,5,86.0,-0.5595770478248596,1992367.0,3,0.8,"[""charliehebdo-all-rnr-threads"", ""sydneysiege-all-rnr-threads""]","[""20639175"", ""1077971"", ""171802941""]",4,1,5
347462394,14,91.85714285714286,-0.33969224776540485,2004676.0,2,0.9285714285714286,"[""charliehebdo-all-rnr-threads"", ""sydneysiege-all-rnr-threads""]","[""1077971"", ""742143""]",13,1,14
15446865,2,75.0,-0.2656552791595459,6650485.0,2,0.5,"[""charliehebdo-all-rnr-threads"", ""ottawashooting-all-rnr-threads""]","[""788524"", ""25516222""]",1,1,2
93349233,5,51.4,-0.16847336292266846,6650107.0,5,0.4,"[""charliehebdo-all-rnr-threads"", ""ottawashooting-all-rnr-threads"", ""sydneysiege-all-rnr-threads""]","[""61126132"", ""742143"", ""47685065"", ""243249906"", ""15012486""]",2,3,5
602767623,9,129.33333333333334,-0.1799767944547865,2035466.0,3,0.7777777777777778,"[""charliehebdo-all-rnr-threads"", ""sydneysiege-all-rnr-threads""]","[""254873869"", ""14098166"", ""243249906""]",7,2,9
339847349,10,91.8,-0.3148305773735046,6649935.0,6,0.4,"[""charliehebdo-all-rnr-threads"", ""ottawashooting-all-rnr-threads"", ""sydneysiege-all-rnr-threads""]","[""2566535282"", ""6433472"", ""19038934"", ""747398809"", ""203123011"", ""5402612""]",4,6,10
175584371,5,107.4,-0.13379883766174316,2121275.0,3,0.2,"[""charliehebdo-all-rnr-threads"", ""sydneysiege-all-rnr-threads""]","[""460005853"", ""16170253"", ""292777349""]",1,4,5
312696314,3,114.0,-0.2347994645436605,2025004.0,19,0.0,"[""charliehebdo-all-rnr-threads"", ""sydneysiege-all-rnr-threads""]","[""2653204868"", ""217421873"", ""594976909"", ""1176487490"", ""64067171"", ""855706392"", ""2891327902"", ""2201746030"", ""1278184561"", ""85189598"", ""233801630"", ""792802638"", ""2708897486"", ""311219562"", ""243280033"", ""2554326446"", ""16675569"", ""58258157"", ""1348798826""]",0,3,3
373601625,5,55.6,-0.17507435083389283,6654892.0,4,0.6,"[""charliehebdo-all-rnr-threads"", ""ottawashooting-all-rnr-threads"", ""sydneysiege-all-rnr-threads""]","[""1960878613"", ""6433472"", ""1367531"", ""20748745""]",3,2,5
37624597,2,59.5,-0.038729310035705566,2008377.0,2,0.0,"[""charliehebdo-all-rnr-threads"", ""sydneysiege-all-rnr-threads""]","[""1246678909"", ""20748745""]",0,2,2
1052399454,3,91.66666666666667,-0.4321664571762085,12530262.0,3,0.6666666666666666,"[""charliehebdo-all-rnr-threads"", ""ottawashooting-all-rnr-threads"", ""ferguson-all-rnr-threads""]","[""16721461"", ""119972954"", ""8839632""]",2,1,3
1416161688,3,128.0,-0.6034770806630453,2032074.0,2,0.0,"[""charliehebdo-all-rnr-threads"", ""sydneysiege-all-rnr-threads""]","[""16721461"", ""35051304""]",0,3,3
715539325,6,68.5,-0.056422303120295204,1989703.0,3,0.0,"[""charliehebdo-all-rnr-threads"", ""sydneysiege-all-rnr-threads""]","[""373783051"", ""16721461"", ""17995040""]",0,6,6
17206650,2,106.0,0.6616321802139282,1988759.0,2,0.5,"[""charliehebdo-all-rnr-threads"", ""sydneysiege-all-rnr-threads""]","[""788524"", ""297690193""]",1,1,2
339312080,3,121.66666666666667,-0.18137137095133463,6742575.0,3,0.0,"[""charliehebdo-all-rnr-threads"", ""ottawashooting-all-rnr-threads""]","[""1652541"", ""18510860"", ""329121956""]",0,3,3
2426,3,79.0,-0.17092005411783853,2030566.0,16,0.6666666666666666,"[""charliehebdo-all-rnr-threads"", ""sydneysiege-all-rnr-threads""]","[""13229442"", ""3367641"", ""54937843"", ""333621593"", ""263660425"", ""21048715"", ""247938477"", ""15230558"", ""747533"", ""45127876"", ""1839381"", ""456921114"", ""14069034"", ""532661320"", ""17919393"", ""14234180""]",2,1,3
117110737,3,123.0,-0.32610509792963666,2041458.0,2,0.6666666666666666,"[""charliehebdo-all-rnr-threads"", ""sydneysiege-all-rnr-threads""]","[""972651"", ""292777349""]",2,1,3
48766152,4,102.25,-0.26357610523700714,12396655.0,2,0.0,"[""charliehebdo-all-rnr-threads"", ""ferguson-all-rnr-threads""]","[""55113967"", ""373416209""]",0,4,4
29465011,6,122.0,-0.5337415238221487,2211311.0,2,0.3333333333333333,"[""charliehebdo-all-rnr-threads"", ""sydneysiege-all-rnr-threads""]","[""171802941"", ""292777349""]",2,4,6
78869025,4,52.0,-0.3473995327949524,2079970.0,3,0.0,"[""charliehebdo-all-rnr-threads"", ""sydneysiege-all-rnr-threads""]","[""1375289149"", ""759251"", ""292777349""]",0,4,4
17999966,2,139.5,-0.6772329807281494,1991002.0,1,0.0,"[""charliehebdo-all-rnr-threads"", ""sydneysiege-all-rnr-threads""]","[""292777349""]",0,2,2
55712928,2,89.0,-0.3869360685348511,12582108.0,2,0.5,"[""charliehebdo-all-rnr-threads"", ""ferguson-all-rnr-threads""]","[""230787751"", ""1716581""]",1,1,2
2701014260,2,103.5,-0.15254813432693481,12519713.0,2,0.0,"[""charliehebdo-all-rnr-threads"", ""ferguson-all-rnr-threads""]","[""37501003"", ""257747817""]",0,2,2
977204844,4,97.75,-0.3059135675430298,12960272.0,3,0.0,"[""charliehebdo-all-rnr-threads"", ""ferguson-all-rnr-threads""]","[""183341278"", ""257747817"", ""23831448""]",0,4,4
360129829,4,113.0,-0.43695780634880066,12538178.0,21,0.75,"[""charliehebdo-all-rnr-threads"", ""ferguson-all-rnr-threads""]","[""34619653"", ""766996760"", ""17300548"", ""169890210"", ""390696780"", ""421182984"", ""42147957"", ""377696943"", ""17798031"", ""115750555"", ""162674848"", ""211280553"", ""21613942"", ""360129829"", ""1010456808"", ""511167564"", ""2386012770"", ""2412689935"", ""2741204688"", ""257747817"", ""143313538""]",3,1,4
331014209,3,101.0,-0.035564700762430825,6649851.0,3,0.0,"[""charliehebdo-all-rnr-threads"", ""ottawashooting-all-rnr-threads""]","[""68577152"", ""20878297"", ""1115146242""]",0,3,3
49700849,3,69.0,0.2622733513514201,6637132.0,3,0.3333333333333333,"[""charliehebdo-all-rnr-threads"", ""ottawashooting-all-rnr-threads""]","[""272172091"", ""20878297"", ""257291338""]",1,2,3
15427912,10,118.7,-0.4905092120170593,6726310.0,4,0.0,"[""charliehebdo-all-rnr-threads"", ""ottawashooting-all-rnr-threads""]","[""148653311"", ""16343974"", ""97382927"", ""154066182""]",0,10,10
150974182,5,52.2,-0.26640365123748777,2345079.0,4,0.0,"[""charliehebdo-all-rnr-threads"", ""sydneysiege-all-rnr-threads""]","[""17537467"", ""206979151"", ""1359226843"", ""154066182""]",0,5,5
24001226,2,127.0,-0.07993870973587036,2044495.0,2,0.0,"[""charliehebdo-all-rnr-threads"", ""sydneysiege-all-rnr-threads""]","[""204832963"", ""645503""]",0,2,2
495464885,7,116.14285714285714,-0.3808124916894095,12669973.0,92,0.0,"[""charliehebdo-all-rnr-threads"", ""ferguson-all-rnr-threads""]","[""14427663"", ""1582077440"", ""188317155"", ""49388645"", ""119512960"", ""619760091"", ""495464885"", ""24238344"", ""794622211"", ""43378629"", ""1381489394"", ""1113825758"", ""457937298"", ""1097164332"", ""292629799"", ""14367935"", ""241559936"", ""338563496"", ""424657192"", ""2248084328"", ""2353607802"", ""277670569"", ""502155957"", ""613585172"", ""167255663"", ""2556027474"", ""257627273"", ""85738930"", ""51197241"", ""720544370"", ""12199652"", ""21874827"", ""501381054"", ""2279792244"", ""2322207225"", ""398689270"", ""14123701"", ""63682553"", ""44811114"", ""19028476"", ""249569378"", ""1937948592"", ""706919497"", ""28781926"", ""15819329"", ""1166506328"", ""167676689"", ""18334049"", ""24620486"", ""435427542"", ""2838670203"", ""1975940696"", ""63454290"", ""1087371074"", ""1891226040"", ""938022144"", ""2446614943"", ""210721521"", ""1301679750"", ""32707036"", ""814054454"", ""176708451"", ""68552069"", ""417315492"", ""880169738"", ""84194378"", ""364194053"", ""841303244"", ""171435540"", ""555584993"", ""1107594619"", ""10257342"", ""483275984"", ""47694347"", ""987416268"", ""729719605"", ""831862195"", ""489855788"", ""47282744"", ""569900167"", ""49797407"", ""481778335"", ""270411885"", ""558865239"", ""21713975"", ""20704612"", ""49678655"", ""786138018"", ""235430222"", ""60420690"", ""788255594"", ""402070775""]",0,7,7
270411885,2,63.5,0.7304062843322754,6648366.0,2,0.0,"[""charliehebdo-all-rnr-threads"", ""ottawashooting-all-rnr-threads""]","[""495464885"", ""289998339""]",0,2,2
24620486,4,113.5,0.031155988574028015,2081319.0,4,0.0,"[""charliehebdo-all-rnr-threads"", ""sydneysiege-all-rnr-threads""]","[""9207632"", ""495464885"", ""282977213"", ""121817564""]",0,4,4
51197241,4,105.25,0.027942746877670288,12513868.0,3,0.5,"[""charliehebdo-all-rnr-threads"", ""ferguson-all-rnr-threads""]","[""69773058"", ""495464885"", ""21879831""]",2,2,4
7309052,5,125.4,-0.6997133016586303,8727337.0,21,0.8,"[""charliehebdo-all-rnr-threads"", ""germanwings-crash-all-rnr-threads"", ""sydneysiege-all-rnr-threads""]","[""1030435626"", ""268635919"", ""2901964056"", ""2885752132"", ""2416235035"", ""279018011"", ""2241422761"", ""2721599621"", ""31493602"", ""390232856"", ""329976431"", ""2830305847"", ""1517705112"", ""15517408"", ""2912429401"", ""100005598"", ""100150564"", ""113174096"", ""534689933"", ""1348798826"", ""16509444""]",4,1,5
2901964056,10,62.1,-0.2724575698375702,5715863.0,4,0.1,"[""charliehebdo-all-rnr-threads"", ""putinmissing-all-rnr-threads""]","[""522285305"", ""15438913"", ""7309052"", ""31135856""]",1,9,10
2198241673,2,113.5,-0.04448089003562927,12514527.0,2,0.0,"[""charliehebdo-all-rnr-threads"", ""ferguson-all-rnr-threads""]","[""15764415"", ""2097571""]",0,2,2
373783051,32,74.625,-0.14481677673757076,12507241.0,142,0.46875,"[""charliehebdo-all-rnr-threads"", ""sydneysiege-all-rnr-threads"", ""ferguson-all-rnr-threads""]","[""165859140"", ""607651527"", ""1090556088"", ""891449460"", ""238726677"", ""1884219200"", ""18815956"", ""336377205"", ""635204214"", ""1433155524"", ""402090275"", ""229846341"", ""531629036"", ""1865674987"", ""45061641"", ""98229175"", ""2437571275"", ""366375833"", ""172036550"", ""2194470846"", ""2316330373"", ""2931673021"", ""1682405497"", ""216542945"", ""27211964"", ""2842251353"", ""861712795"", ""919261092"", ""373783051"", ""351405195"", ""1951578937"", ""81696231"", ""29623004"", ""399162779"", ""134617566"", ""451656800"", ""52616937"", ""1955360286"", ""47259148"", ""1158273516"", ""24269325"", ""1226495796"", ""2241793219"", ""515895662"", ""77752606"", ""154523730"", ""404507637"", ""1104705374"", ""245200769"", ""624557599"", ""375190644"", ""311340378"", ""244323892"", ""111356099"", ""2730969312"", ""1349989992"", ""1161786943"", ""791064132"", ""263007263"", ""51201342"", ""199387685"", ""374215189"", ""1711450184"", ""594337767"", ""49209314"", ""566793543"", ""17264634"", ""2604128282"", ""861931308"", ""272247691"", ""973285034"", ""2317019724"", ""2494237140"", ""1692065287"", ""1634077976"", ""275450877"", ""898728732"", ""313198995"", ""1276671109"", ""325294552"", ""81060557"", ""366748134"", ""496236228"", ""2923372268"", ""2808659378"", ""108654382"", ""2474647404"", ""33822094"", ""31267020"", ""359678512"", ""350261087"", ""620045396"", ""230859523"", ""937897969"", ""926317914"", ""1366631"", ""22095997"", ""1964968338"", ""15943896"", ""64272430"", ""254258301"", ""1931711646"", ""86883476"", ""715539325"", ""297940057"", ""22446355"", ""2485285513"", ""2886832201"", ""534943027"", ""1977706561"", ""67285893"", ""428447412"", ""1339382407"", ""103037378"", ""1921550196"", ""375940972"", ""15166145"", ""1567581847"", ""44444655"", ""1177626974"", ""142150016"", ""2831069305"", ""1576714754"", ""1656966026"", ""1203031308"", ""206962580"", ""55347838"", ""80091959"", ""160348847"", ""2850249772"", ""269620333"", ""2347201443"", ""616677817"", ""389604704"", ""571301970"", ""272197502"", ""2835341775"", ""156829334"", ""792995834"", ""61554871"", ""2536112278"", ""2744045135""]",15,17,32
861712795,4,64.25,0.07108038663864136,1995265.0,4,0.0,"[""charliehebdo-all-rnr-threads"", ""sydneysiege-all-rnr-threads""]","[""373783051"", ""43182702"", ""51241574"", ""149913262""]",0,4,4
216542945,2,120.0,-0.3566896319389343,12513852.0,2,0.0,"[""charliehebdo-all-rnr-threads"", ""ferguson-all-rnr-threads""]","[""373783051"", ""15907183""]",0,2,2
937897969,2,122.5,-0.043180108070373535,2041279.0,2,0.0,"[""charliehebdo-all-rnr-threads"", ""sydneysiege-all-rnr-threads""]","[""373783051"", ""16675569""]",0,2,2
607651527,4,115.5,-0.43007852137088776,12520823.0,2,0.5,"[""charliehebdo-all-rnr-threads"", ""ottawashooting-all-rnr-threads"", ""ferguson-all-rnr-threads""]","[""373783051"", ""20748745""]",2,2,4
2437571275,8,69.0,-0.20142053812742233,13027367.0,3,0.0,"[""charliehebdo-all-rnr-threads"", ""ferguson-all-rnr-threads""]","[""373783051"", ""1539100118"", ""100136358""]",0,8,8
16533116,2,115.0,0.7995346784591675,12648079.0,2,0.0,"[""charliehebdo-all-rnr-threads"", ""ferguson-all-rnr-threads""]","[""17073225"", ""246532728""]",0,2,2
2697713994,4,138.0,-0.32396532595157623,6554402.0,2,0.0,"[""charliehebdo-all-rnr-threads"", ""germanwings-crash-all-rnr-threads""]","[""5402612"", ""246532728""]",0,4,4
2651936329,5,71.6,-0.135243821144104,2028130.0,4,0.0,"[""charliehebdo-all-rnr-threads"", ""sydneysiege-all-rnr-threads""]","[""7702542"", ""520011678"", ""101520906"", ""246532728""]",0,5,5
134240162,6,96.66666666666667,-0.19855482379595438,6646241.0,5,0.16666666666666666,"[""charliehebdo-all-rnr-threads"", ""ottawashooting-all-rnr-threads"", ""sydneysiege-all-rnr-threads""]","[""8736882"", ""7587032"", ""491344675"", ""292777349"", ""5402612""]",1,5,6
204844864,5,121.0,-0.36540788412094116,13293757.0,5,0.4,"[""charliehebdo-all-rnr-threads"", ""germanwings-crash-all-rnr-threads"", ""ottawashooting-all-rnr-threads""]","[""16973333"", ""148116121"", ""51241574"", ""16299754"", ""41479334""]",2,3,5
2448215593,2,41.5,-0.5715205371379852,12667942.0,2,0.0,"[""charliehebdo-all-rnr-threads"", ""ferguson-all-rnr-threads""]","[""1716581"", ""16973333""]",0,2,2
27859283,2,110.0,-0.872870922088623,6747152.0,2,0.5,"[""charliehebdo-all-rnr-threads"", ""germanwings-crash-all-rnr-threads""]","[""1367531"", ""16973333""]",1,1,2
1068809875,2,40.0,0.1520635485649109,6563984.0,2,0.5,"[""charliehebdo-all-rnr-threads"", ""germanwings-crash-all-rnr-threads""]","[""330378192"", ""15513604""]",1,1,2
14717197,9,112.44444444444444,-0.5508186088667976,12535643.0,47,0.7777777777777778,"[""charliehebdo-all-rnr-threads"", ""ferguson-all-rnr-threads""]","[""374577469"", ""50251957"", ""54938749"", ""124555919"", ""33928457"", ""537670884"", ""2610546426"", ""259094582"", ""268528880"", ""331377273"", ""902528816"", ""246458133"", ""335871995"", ""156737416"", ""67706546"", ""911076488"", ""463977154"", ""2733049310"", ""805089864"", ""234018353"", ""1431651026"", ""106279514"", ""1080941352"", ""14731096"", ""20045868"", ""287275623"", ""65963242"", ""1468900753"", ""17329509"", ""2599925509"", ""1307986423"", ""1551980622"", ""201295178"", ""148383532"", ""2556666510"", ""126508387"", ""531931392"", ""14717197"", ""66914769"", ""433685408"", ""743765600"", ""22705932"", ""538027644"", ""193173207"", ""25941064"", ""25221139"", ""131039234""]",7,2,9
33928457,4,108.25,-0.34732355177402496,12542947.0,3,0.0,"[""charliehebdo-all-rnr-threads"", ""ferguson-all-rnr-threads""]","[""14717197"", ""64643056"", ""2680112214""]",0,4,4
25941064,6,96.83333333333333,-0.30737630526224774,2028501.0,4,0.16666666666666666,"[""charliehebdo-all-rnr-threads"", ""sydneysiege-all-rnr-threads""]","[""14717197"", ""55186601"", ""14138785"", ""153029181""]",1,5,6
19899606,2,104.5,-0.4086337685585022,2014764.0,37,0.0,"[""charliehebdo-all-rnr-threads"", ""sydneysiege-all-rnr-threads""]","[""2882796675"", ""18209365"", ""583930928"", ""492034711"", ""2728595262"", ""441170122"", ""1497511932"", ""2861380028"", ""244015944"", ""1367921624"", ""119058143"", ""84572885"", ""399065347"", ""254803029"", ""2737987487"", ""1478130330"", ""525249347"", ""50377802"", ""2534066732"", ""1359226843"", ""138579043"", ""2842567535"", ""2295239155"", ""980457650"", ""2733816872"", ""302174491"", ""431590274"", ""328440716"", ""38635888"", ""2419558070"", ""101541188"", ""285902442"", ""2344354190"", ""479794433"", ""1240917696"", ""2193750641"", ""256046799""]",0,2,2
2295239155,12,122.33333333333333,-0.13522835075855255,2148371.0,3,0.0,"[""charliehebdo-all-rnr-threads"", ""sydneysiege-all-rnr-threads""]","[""19899606"", ""1125937411"", ""270569708""]",0,12,12
62591883,10,123.9,-0.2697641432285309,12707014.0,9,0.7,"[""charliehebdo-all-rnr-threads"", ""ottawashooting-all-rnr-threads"", ""ferguson-all-rnr-threads"", ""sydneysiege-all-rnr-threads""]","[""14173315"", ""2884771"", ""7587032"", ""15108702"", ""87416722"", ""64643056"", ""50348344"", ""1367531"", ""5402612""]",7,3,10
151827802,4,74.75,-0.15284903347492218,2022722.0,2,0.0,"[""charliehebdo-all-rnr-threads"", ""sydneysiege-all-rnr-threads""]","[""14173315"", ""103065157""]",0,4,4
303328398,2,82.0,-0.008853912353515625,12674118.0,2,0.0,"[""charliehebdo-all-rnr-threads"", ""ferguson-all-rnr-threads""]","[""17995040"", ""195271137""]",0,2,2
1512120685,2,124.0,-0.44699472188949585,1983620.0,2,0.0,"[""charliehebdo-all-rnr-threads"", ""sydneysiege-all-rnr-threads""]","[""20402945"", ""807095""]",0,2,2
14940354,10,130.7,-0.25617467164993285,19234637.0,92,0.4,"[""charliehebdo-all-rnr-threads"", ""germanwings-crash-all-rnr-threads"", ""sydneysiege-all-rnr-threads"", ""ferguson-all-rnr-threads""]","[""19062512"", ""18657807"", ""17686959"", ""37891446"", ""2824340152"", ""883289545"", ""66278875"", ""18584536"", ""2383954135"", ""2909484938"", ""2148496332"", ""23111958"", ""35679546"", ""395335393"", ""137832626"", ""2347173660"", ""13136732"", ""1591753178"", ""551551599"", ""1559702449"", ""23935607"", ""269042717"", ""249574232"", ""492529570"", ""2655630895"", ""118878145"", ""255527829"", ""143067985"", ""2533320481"", ""51381252"", ""2450833706"", ""7040442"", ""158121515"", ""28024611"", ""12712112"", ""19622848"", ""21899739"", ""77284148"", ""95293452"", ""51003218"", ""213530957"", ""61366208"", ""2222877594"", ""159451731"", ""157013030"", ""102189393"", ""898260326"", ""1516800876"", ""161090384"", ""16678471"", ""2403111176"", ""1487704298"", ""1455108678"", ""391815955"", ""323485509"", ""518018426"", ""15877276"", ""1344297120"", ""2775150405"", ""277747585"", ""251810673"", ""339665363"", ""519314995"", ""47165550"", ""379700347"", ""44165283"", ""36750642"", ""422640612"", ""134808120"", ""448043662"", ""108721985"", ""155285081"", ""96823343"", ""34071928"", ""2469384241"", ""331377273"", ""14940354"", ""51423800"", ""283869205"", ""494579507"", ""447783276"", ""2780648743"", ""134216710"", ""14162258"", ""345071560"", ""9131962"", ""18024557"", ""1038990073"", ""1572315950"", ""18929297"", ""1820497134"", ""2199541""]",4,6,10
54661743,5,126.8,-0.21930575370788574,19424881.0,4,0.2,"[""charliehebdo-all-rnr-threads"", ""germanwings-crash-all-rnr-threads"", ""ferguson-all-rnr-threads""]","[""27187343"", ""282335488"", ""83638901"", ""63502107""]",1,4,5
106790430,2,110.5,-0.15791624784469604,12690680.0,2,0.5,"[""charliehebdo-all-rnr-threads"", ""ferguson-all-rnr-threads""]","[""27187343"", ""26642006""]",1,1,2
595842442,6,69.16666666666667,-0.4000174005826314,2009994.0,2,0.0,"[""charliehebdo-all-rnr-threads"", ""sydneysiege-all-rnr-threads""]","[""27187343"", ""202934450""]",0,6,6
347358838,6,69.66666666666667,-0.5118731757005056,12612923.0,4,0.6666666666666666,"[""charliehebdo-all-rnr-threads"", ""ferguson-all-rnr-threads""]","[""3108351"", ""16973333"", ""15108530"", ""37303498""]",4,2,6
551234726,8,113.125,-0.11054828017950058,6828036.0,7,0.0,"[""charliehebdo-all-rnr-threads"", ""ottawashooting-all-rnr-threads""]","[""168828976"", ""282977213"", ""7587032"", ""15438913"", ""6107422"", ""292777349"", ""39728435""]",0,8,8
19346439,14,102.78571428571429,-0.33342515570776804,6737514.0,72,0.0,"[""charliehebdo-all-rnr-threads"", ""ottawashooting-all-rnr-threads"", ""sydneysiege-all-rnr-threads""]","[""770550"", ""203377811"", ""2790758468"", ""193349169"", ""16076032"", ""175801508"", ""265608153"", ""20233638"", ""2260870241"", ""2436705422"", ""491395396"", ""15628478"", ""22369295"", ""879038035"", ""1451170099"", ""2940918182"", ""227917021"", ""18176779"", ""1972731678"", ""19346439"", ""1155841"", ""220009613"", ""2170209896"", ""40207464"", ""399004122"", ""14150382"", ""985206434"", ""20703804"", ""119084327"", ""73074188"", ""1622984269"", ""18686079"", ""20130428"", ""2194623472"", ""185947193"", ""632286118"", ""1343325901"", ""137077093"", ""310750549"", ""28133713"", ""21570066"", ""162728456"", ""721029913"", ""17484243"", ""1484967949"", ""2201786204"", ""392775714"", ""140622942"", ""86522841"", ""190458578"", ""199701783"", ""610028948"", ""2364786337"", ""8863322"", ""293059094"", ""321034096"", ""472998795"", ""2666274223"", ""238575113"", ""254581920"", ""2787720983"", ""197366013"", ""438118599"", ""105404541"", ""320244126"", ""279533332"", ""60167374"", ""2383104221"", ""89929611"", ""19716217"", ""256046799"", ""2798876236""]",0,14,14
15628478,4,79.0,0.3099764883518219,12687581.0,3,0.0,"[""charliehebdo-all-rnr-threads"", ""ferguson-all-rnr-threads""]","[""13393052"", ""19346439"", ""5513002""]",0,4,4
8863322,3,117.0,-0.25401991605758667,6564387.0,3,0.0,"[""charliehebdo-all-rnr-threads"", ""germanwings-crash-all-rnr-threads""]","[""19346439"", ""16973333"", ""41203507""]",0,3,3
2170209896,8,132.625,-0.3728853240609169,2081980.0,3,0.0,"[""charliehebdo-all-rnr-threads"", ""sydneysiege-all-rnr-threads""]","[""15438913"", ""22021978"", ""19346439""]",0,8,8
879038035,3,122.0,-0.2510852813720703,12741715.0,3,0.0,"[""charliehebdo-all-rnr-threads"", ""sydneysiege-all-rnr-threads"", ""ferguson-all-rnr-threads""]","[""18643437"", ""19346439"", ""7587032""]",0,3,3
1343325901,6,103.5,-0.20509199301401773,2496684.0,3,0.3333333333333333,"[""charliehebdo-all-rnr-threads"", ""sydneysiege-all-rnr-threads""]","[""19346439"", ""206979151"", ""16834659""]",2,4,6
326228723,2,65.5,-0.5469620227813721,6775390.0,2,0.5,"[""charliehebdo-all-rnr-threads"", ""germanwings-crash-all-rnr-threads""]","[""952112047"", ""19211550""]",1,1,2
2302159284,3,101.33333333333333,-0.4967299699783325,2031537.0,3,0.0,"[""charliehebdo-all-rnr-threads"", ""sydneysiege-all-rnr-threads""]","[""18424289"", ""7702542"", ""28785486""]",0,3,3
27637361,17,70.23529411764706,-0.23743705539142385,2114461.0,7,0.23529411764705882,"[""charliehebdo-all-rnr-threads"", ""sydneysiege-all-rnr-threads""]","[""7702542"", ""17995040"", ""171802941"", ""342894187"", ""49279876"", ""22993014"", ""5402612""]",4,13,17
243447325,3,59.0,-0.20215018590291342,6733343.0,3,0.3333333333333333,"[""charliehebdo-all-rnr-threads"", ""ottawashooting-all-rnr-threads""]","[""5402612"", ""292777349"", ""149913262""]",1,2,3
823731786,5,135.0,-0.5336636543273926,2102137.0,5,0.0,"[""charliehebdo-all-rnr-threads"", ""sydneysiege-all-rnr-threads""]","[""763156754"", ""31114386"", ""711348452"", ""149913262"", ""2799960092""]",0,5,5
531598198,24,120.20833333333333,-0.30467411130666733,12683948.0,2,0.0,"[""charliehebdo-all-rnr-threads"", ""ferguson-all-rnr-threads""]","[""14700316"", ""149913262""]",0,24,24
2863774500,2,92.5,-0.0945693850517273,6774446.0,2,0.5,"[""charliehebdo-all-rnr-threads"", ""germanwings-crash-all-rnr-threads""]","[""72882689"", ""149913262""]",1,1,2
45851324,2,138.0,0.13249647617340088,6654716.0,2,0.5,"[""charliehebdo-all-rnr-threads"", ""ottawashooting-all-rnr-threads""]","[""16973333"", ""5402612""]",1,1,2
282977213,10,107.9,-0.33039672374725343,2033997.0,31,0.1,"[""charliehebdo-all-rnr-threads"", ""sydneysiege-all-rnr-threads""]","[""14098166"", ""2317241800"", ""272114850"", ""2583172532"", ""503693741"", ""551234726"", ""1250847332"", ""20048693"", ""55911799"", ""24509168"", ""46313137"", ""26550151"", ""61532349"", ""75192299"", ""2307359154"", ""20496966"", ""291763454"", ""63112335"", ""282977213"", ""2163076560"", ""1485225582"", ""522132942"", ""38087318"", ""281670182"", ""15250661"", ""24620486"", ""2343835389"", ""2263772618"", ""86392086"", ""137521303"", ""1931711646""]",1,9,10
134617566,5,82.8,-0.07630006074905396,2033901.0,2,0.4,"[""charliehebdo-all-rnr-threads"", ""sydneysiege-all-rnr-threads""]","[""373783051"", ""254873869""]",2,3,5
38495037,3,94.0,-0.4753117760022481,2048632.0,2,0.6666666666666666,"[""charliehebdo-all-rnr-threads"", ""sydneysiege-all-rnr-threads""]","[""337200920"", ""258627226""]",2,1,3
254806449,3,93.66666666666667,-0.5978667934735616,6628053.0,2,0.6666666666666666,"[""charliehebdo-all-rnr-threads"", ""ottawashooting-all-rnr-threads""]","[""635608354"", ""337200920""]",2,1,3
280316807,8,109.75,-0.10620392858982086,12695296.0,3,0.25,"[""charliehebdo-all-rnr-threads"", ""ottawashooting-all-rnr-threads"", ""ferguson-all-rnr-threads""]","[""18622869"", ""6160792"", ""26642006""]",2,6,8
180884051,3,98.66666666666667,-0.6488210956255595,5817634.0,2,0.0,"[""charliehebdo-all-rnr-threads"", ""putinmissing-all-rnr-threads""]","[""6160792"", ""64643056""]",0,3,3
2728348305,2,37.5,0.7167662382125854,6463274.0,2,0.5,"[""charliehebdo-all-rnr-threads"", ""ottawashooting-all-rnr-threads""]","[""820585"", ""17820367""]",1,1,2
126966332,4,94.75,-0.3283180594444275,12860990.0,3,0.0,"[""charliehebdo-all-rnr-threads"", ""ferguson-all-rnr-threads""]","[""11265832"", ""820585"", ""319777415""]",0,4,4
44691104,2,48.0,0.0509263277053833,2047395.0,2,0.5,"[""charliehebdo-all-rnr-threads"", ""sydneysiege-all-rnr-threads""]","[""27831488"", ""1571428436""]",1,1,2
2933799228,3,73.33333333333333,-0.20845985412597656,5828058.0,2,0.0,"[""charliehebdo-all-rnr-threads"", ""putinmissing-all-rnr-threads""]","[""292777349"", ""64643056""]",0,3,3
16166464,2,136.5,-0.43891945481300354,2028218.0,2,0.5,"[""charliehebdo-all-rnr-threads"", ""sydneysiege-all-rnr-threads""]","[""972651"", ""14511951""]",1,1,2
60862254,2,115.0,-0.5520510077476501,2001004.0,2,0.0,"[""charliehebdo-all-rnr-threads"", ""sydneysiege-all-rnr-threads""]","[""87818409"", ""16672510""]",0,2,2
36305576,3,105.66666666666667,-0.43756107489267987,2033056.0,3,0.3333333333333333,"[""charliehebdo-all-rnr-threads"", ""sydneysiege-all-rnr-threads""]","[""86141342"", ""199721359"", ""20402945""]",1,2,3
500410336,4,123.5,-0.6929221898317337,13377419.0,4,0.5,"[""charliehebdo-all-rnr-threads"", ""germanwings-crash-all-rnr-threads"", ""ottawashooting-all-rnr-threads"", ""sydneysiege-all-rnr-threads""]","[""5402612"", ""1367531"", ""199721359"", ""17469289""]",2,2,4
204339253,2,139.0,-0.3003584146499634,12604298.0,2,0.0,"[""charliehebdo-all-rnr-threads"", ""ferguson-all-rnr-threads""]","[""199721359"", ""954124423""]",0,2,2
2446614943,3,48.666666666666664,0.21673198541005453,12672515.0,3,0.0,"[""charliehebdo-all-rnr-threads"", ""sydneysiege-all-rnr-threads"", ""ferguson-all-rnr-threads""]","[""495464885"", ""97382927"", ""5402612""]",0,3,3
15143478,3,129.0,-0.5317168434460958,2014038.0,78,0.0,"[""charliehebdo-all-rnr-threads"", ""sydneysiege-all-rnr-threads""]","[""7961972"", ""540771222"", ""175243720"", ""1963704589"", ""16857215"", ""3367641"", ""182570977"", ""2916544419"", ""307221635"", ""189658093"", ""215352821"", ""1569707556"", ""606090045"", ""2681494416"", ""444467128"", ""22120918"", ""107908397"", ""26543707"", ""159855064"", ""222241770"", ""2620831379"", ""13040652"", ""2645645520"", ""48518399"", ""27941438"", ""520565312"", ""2799947666"", ""145263864"", ""217616267"", ""15367213"", ""345289707"", ""56028793"", ""78048071"", ""34453374"", ""2781429392"", ""15565732"", ""140738704"", ""2908664472"", ""115506089"", ""186110649"", ""522289313"", ""342544842"", ""16482504"", ""16023370"", ""15903179"", ""592917236"", ""1406255324"", ""213411682"", ""1416686606"", ""1296296228"", ""21414569"", ""1675503409"", ""39649502"", ""15143478"", ""64039086"", ""1577059465"", ""59685116"", ""558118066"", ""564191971"", ""532682350"", ""52369289"", ""492034711"", ""453714544"", ""2372161123"", ""404260094"", ""170022711"", ""70164920"", ""2873595551"", ""9126702"", ""39204895"", ""32351459"", ""38624168"", ""75945291"", ""716027743"", ""266276055"", ""823857570"", ""324185138"", ""2886174354""]",0,3,3
15367213,3,120.0,-0.13257726033528647,2006015.0,1,0.0,"[""charliehebdo-all-rnr-threads"", ""sydneysiege-all-rnr-threads""]","[""15143478""]",0,3,3
59685116,2,127.0,-0.5799768567085266,2067719.0,2,0.0,"[""charliehebdo-all-rnr-threads"", ""sydneysiege-all-rnr-threads""]","[""44835347"", ""15143478""]",0,2,2
2826961293,5,55.6,-0.09938334226608277,6741553.0,4,0.2,"[""charliehebdo-all-rnr-threads"", ""ottawashooting-all-rnr-threads""]","[""3108351"", ""15586316"", ""15754281"", ""1877831""]",1,4,5
22600696,2,63.5,-0.5332806706428528,6638535.0,2,0.0,"[""charliehebdo-all-rnr-threads"", ""ottawashooting-all-rnr-threads""]","[""207441433"", ""635608354""]",0,2,2
630030090,20,118.1,-0.18158270418643951,12744863.0,4,0.0,"[""charliehebdo-all-rnr-threads"", ""ferguson-all-rnr-threads""]","[""207441433"", ""17068692"", ""14849562"", ""11265832""]",0,20,20
1952486390,3,103.33333333333333,-0.6621890862782797,6634136.0,2,0.6666666666666666,"[""charliehebdo-all-rnr-threads"", ""ottawashooting-all-rnr-threads""]","[""207441433"", ""214007688""]",2,1,3
2938592060,6,129.83333333333334,-0.66036390264829,6774051.0,3,0.0,"[""charliehebdo-all-rnr-threads"", ""germanwings-crash-all-rnr-threads""]","[""403647191"", ""51241574"", ""64643056""]",0,6,6
142165701,3,115.0,-0.05650226275126139,2040837.0,3,0.0,"[""charliehebdo-all-rnr-threads"", ""sydneysiege-all-rnr-threads""]","[""2799960092"", ""403576718"", ""5402612""]",0,3,3
395700090,4,39.75,-0.321016326546669,6783837.0,3,0.75,"[""charliehebdo-all-rnr-threads"", ""germanwings-crash-all-rnr-threads""]","[""91493488"", ""17561562"", ""428333""]",3,1,4
1400503214,3,91.0,-0.07119345664978027,12746238.0,2,0.0,"[""charliehebdo-all-rnr-threads"", ""ferguson-all-rnr-threads""]","[""46303458"", ""428333""]",0,3,3
84135023,2,100.5,0.011594951152801514,1986132.0,2,0.0,"[""charliehebdo-all-rnr-threads"", ""sydneysiege-all-rnr-threads""]","[""17995040"", ""428333""]",0,2,2
441919659,2,108.0,-0.6129213869571686,12516231.0,2,0.5,"[""charliehebdo-all-rnr-threads"", ""ferguson-all-rnr-threads""]","[""16832632"", ""64643056""]",1,1,2
1601942108,2,72.5,0.06808453798294067,6636734.0,2,0.0,"[""charliehebdo-all-rnr-threads"", ""ottawashooting-all-rnr-threads""]","[""113899804"", ""39364684""]",0,2,2
390696780,5,107.8,-0.26560295820236207,12966153.0,5,0.2,"[""charliehebdo-all-rnr-threads"", ""ferguson-all-rnr-threads""]","[""360129829"", ""15164565"", ""14090948"", ""325340909"", ""113899804""]",1,4,5
205242337,5,128.4,0.03066861629486084,2036203.0,40,0.4,"[""charliehebdo-all-rnr-threads"", ""sydneysiege-all-rnr-threads""]","[""343396047"", ""200005378"", ""1474118539"", ""25470467"", ""166799929"", ""2873267413"", ""182656883"", ""20414076"", ""180122238"", ""870204643"", ""176618024"", ""985725253"", ""443194544"", ""496762984"", ""622739825"", ""559687195"", ""249895981"", ""2415492990"", ""25172734"", ""54494842"", ""260677385"", ""145106261"", ""938489083"", ""2534066732"", ""1565429192"", ""230319291"", ""2840741071"", ""181949837"", ""261300530"", ""2855452792"", ""1634918790"", ""2398287421"", ""470799787"", ""22314040"", ""15957148"", ""2511959570"", ""300233998"", ""93524104"", ""151295755"", ""1412768808""]",2,3,5
23880636,8,80.875,-0.3376399502158165,2021081.0,3,0.125,"[""charliehebdo-all-rnr-threads"", ""sydneysiege-all-rnr-threads""]","[""2467959607"", ""292777349"", ""25777812""]",1,7,8
886909039,4,97.75,-0.24355235695838928,6653318.0,2,0.25,"[""charliehebdo-all-rnr-threads"", ""ottawashooting-all-rnr-threads"", ""sydneysiege-all-rnr-threads""]","[""384438102"", ""292777349""]",1,3,4
2502895924,40,120.35,-0.2750639781355858,6669113.0,31,0.275,"[""charliehebdo-all-rnr-threads"", ""ottawashooting-all-rnr-threads"", ""sydneysiege-all-rnr-threads""]","[""2517979899"", ""19318739"", ""141682204"", ""20233638"", ""1855737487"", ""195160252"", ""22558532"", ""369249722"", ""189306474"", ""100906237"", ""1173618348"", ""171802941"", ""850302560"", ""2502895924"", ""153029181"", ""2162983369"", ""269167743"", ""1532402708"", ""160348847"", ""219331447"", ""358135077"", ""16675569"", ""257291338"", ""279534015"", ""22993014"", ""2761606758"", ""4033561"", ""2433017725"", ""37881687"", ""1376028764"", ""302375195""]",11,29,40
160348847,13,102.6923076923077,-0.39583280911812413,2061109.0,2,0.0,"[""charliehebdo-all-rnr-threads"", ""sydneysiege-all-rnr-threads""]","[""373783051"", ""2502895924""]",0,13,13
37963405,3,108.0,0.08607260386149089,6732902.0,3,0.3333333333333333,"[""charliehebdo-all-rnr-threads"", ""ottawashooting-all-rnr-threads""]","[""531902156"", ""28186908"", ""16343974""]",1,2,3
15108702,11,121.0,-0.22322815656661987,13214650.0,77,0.2727272727272727,"[""charliehebdo-all-rnr-threads"", ""germanwings-crash-all-rnr-threads"", ""ottawashooting-all-rnr-threads"", ""sydneysiege-all-rnr-threads""]","[""2723735572"", ""520426603"", ""23189508"", ""2464329458"", ""1427311280"", ""572575684"", ""1217590153"", ""2919525786"", ""30280962"", ""2725109187"", ""1246640292"", ""457820209"", ""53401994"", ""48088248"", ""356088525"", ""103972238"", ""705821096"", ""365948819"", ""221646790"", ""49303023"", ""614801913"", ""2495613440"", ""503613785"", ""62591883"", ""2785275474"", ""268145836"", ""3026120833"", ""1304390671"", ""354917016"", ""2192014255"", ""473472787"", ""85013897"", ""2750908439"", ""2240141214"", ""220981466"", ""2607703608"", ""58341062"", ""1062791150"", ""894116364"", ""62155958"", ""2604089039"", ""1030435626"", ""91151488"", ""38392608"", ""32255020"", ""50508373"", ""149286219"", ""701094366"", ""2918317414"", ""33523573"", ""2258289120"", ""142714169"", ""317181555"", ""399867737"", ""633825264"", ""2325214996"", ""33332251"", ""454847135"", ""2453850531"", ""3072847472"", ""2799463069"", ""2370908751"", ""340815286"", ""66640423"", ""2780963558"", ""349153383"", ""2806879372"", ""2612126299"", ""2958255480"", ""225503094"", ""22518101"", ""2951968857"", ""1292937884"", ""2582465372"", ""1172352422"", ""2839838866"", ""462732009""]",3,8,11
2725109187,5,90.4,-0.41474194526672364,6541668.0,3,0.6,"[""charliehebdo-all-rnr-threads"", ""ottawashooting-all-rnr-threads"", ""sydneysiege-all-rnr-threads""]","[""423662810"", ""15108702"", ""1630896181""]",3,2,5
31452669,2,109.0,-0.5327050089836121,12191752.0,2,0.0,"[""charliehebdo-all-rnr-threads"", ""ferguson-all-rnr-threads""]","[""19259102"", ""11203972""]",0,2,2
91812492,2,69.5,-0.4650230407714844,1987291.0,2,0.5,"[""charliehebdo-all-rnr-threads"", ""sydneysiege-all-rnr-threads""]","[""14173315"", ""11203972""]",1,1,2
880100622,2,140.5,-0.6535312533378601,2019476.0,2,0.0,"[""charliehebdo-all-rnr-threads"", ""sydneysiege-all-rnr-threads""]","[""952112047"", ""11203972""]",0,2,2
496199344,2,126.5,-0.4799984395503998,1988828.0,2,0.0,"[""charliehebdo-all-rnr-threads"", ""sydneysiege-all-rnr-threads""]","[""45715838"", ""14888597""]",0,2,2
2833164631,2,38.5,-0.15412560105323792,6644096.0,2,0.5,"[""charliehebdo-all-rnr-threads"", ""ottawashooting-all-rnr-threads""]","[""28096105"", ""315878798""]",1,1,2
17983365,5,128.4,-0.5202648401260376,6801634.0,41,0.2,"[""charliehebdo-all-rnr-threads"", ""ottawashooting-all-rnr-threads"", ""sydneysiege-all-rnr-threads""]","[""2824598336"", ""884156634"", ""60022825"", ""2664984804"", ""2583335345"", ""367267152"", ""2649303001"", ""168086103"", ""54372224"", ""2800409779"", ""114962484"", ""2611782600"", ""742143"", ""49190063"", ""1573472503"", ""1144257864"", ""2413247540"", ""2270616696"", ""2790589639"", ""24218861"", ""2179196810"", ""41840886"", ""2848353061"", ""2608622678"", ""24197612"", ""16504112"", ""96686135"", ""436124417"", ""37129155"", ""145726332"", ""401866052"", ""624037558"", ""524901955"", ""2614240147"", ""2555543388"", ""2497038156"", ""2675225370"", ""2905593484"", ""197170486"", ""369318439"", ""20744375""]",1,4,5
135438736,2,28.5,-0.018336892127990723,12526209.0,2,0.0,"[""charliehebdo-all-rnr-threads"", ""ferguson-all-rnr-threads""]","[""334715818"", ""195271137""]",0,2,2
76858507,7,118.71428571428571,-0.36633918966565815,2169912.0,76,0.0,"[""charliehebdo-all-rnr-threads"", ""sydneysiege-all-rnr-threads""]","[""2555980834"", ""214317500"", ""51269352"", ""989794616"", ""2558862918"", ""2782691053"", ""24304902"", ""2225723400"", ""1975195116"", ""1138764877"", ""1299906942"", ""69539409"", ""563827127"", ""2392744614"", ""75359240"", ""192511296"", ""2418740916"", ""1197818923"", ""68729028"", ""2920644253"", ""100910161"", ""93804616"", ""470127403"", ""158967738"", ""67217016"", ""2594385554"", ""1588729993"", ""745248356"", ""30122242"", ""2217728304"", ""147258286"", ""2972990029"", ""1420401030"", ""4781811"", ""558235346"", ""833363024"", ""1684585526"", ""823640412"", ""247240645"", ""2842747385"", ""2838781405"", ""252686292"", ""205024182"", ""30813838"", ""74906650"", ""96994945"", ""2439561698"", ""2315060196"", ""1595824910"", ""245033102"", ""74938726"", ""75521696"", ""1416490644"", ""289322631"", ""86088509"", ""95896119"", ""734713182"", ""150198912"", ""1097218164"", ""1465463371"", ""76858507"", ""130593165"", ""102052677"", ""253791853"", ""2259880764"", ""359136927"", ""2359028480"", ""22749349"", ""2422702611"", ""359422031"", ""2460732066"", ""796740463"", ""606152631"", ""59073766"", ""1857982483"", ""271930623""]",0,7,7
2359028480,4,117.25,-0.7586917728185654,2105589.0,3,0.0,"[""charliehebdo-all-rnr-threads"", ""sydneysiege-all-rnr-threads""]","[""21360768"", ""20197308"", ""76858507""]",0,4,4
15644999,8,120.125,-0.19377952814102173,13094254.0,46,0.0,"[""charliehebdo-all-rnr-threads"", ""ferguson-all-rnr-threads""]","[""15177772"", ""431771635"", ""361513681"", ""20113220"", ""243831804"", ""30514231"", ""315690250"", ""26192631"", ""19517219"", ""1671640609"", ""286520858"", ""35809554"", ""6818842"", ""1686066882"", ""32833248"", ""15992943"", ""15499478"", ""37514839"", ""241784604"", ""2194966952"", ""195766432"", ""53257286"", ""46365222"", ""15644999"", ""59574823"", ""601342849"", ""225572203"", ""11050942"", ""1016544696"", ""15707229"", ""541261672"", ""517883300"", ""15649636"", ""21910479"", ""401593074"", ""14317747"", ""19689899"", ""232372741"", ""18299758"", ""304786963"", ""164928882"", ""16237734"", ""1623561223"", ""10186662"", ""117588125"", ""14270439""]",0,8,8
583115866,2,91.5,-0.22195255756378174,6695836.0,2,0.0,"[""charliehebdo-all-rnr-threads"", ""ottawashooting-all-rnr-threads""]","[""88574375"", ""26192631""]",0,2,2
798623144,3,109.33333333333333,-0.2751110593477885,5585846.0,3,0.6666666666666666,"[""charliehebdo-all-rnr-threads"", ""sydneysiege-all-rnr-threads"", ""prince-toronto-all-rnr-threads""]","[""21889069"", ""9609632"", ""26192631""]",2,1,3
425369804,3,66.33333333333333,-0.21787997086842856,2079961.0,3,0.0,"[""charliehebdo-all-rnr-threads"", ""sydneysiege-all-rnr-threads""]","[""171802941"", ""20197308"", ""26192631""]",0,3,3
136271388,2,57.5,-0.5002351403236389,2007724.0,2,0.0,"[""charliehebdo-all-rnr-threads"", ""sydneysiege-all-rnr-threads""]","[""103245739"", ""117341432""]",0,2,2
92734920,4,103.5,-0.3389691412448883,2042862.0,2,0.0,"[""charliehebdo-all-rnr-threads"", ""sydneysiege-all-rnr-threads""]","[""22021978"", ""117341432""]",0,4,4
19903328,3,88.66666666666667,-0.6057794690132141,2007250.0,3,0.0,"[""charliehebdo-all-rnr-threads"", ""sydneysiege-all-rnr-threads""]","[""268676434"", ""25777812"", ""117341432""]",0,3,3
244661569,2,62.0,-0.3046313226222992,6643138.0,2,0.0,"[""charliehebdo-all-rnr-threads"", ""ottawashooting-all-rnr-threads""]","[""742143"", ""117341432""]",0,2,2
460637495,2,109.0,0.012886106967926025,6679285.0,2,0.0,"[""charliehebdo-all-rnr-threads"", ""ottawashooting-all-rnr-threads""]","[""433584049"", ""214924806""]",0,2,2
2206466353,5,93.8,-0.1804579257965088,2110420.0,3,0.4,"[""charliehebdo-all-rnr-threads"", ""sydneysiege-all-rnr-threads""]","[""3108351"", ""597251143"", ""9609632""]",2,3,5
1482457993,4,117.0,-0.49546846747398376,2020177.0,2,0.0,"[""charliehebdo-all-rnr-threads"", ""sydneysiege-all-rnr-threads""]","[""3108351"", ""1367531""]",0,4,4
2837612147,2,121.5,-0.15180587768554688,2039218.0,2,0.0,"[""charliehebdo-all-rnr-threads"", ""sydneysiege-all-rnr-threads""]","[""3108351"", ""5402612""]",0,2,2
25300494,8,67.875,-0.4224271699786186,2077740.0,4,0.125,"[""charliehebdo-all-rnr-threads"", ""sydneysiege-all-rnr-threads""]","[""129880735"", ""16834659"", ""16827148"", ""7779462""]",1,7,8
534308567,2,54.5,0.6806378364562988,12566365.0,2,0.5,"[""charliehebdo-all-rnr-threads"", ""ferguson-all-rnr-threads""]","[""28785486"", ""7779462""]",1,1,2
307869614,3,58.666666666666664,-0.060494701067606606,6798988.0,2,0.6666666666666666,"[""charliehebdo-all-rnr-threads"", ""germanwings-crash-all-rnr-threads""]","[""36116351"", ""419520517""]",2,1,3
408374972,10,127.0,-0.17170041799545288,2066552.0,2,0.0,"[""charliehebdo-all-rnr-threads"", ""sydneysiege-all-rnr-threads""]","[""419520517"", ""105485791""]",0,10,10
25110374,7,112.57142857142857,0.06920745543071202,13032264.0,62,0.0,"[""charliehebdo-all-rnr-threads"", ""ferguson-all-rnr-threads""]","[""2590908834"", ""1367955294"", ""217118762"", ""21238713"", ""192372321"", ""2559432516"", ""20444085"", ""122312240"", ""247450172"", ""252578331"", ""1884616328"", ""483367085"", ""519458575"", ""2403505671"", ""1563995216"", ""364950271"", ""190280139"", ""1179687427"", ""275331952"", ""1268587026"", ""23869900"", ""1950332042"", ""148908323"", ""1643704652"", ""93552105"", ""329329813"", ""178183646"", ""295904351"", ""25110374"", ""354356571"", ""542515221"", ""293559701"", ""68036352"", ""26465563"", ""1007147275"", ""59982337"", ""244596934"", ""179750692"", ""169179738"", ""493460897"", ""383227883"", ""1391363136"", ""178809676"", ""1546035500"", ""2431432212"", ""293392838"", ""2450904662"", ""2740112260"", ""511667586"", ""1534889346"", ""47612355"", ""327113920"", ""103863964"", ""112897323"", ""2439572508"", ""185951111"", ""1658660155"", ""2705348713"", ""1687941666"", ""2256970771"", ""23636341"", ""618568773""]",0,7,7
190280139,18,105.55555555555556,-0.8089904520246718,6745747.0,17,0.0,"[""charliehebdo-all-rnr-threads"", ""ottawashooting-all-rnr-threads""]","[""5695632"", ""14123751"", ""329121956"", ""852269288"", ""403338386"", ""16076032"", ""25110374"", ""382051315"", ""109042732"", ""3108351"", ""15754281"", ""31135856"", ""30138572"", ""28443608"", ""9507342"", ""81683900"", ""8161232""]",0,18,18
1643704652,6,36.5,-0.5409526526927948,2080645.0,3,0.3333333333333333,"[""charliehebdo-all-rnr-threads"", ""sydneysiege-all-rnr-threads""]","[""171802941"", ""25110374"", ""258627226""]",2,4,6
148908323,17,91.6470588235294,-0.24844031474169562,12971518.0,3,0.0,"[""charliehebdo-all-rnr-threads"", ""ferguson-all-rnr-threads""]","[""16116288"", ""12004852"", ""25110374""]",0,17,17
264986436,2,96.0,-0.6406787931919098,12535081.0,2,0.0,"[""charliehebdo-all-rnr-threads"", ""ferguson-all-rnr-threads""]","[""487600344"", ""13393052""]",0,2,2
239662704,2,126.0,-0.6588917672634125,2065323.0,2,0.5,"[""charliehebdo-all-rnr-threads"", ""sydneysiege-all-rnr-threads""]","[""487600344"", ""5402612""]",1,1,2
706948371,3,77.66666666666667,0.04268489281336466,2073118.0,2,0.0,"[""charliehebdo-all-rnr-threads"", ""sydneysiege-all-rnr-threads""]","[""28785486"", ""19379616""]",0,3,3
2358039120,3,95.0,-0.3114993969599406,12550095.0,3,0.3333333333333333,"[""charliehebdo-all-rnr-threads"", ""ottawashooting-all-rnr-threads"", ""ferguson-all-rnr-threads""]","[""464829719"", ""6017542"", ""179732982""]",1,2,3
16031927,4,127.0,-0.4000869393348694,12552537.0,75,0.5,"[""charliehebdo-all-rnr-threads"", ""sydneysiege-all-rnr-threads"", ""ferguson-all-rnr-threads""]","[""15552727"", ""1217980556"", ""2723735572"", ""875809039"", ""497505530"", ""542704147"", ""702591266"", ""16973217"", ""1244829337"", ""2905413041"", ""1263002017"", ""17756112"", ""26495702"", ""154138113"", ""16276154"", ""2725366949"", ""1265688324"", ""168759825"", ""1470409188"", ""2167674121"", ""312260303"", ""297054637"", ""179785566"", ""94968596"", ""425445122"", ""21141056"", ""138713188"", ""45518891"", ""82904917"", ""22409843"", ""35560115"", ""14925552"", ""19040480"", ""2230262515"", ""30651089"", ""2385846966"", ""2678642341"", ""185533755"", ""1485483578"", ""57995307"", ""24427864"", ""31472786"", ""1631748276"", ""2692926618"", ""18509606"", ""2263797415"", ""1347197874"", ""2260694815"", ""315441788"", ""161860598"", ""40651462"", ""291240985"", ""24774593"", ""218956862"", ""75595771"", ""2315776495"", ""68956490"", ""4239551"", ""21009409"", ""82682487"", ""402355096"", ""18102864"", ""32426966"", ""14875587"", ""311198407"", ""14789146"", ""575857218"", ""1323218581"", ""2363561616"", ""1931711646"", ""326345757"", ""2455683147"", ""407279130"", ""136754171"", ""417339306""]",2,2,4
21009409,4,110.25,-0.463849201798439,12530005.0,4,0.5,"[""charliehebdo-all-rnr-threads"", ""sydneysiege-all-rnr-threads"", ""ferguson-all-rnr-threads""]","[""898533348"", ""1367531"", ""16031927"", ""428333""]",2,2,4
154138113,4,73.5,-0.1602584570646286,2155200.0,3,0.75,"[""charliehebdo-all-rnr-threads"", ""sydneysiege-all-rnr-threads""]","[""1367531"", ""16031927"", ""14401607""]",3,1,4
76938029,3,79.0,-0.2503083149592082,2064835.0,2,0.0,"[""charliehebdo-all-rnr-threads"", ""sydneysiege-all-rnr-threads""]","[""2467791"", ""711348452""]",0,3,3
599875685,3,67.33333333333333,-0.11916106939315796,6656660.0,3,0.3333333333333333,"[""charliehebdo-all-rnr-threads"", ""ottawashooting-all-rnr-threads"", ""sydneysiege-all-rnr-threads""]","[""2467791"", ""15250661"", ""428333""]",1,2,3
110445334,2,114.0,0.10369718074798584,6742874.0,25,0.0,"[""charliehebdo-all-rnr-threads"", ""germanwings-crash-all-rnr-threads""]","[""2935844504"", ""25483210"", ""401820335"", ""344428289"", ""24449727"", ""2887647047"", ""1027731337"", ""1101462716"", ""2295262069"", ""861509263"", ""18142983"", ""23723528"", ""24136030"", ""17276699"", ""2988198670"", ""2986452453"", ""2195116544"", ""46950425"", ""268553261"", ""79056597"", ""300986742"", ""2994516125"", ""2611911771"", ""330642150"", ""25417458""]",0,2,2
68577152,4,66.5,-0.5428048074245453,6675313.0,61,0.0,"[""charliehebdo-all-rnr-threads"", ""ottawashooting-all-rnr-threads"", ""sydneysiege-all-rnr-threads""]","[""63849134"", ""254739975"", ""383782233"", ""57493001"", ""311137532"", ""45139332"", ""363793378"", ""204470303"", ""261054423"", ""339752506"", ""2692663801"", ""19981405"", ""51101318"", ""174654350"", ""58850378"", ""24780887"", ""21654257"", ""2952804956"", ""2364295403"", ""21558697"", ""212381174"", ""2344141208"", ""41447812"", ""263480472"", ""166267121"", ""254232170"", ""185916282"", ""981657048"", ""40381745"", ""258204380"", ""383597794"", ""21557277"", ""14834309"", ""57675938"", ""13277622"", ""2786231786"", ""308032976"", ""331014209"", ""28945268"", ""57316473"", ""19689899"", ""68559865"", ""224011819"", ""1551535297"", ""13162152"", ""271943194"", ""833874578"", ""18076755"", ""336922393"", ""2551053583"", ""274689301"", ""7635992"", ""17559915"", ""306605080"", ""2567127512"", ""1256433048"", ""2229344412"", ""284224887"", ""115474068"", ""321175574"", ""311255564""]",0,4,4
19689899,2,70.5,-0.38199788331985474,13040820.0,2,0.0,"[""charliehebdo-all-rnr-threads"", ""ferguson-all-rnr-threads""]","[""68577152"", ""15644999""]",0,2,2
227837742,11,133.72727272727272,-0.041809580542824486,6752158.0,124,0.18181818181818182,"[""charliehebdo-all-rnr-threads"", ""germanwings-crash-all-rnr-threads""]","[""15405016"", ""2886838704"", ""2828920200"", ""21036397"", ""138619638"", ""89002569"", ""21972791"", ""1228899091"", ""114962484"", ""1448127140"", ""1941960030"", ""48052467"", ""380506359"", ""1645499760"", ""39588132"", ""2363381414"", ""908152572"", ""107281171"", ""332424361"", ""394072560"", ""242503872"", ""25541189"", ""23857263"", ""38045703"", ""995828730"", ""407496438"", ""2733756599"", ""26282557"", ""876695682"", ""54578210"", ""15945172"", ""95622230"", ""2885752132"", ""19987172"", ""389786973"", ""77856107"", ""272074464"", ""2869492046"", ""2571833844"", ""35338602"", ""2878850941"", ""23183433"", ""2354261358"", ""1070850344"", ""95493132"", ""529604764"", ""20688351"", ""2961440830"", ""1396855940"", ""616487153"", ""524872414"", ""94677072"", ""125192735"", ""22318315"", ""2963728182"", ""35000355"", ""190062790"", ""3051538191"", ""218272201"", ""533667289"", ""1251546241"", ""2217911104"", ""31533511"", ""1677248065"", ""526362043"", ""149083571"", ""766130665"", ""314658698"", ""18581346"", ""18359761"", ""2200304672"", ""23536054"", ""44825797"", ""53249230"", ""608762112"", ""535977623"", ""2689273202"", ""173546979"", ""2914922246"", ""2567764124"", ""32414658"", ""366596805"", ""26837420"", ""30405225"", ""2920317232"", ""360641558"", ""552929454"", ""1363526006"", ""1911199880"", ""177258925"", ""351860076"", ""112897323"", ""86289052"", ""22304110"", ""176029570"", ""348861608"", ""2788435301"", ""24492927"", ""3098353628"", ""40546311"", ""100902179"", ""2445792466"", ""2407861884"", ""1139668668"", ""1104593154"", ""168550666"", ""2436990216"", ""189901445"", ""24904668"", ""30034448"", ""123303878"", ""2431028329"", ""5981342"", ""408194759"", ""20414205"", ""105598812"", ""2313132087"", ""241244558"", ""37796609"", ""16615729"", ""18706963"", ""49329424"", ""224066941"", ""905748632""]",2,9,11
535977623,2,67.5,-0.508104145526886,12703045.0,2,0.0,"[""charliehebdo-all-rnr-threads"", ""ferguson-all-rnr-threads""]","[""14700316"", ""227837742""]",0,2,2
2354261358,2,89.5,0.43147534132003784,6664605.0,2,0.5,"[""charliehebdo-all-rnr-threads"", ""ottawashooting-all-rnr-threads""]","[""227837742"", ""17469289""]",1,1,2
242503872,4,76.5,-0.5155808329582214,12588295.0,3,0.0,"[""charliehebdo-all-rnr-threads"", ""ferguson-all-rnr-threads""]","[""19222164"", ""227837742"", ""428333""]",0,4,4
533667289,3,104.33333333333333,-0.7126273512840271,6673611.0,3,0.0,"[""charliehebdo-all-rnr-threads"", ""ottawashooting-all-rnr-threads""]","[""1652541"", ""759251"", ""227837742""]",0,3,3
2373121802,14,111.0,-0.3097055213791983,12566778.0,3,0.8571428571428571,"[""charliehebdo-all-rnr-threads"", ""ferguson-all-rnr-threads""]","[""16553638"", ""231094495"", ""149913262""]",12,2,14
21190891,3,63.0,-0.20166492462158203,2087679.0,2,0.0,"[""charliehebdo-all-rnr-threads"", ""sydneysiege-all-rnr-threads""]","[""499696436"", ""149913262""]",0,3,3
42650881,3,105.66666666666667,-0.17161746819814047,6522044.0,3,0.0,"[""charliehebdo-all-rnr-threads"", ""germanwings-crash-all-rnr-threads""]","[""501768982"", ""759251"", ""17152053""]",0,3,3
902814223,9,68.33333333333333,-0.09362300899293688,19577781.0,4,0.1111111111111111,"[""charliehebdo-all-rnr-threads"", ""germanwings-crash-all-rnr-threads"", ""sydneysiege-all-rnr-threads"", ""ferguson-all-rnr-threads""]","[""20772763"", ""17995040"", ""954124423"", ""17561562""]",1,8,9
636741360,3,122.0,-0.3175285259882609,1801931.0,2,0.3333333333333333,"[""charliehebdo-all-rnr-threads"", ""sydneysiege-all-rnr-threads""]","[""25198840"", ""46078438""]",1,2,3
184570425,2,77.0,-0.6984107196331024,2020531.0,2,0.0,"[""charliehebdo-all-rnr-threads"", ""sydneysiege-all-rnr-threads""]","[""25198840"", ""254873869""]",0,2,2
740614004,2,101.5,-0.6483608186244965,12548097.0,2,0.0,"[""charliehebdo-all-rnr-threads"", ""ferguson-all-rnr-threads""]","[""27966935"", ""733838438""]",0,2,2
1902400610,20,116.8,-0.3924206972122192,12739632.0,2,0.0,"[""charliehebdo-all-rnr-threads"", ""ferguson-all-rnr-threads""]","[""5988062"", ""733838438""]",0,20,20
102837987,3,115.33333333333333,-0.5434491038322449,2031471.0,3,0.0,"[""charliehebdo-all-rnr-threads"", ""sydneysiege-all-rnr-threads""]","[""16807528"", ""153029181"", ""374712154""]",0,3,3
588726199,10,74.9,-0.0197640061378479,2124471.0,3,0.1,"[""charliehebdo-all-rnr-threads"", ""sydneysiege-all-rnr-threads""]","[""20043786"", ""16834659"", ""374712154""]",1,9,10
136039190,28,112.96428571428571,-0.4498931403670992,12545750.0,2,0.9642857142857143,"[""charliehebdo-all-rnr-threads"", ""ferguson-all-rnr-threads""]","[""38736974"", ""374712154""]",27,1,28
940368062,4,88.25,-0.2487908899784088,6741547.0,15,0.75,"[""charliehebdo-all-rnr-threads"", ""germanwings-crash-all-rnr-threads""]","[""628120930"", ""33327895"", ""590180745"", ""3030413492"", ""377129602"", ""1619742066"", ""1729770470"", ""2954264297"", ""3078547293"", ""1420720760"", ""180212590"", ""2251286285"", ""940368062"", ""392886711"", ""75391501""]",3,1,4
1729770470,10,102.5,-0.3037422657012939,6667685.0,4,0.8,"[""charliehebdo-all-rnr-threads"", ""ottawashooting-all-rnr-threads"", ""sydneysiege-all-rnr-threads""]","[""940368062"", ""12848262"", ""35466620"", ""491960101""]",8,2,10
628120930,2,51.5,-0.07712900638580322,6684268.0,2,0.5,"[""charliehebdo-all-rnr-threads"", ""ottawashooting-all-rnr-threads""]","[""940368062"", ""171606833""]",1,1,2
590180745,2,136.0,-0.6416370272636414,6747586.0,2,0.5,"[""charliehebdo-all-rnr-threads"", ""germanwings-crash-all-rnr-threads""]","[""940368062"", ""19211550""]",1,1,2
537670884,7,117.28571428571429,-0.4103478959628514,12561498.0,6,0.14285714285714285,"[""charliehebdo-all-rnr-threads"", ""ferguson-all-rnr-threads""]","[""14717197"", ""2884771"", ""15438913"", ""7768402"", ""2836421"", ""1947301""]",1,6,7
33332251,6,117.5,-0.4964790940284729,2048686.0,5,0.6666666666666666,"[""charliehebdo-all-rnr-threads"", ""sydneysiege-all-rnr-threads""]","[""246130881"", ""2097571"", ""15108702"", ""15438913"", ""16834659""]",4,2,6
1355670361,2,61.5,-0.45964285731315613,2018074.0,2,0.0,"[""charliehebdo-all-rnr-threads"", ""sydneysiege-all-rnr-threads""]","[""15438913"", ""1367531""]",0,2,2
1567581847,2,101.0,-0.7701937556266785,2050224.0,2,0.0,"[""charliehebdo-all-rnr-threads"", ""sydneysiege-all-rnr-threads""]","[""487600344"", ""373783051""]",0,2,2
206979151,2,121.0,0.32700061798095703,2039273.0,28,0.0,"[""charliehebdo-all-rnr-threads"", ""sydneysiege-all-rnr-threads""]","[""407931439"", ""1549414586"", ""2189523500"", ""1600261771"", ""1717404162"", ""265936127"", ""1634512056"", ""2879188310"", ""947011567"", ""296223335"", ""150974182"", ""170059138"", ""378420614"", ""2556511814"", ""1343325901"", ""57271359"", ""400958120"", ""2494210622"", ""1373648552"", ""301219529"", ""1227227953"", ""2938867807"", ""389368027"", ""870685718"", ""2284965018"", ""1303219214"", ""71172514"", ""506946706""]",0,2,2
506946706,2,81.0,-0.07924467325210571,2064095.0,2,0.0,"[""charliehebdo-all-rnr-threads"", ""sydneysiege-all-rnr-threads""]","[""206979151"", ""20197308""]",0,2,2
1717404162,2,130.5,-0.12615394592285156,2039800.0,2,0.0,"[""charliehebdo-all-rnr-threads"", ""sydneysiege-all-rnr-threads""]","[""8197942"", ""206979151""]",0,2,2
1634512056,11,65.18181818181819,-0.17536152492869983,8593911.0,9,0.7272727272727273,"[""charliehebdo-all-rnr-threads"", ""germanwings-crash-all-rnr-threads"", ""sydneysiege-all-rnr-threads""]","[""19317766"", ""20639175"", ""2738397743"", ""3108351"", ""380648579"", ""206979151"", ""2799960092"", ""16675569"", ""5402612""]",8,3,11
2189523500,2,87.5,0.2489507794380188,1971250.0,2,0.0,"[""charliehebdo-all-rnr-threads"", ""sydneysiege-all-rnr-threads""]","[""206979151"", ""16973333""]",0,2,2
2304047108,4,83.0,0.23756694793701172,1994362.0,3,0.75,"[""charliehebdo-all-rnr-threads"", ""sydneysiege-all-rnr-threads""]","[""8197942"", ""129964269"", ""35773039""]",3,1,4
2411443866,2,134.5,-0.18213999271392822,2028282.0,2,0.5,"[""charliehebdo-all-rnr-threads"", ""sydneysiege-all-rnr-threads""]","[""342894187"", ""35773039""]",1,1,2
297054637,2,112.5,-0.2588586211204529,12728032.0,2,0.5,"[""charliehebdo-all-rnr-threads"", ""ferguson-all-rnr-threads""]","[""26642006"", ""16031927""]",1,1,2
57995307,3,123.66666666666667,-0.4445783297220866,6932104.0,2,0.6666666666666666,"[""charliehebdo-all-rnr-threads"", ""ottawashooting-all-rnr-threads""]","[""16031927"", ""176930329""]",2,1,3
45518891,9,88.88888888888889,-0.30388427442974514,13174983.0,5,0.1111111111111111,"[""charliehebdo-all-rnr-threads"", ""ferguson-all-rnr-threads""]","[""17995040"", ""16936858"", ""14849562"", ""972651"", ""16031927""]",1,8,9
129673790,6,114.0,-0.3785427709420522,2075580.0,75,0.6666666666666666,"[""charliehebdo-all-rnr-threads"", ""sydneysiege-all-rnr-threads""]","[""2742121651"", ""229831376"", ""114326949"", ""2921050765"", ""2384105730"", ""92748055"", ""416088880"", ""2909901595"", ""60353514"", ""200121182"", ""23712477"", ""1535422453"", ""832990914"", ""297847624"", ""1536797588"", ""519458242"", ""10861282"", ""71194194"", ""325747234"", ""190107791"", ""20228338"", ""287488677"", ""449771364"", ""1395897493"", ""475201473"", ""22113948"", ""1855698619"", ""782153148"", ""19896820"", ""423247662"", ""2827613550"", ""865771614"", ""2537547075"", ""223782828"", ""24125118"", ""433308581"", ""839824826"", ""187783599"", ""2245368547"", ""1135612998"", ""2526192348"", ""755082008"", ""49548515"", ""2650054351"", ""14162258"", ""107714426"", ""701089236"", ""1560365636"", ""2289936355"", ""93176553"", ""520063574"", ""125323374"", ""16328035"", ""550679423"", ""498305247"", ""74412880"", ""76345085"", ""15817213"", ""212243193"", ""16278101"", ""115600043"", ""20986375"", ""27406839"", ""528515668"", ""2881006020"", ""214770574"", ""18012632"", ""416567800"", ""1456624183"", ""174187855"", ""84913334"", ""6782812"", ""243983947"", ""295070137"", ""2596804566""]",4,2,6
485054188,2,107.5,0.01322084665298462,2084464.0,2,0.5,"[""charliehebdo-all-rnr-threads"", ""sydneysiege-all-rnr-threads""]","[""23055689"", ""15235811""]",1,1,2
225227311,6,87.0,-0.28824204206466675,8585519.0,11,0.8333333333333334,"[""charliehebdo-all-rnr-threads"", ""germanwings-crash-all-rnr-threads"", ""sydneysiege-all-rnr-threads""]","[""2365362649"", ""992508296"", ""2478594524"", ""19932111"", ""56030702"", ""2928749685"", ""156464691"", ""931605320"", ""225227311"", ""70360760"", ""2894134571""]",5,1,6
56030702,2,137.0,0.007414877414703369,6678348.0,2,0.5,"[""charliehebdo-all-rnr-threads"", ""ottawashooting-all-rnr-threads""]","[""759251"", ""225227311""]",1,1,2
15956067,5,100.4,-0.35339834690093996,12553511.0,40,0.0,"[""charliehebdo-all-rnr-threads"", ""ferguson-all-rnr-threads""]","[""177350341"", ""15956067"", ""42366348"", ""301989551"", ""80579864"", ""236940018"", ""394347448"", ""643893"", ""27088456"", ""188538207"", ""55920135"", ""2726659574"", ""430925630"", ""280810416"", ""1631877504"", ""96800761"", ""164028903"", ""502110969"", ""203351858"", ""2267066588"", ""299810381"", ""601342849"", ""357198939"", ""135597607"", ""617720452"", ""305356699"", ""14782782"", ""1368258517"", ""41290144"", ""2834560938"", ""47690563"", ""464329417"", ""546910223"", ""2382836719"", ""468010454"", ""519974177"", ""871610738"", ""1455045084"", ""500105770"", ""82412657""]",0,5,5
203351858,3,20.0,0.14600173632303873,6693928.0,3,0.3333333333333333,"[""charliehebdo-all-rnr-threads"", ""ottawashooting-all-rnr-threads""]","[""954124423"", ""17001435"", ""15956067""]",1,2,3
1312728277,7,76.71428571428571,-0.13639213357652938,6698008.0,3,0.2857142857142857,"[""charliehebdo-all-rnr-threads"", ""ottawashooting-all-rnr-threads"", ""sydneysiege-all-rnr-threads""]","[""129880735"", ""49591803"", ""24000965""]",2,5,7
612473,2,126.5,-0.079265296459198,2088369.0,21,0.0,"[""charliehebdo-all-rnr-threads"", ""sydneysiege-all-rnr-threads""]","[""2961649574"", ""2404144517"", ""2896291439"", ""2525443105"", ""373157748"", ""1518883244"", ""948517734"", ""350239845"", ""1265505127"", ""525853179"", ""919389188"", ""469699513"", ""607311691"", ""422490523"", ""205843793"", ""2833078354"", ""965374314"", ""45107683"", ""2967388498"", ""33792054"", ""2942702023""]",0,2,2
948517734,9,90.11111111111111,-0.7022581564055549,2193829.0,7,0.3333333333333333,"[""charliehebdo-all-rnr-threads"", ""sydneysiege-all-rnr-threads""]","[""143415291"", ""106118793"", ""7587032"", ""612473"", ""87416722"", ""358204197"", ""5402612""]",3,6,9
373157748,2,46.0,-0.4409283399581909,2084357.0,2,0.5,"[""charliehebdo-all-rnr-threads"", ""sydneysiege-all-rnr-threads""]","[""87818409"", ""612473""]",1,1,2
53789862,6,92.5,-0.31728853782018024,2085439.0,43,0.0,"[""charliehebdo-all-rnr-threads"", ""sydneysiege-all-rnr-threads""]","[""21732921"", ""41347278"", ""109525069"", ""21048366"", ""2480104225"", ""256186890"", ""2212926198"", ""108905115"", ""1343704328"", ""17482107"", ""1072848662"", ""22253327"", ""2891192068"", ""2326491679"", ""2786149478"", ""2306612902"", ""21177936"", ""395895021"", ""17897038"", ""30865662"", ""2791848577"", ""152145450"", ""145204961"", ""1849575894"", ""37898439"", ""383802907"", ""13842992"", ""217202235"", ""15279269"", ""2809547070"", ""81293985"", ""120093004"", ""314587816"", ""53789862"", ""20228905"", ""2408067523"", ""19495609"", ""929005422"", ""1520983754"", ""264862915"", ""53854391"", ""2825427884"", ""36005116""]",0,6,6
395895021,5,80.0,-0.17552906274795532,2251824.0,4,0.0,"[""charliehebdo-all-rnr-threads"", ""sydneysiege-all-rnr-threads""]","[""2566535282"", ""53789862"", ""24187097"", ""14293310""]",0,5,5
19200048,2,47.0,0.6835297346115112,2080641.0,2,0.5,"[""charliehebdo-all-rnr-threads"", ""sydneysiege-all-rnr-threads""]","[""6107422"", ""143415291""]",1,1,2
22799750,3,119.66666666666667,-0.11944158871968587,6626561.0,25,0.6666666666666666,"[""charliehebdo-all-rnr-threads"", ""germanwings-crash-all-rnr-threads""]","[""2404144517"", ""23487221"", ""23329908"", ""266653330"", ""22799750"", ""1278832316"", ""264715277"", ""58941351"", ""772465922"", ""2808218208"", ""397235107"", ""1528718839"", ""181041683"", ""30126064"", ""2311110587"", ""17870557"", ""477224996"", ""327071621"", ""63160932"", ""36719252"", ""20773814"", ""2545851438"", ""382301115"", ""16607553"", ""28135590""]",2,1,3
2545851438,7,121.14285714285714,-0.507174585546766,2075371.0,5,0.42857142857142855,"[""charliehebdo-all-rnr-threads"", ""sydneysiege-all-rnr-threads""]","[""2097571"", ""2799960092"", ""447410369"", ""22799750"", ""16834659""]",3,4,7
249895896,7,123.57142857142857,-0.48847986119134085,19527469.0,3,0.0,"[""charliehebdo-all-rnr-threads"", ""germanwings-crash-all-rnr-threads"", ""ferguson-all-rnr-threads""]","[""501637514"", ""87818409"", ""244452760""]",0,7,7
33752742,3,88.66666666666667,-0.6483030716578165,2069616.0,3,0.0,"[""charliehebdo-all-rnr-threads"", ""sydneysiege-all-rnr-threads""]","[""82491225"", ""74382140"", ""3108351""]",0,3,3
228099346,5,88.6,-0.20840373039245605,12769100.0,4,0.0,"[""charliehebdo-all-rnr-threads"", ""ferguson-all-rnr-threads""]","[""82491225"", ""215598844"", ""100136358"", ""2163076560""]",0,5,5
17289449,3,97.0,-0.3901327848434448,6731481.0,3,0.3333333333333333,"[""charliehebdo-all-rnr-threads"", ""germanwings-crash-all-rnr-threads""]","[""15439395"", ""22657914"", ""30122242""]",1,2,3
2566734918,16,117.3125,-0.40827004238963127,2107641.0,3,0.0,"[""charliehebdo-all-rnr-threads"", ""sydneysiege-all-rnr-threads""]","[""15439395"", ""16705804"", ""44835347""]",0,16,16
41789292,3,97.66666666666667,0.06639103094736735,2075951.0,15,0.0,"[""charliehebdo-all-rnr-threads"", ""sydneysiege-all-rnr-threads""]","[""175786151"", ""576829705"", ""14295891"", ""403338386"", ""1362080358"", ""786589926"", ""2967365878"", ""47063444"", ""2492926991"", ""23977720"", ""1140877112"", ""1425756199"", ""2686106365"", ""700605022"", ""20097381""]",0,3,3
1509803635,6,53.333333333333336,-0.05247680346171061,6490680.0,6,0.16666666666666666,"[""charliehebdo-all-rnr-threads"", ""germanwings-crash-all-rnr-threads""]","[""368196789"", ""89457976"", ""17463660"", ""16887175"", ""163718817"", ""14353202""]",1,5,6
90826184,3,104.66666666666667,-0.4695260127385457,2074222.0,3,0.3333333333333333,"[""charliehebdo-all-rnr-threads"", ""sydneysiege-all-rnr-threads""]","[""15438913"", ""246860689"", ""5402612""]",1,2,3
136486687,3,139.66666666666666,-0.46057573954264325,2164678.0,3,0.0,"[""charliehebdo-all-rnr-threads"", ""sydneysiege-all-rnr-threads""]","[""2267059262"", ""1073676020"", ""374712154""]",0,3,3
1556259307,2,102.5,-0.10300534963607788,2074039.0,1,0.0,"[""charliehebdo-all-rnr-threads"", ""sydneysiege-all-rnr-threads""]","[""374712154""]",0,2,2
2891192068,3,121.66666666666667,-0.555341919263204,2064628.0,2,0.0,"[""charliehebdo-all-rnr-threads"", ""sydneysiege-all-rnr-threads""]","[""53789862"", ""742143""]",0,3,3
19495609,5,90.8,-0.13684332370758057,6731880.0,2,0.0,"[""charliehebdo-all-rnr-threads"", ""ottawashooting-all-rnr-threads""]","[""53789862"", ""16220555""]",0,5,5
21732921,5,110.6,-0.17861664295196533,13033860.0,3,0.0,"[""charliehebdo-all-rnr-threads"", ""ferguson-all-rnr-threads""]","[""53789862"", ""14267557"", ""124227622""]",0,5,5
2791848577,6,83.33333333333333,-0.054848273595174156,6757782.0,4,0.16666666666666666,"[""charliehebdo-all-rnr-threads"", ""ottawashooting-all-rnr-threads"", ""sydneysiege-all-rnr-threads""]","[""255753616"", ""53789862"", ""2768501"", ""64643056""]",1,5,6
15659240,4,100.0,0.08242732286453247,2160763.0,4,0.0,"[""charliehebdo-all-rnr-threads"", ""sydneysiege-all-rnr-threads""]","[""18965916"", ""6107422"", ""106118793"", ""33315010""]",0,4,4
2903328589,5,81.4,-0.1161536455154419,2158528.0,5,0.4,"[""charliehebdo-all-rnr-threads"", ""sydneysiege-all-rnr-threads""]","[""16973333"", ""3108351"", ""2799960092"", ""1367531"", ""428333""]",2,3,5
33630394,2,121.0,0.02420029044151306,7571752.0,2,0.5,"[""charliehebdo-all-rnr-threads"", ""ebola-essien-all-rnr-threads""]","[""15438913"", ""579635019""]",1,1,2
494501255,2,49.5,0.10362082719802856,6717807.0,2,0.5,"[""charliehebdo-all-rnr-threads"", ""ottawashooting-all-rnr-threads""]","[""15438913"", ""7587032""]",1,1,2
2222873396,3,93.0,-0.743960976600647,2070513.0,2,0.0,"[""charliehebdo-all-rnr-threads"", ""sydneysiege-all-rnr-threads""]","[""2768501"", ""356026306""]",0,3,3
983376769,3,108.0,-0.3135569890340169,2076393.0,2,0.0,"[""charliehebdo-all-rnr-threads"", ""sydneysiege-all-rnr-threads""]","[""1920286333"", ""356026306""]",0,3,3
403899803,2,60.0,-0.4714351296424866,5602320.0,5,0.5,"[""charliehebdo-all-rnr-threads"", ""putinmissing-all-rnr-threads""]","[""2875761863"", ""356026306"", ""2471093864"", ""2848666053"", ""380087607""]",1,1,2
43541586,2,64.0,-0.05173593759536743,2070180.0,2,0.0,"[""charliehebdo-all-rnr-threads"", ""sydneysiege-all-rnr-threads""]","[""266073503"", ""2768501""]",0,2,2
43041200,4,85.25,-0.15302498638629913,2097818.0,3,0.25,"[""charliehebdo-all-rnr-threads"", ""sydneysiege-all-rnr-threads""]","[""71491041"", ""24062457"", ""956604620""]",1,3,4
2525820541,2,78.5,-0.5108718574047089,2052259.0,2,0.0,"[""charliehebdo-all-rnr-threads"", ""sydneysiege-all-rnr-threads""]","[""71491041"", ""46078438""]",0,2,2
2398593854,6,120.5,0.12733298540115356,6716418.0,5,0.6666666666666666,"[""charliehebdo-all-rnr-threads"", ""ottawashooting-all-rnr-threads""]","[""8736882"", ""71491041"", ""50657158"", ""29518466"", ""16220555""]",4,2,6
418217963,4,139.0,-0.3059493750333786,2078799.0,2,0.0,"[""charliehebdo-all-rnr-threads"", ""sydneysiege-all-rnr-threads""]","[""16973333"", ""14224719""]",0,4,4
549181612,16,108.0625,-0.34082357212901115,2125304.0,4,0.125,"[""charliehebdo-all-rnr-threads"", ""sydneysiege-all-rnr-threads""]","[""5402612"", ""20043786"", ""88210310"", ""428333""]",2,14,16
1877472433,2,92.5,0.01717984676361084,6721928.0,2,0.0,"[""charliehebdo-all-rnr-threads"", ""ottawashooting-all-rnr-threads""]","[""88210310"", ""23937894""]",0,2,2
2414809730,5,104.4,-0.535840904712677,6632773.0,4,0.0,"[""charliehebdo-all-rnr-threads"", ""ottawashooting-all-rnr-threads"", ""sydneysiege-all-rnr-threads""]","[""96104822"", ""88210310"", ""33315010"", ""5402612""]",0,5,5
16355445,2,54.5,-0.4284454882144928,2049958.0,2,0.0,"[""charliehebdo-all-rnr-threads"", ""sydneysiege-all-rnr-threads""]","[""16343974"", ""1246678909""]",0,2,2
38385875,4,121.75,-0.7389016896486282,12735221.0,2,0.0,"[""charliehebdo-all-rnr-threads"", ""ferguson-all-rnr-threads""]","[""3108351"", ""14700316""]",0,4,4
15372043,2,61.0,0.2371079921722412,12738150.0,2,0.0,"[""charliehebdo-all-rnr-threads"", ""ferguson-all-rnr-threads""]","[""3108351"", ""14606079""]",0,2,2
150544924,4,75.25,-0.14497435092926025,2096415.0,3,0.0,"[""charliehebdo-all-rnr-threads"", ""sydneysiege-all-rnr-threads""]","[""2163076560"", ""175452918"", ""260661314""]",0,4,4
1463193979,2,80.0,-0.4119908809661865,2108069.0,2,0.5,"[""charliehebdo-all-rnr-threads"", ""sydneysiege-all-rnr-threads""]","[""15400294"", ""259323371""]",1,1,2
16960279,3,105.33333333333333,-0.24370046456654867,13027177.0,9,0.0,"[""charliehebdo-all-rnr-threads"", ""ferguson-all-rnr-threads""]","[""312355202"", ""350345547"", ""58371469"", ""24476658"", ""16960279"", ""21505436"", ""189974418"", ""2407320510"", ""39547006""]",0,3,3
30130399,6,118.5,-0.3004319866498311,12788593.0,3,0.0,"[""charliehebdo-all-rnr-threads"", ""ferguson-all-rnr-threads""]","[""33092289"", ""58371469"", ""13496142""]",0,6,6
116038947,5,97.0,-0.07780331373214722,12611870.0,2,0.2,"[""charliehebdo-all-rnr-threads"", ""ferguson-all-rnr-threads""]","[""58371469"", ""325076723""]",1,4,5
1530746612,5,133.0,-0.46035470962524416,8542909.0,4,0.4,"[""charliehebdo-all-rnr-threads"", ""germanwings-crash-all-rnr-threads"", ""sydneysiege-all-rnr-threads""]","[""7587032"", ""58371469"", ""22240612"", ""5402612""]",2,3,5
2770810871,14,98.14285714285714,-0.27763920170920237,2098627.0,2,0.0,"[""charliehebdo-all-rnr-threads"", ""sydneysiege-all-rnr-threads""]","[""19140457"", ""58371469""]",0,14,14
37595323,4,133.5,-0.6459231972694397,2107142.0,3,0.75,"[""charliehebdo-all-rnr-threads"", ""sydneysiege-all-rnr-threads""]","[""16675569"", ""292777349"", ""67305394""]",3,1,4
262040253,5,105.6,-0.3527753114700317,2104618.0,4,0.8,"[""charliehebdo-all-rnr-threads"", ""sydneysiege-all-rnr-threads""]","[""52327900"", ""23055689"", ""742143"", ""2271035214""]",4,1,5
349708100,5,109.6,-0.3140788793563843,6493863.0,2,0.0,"[""charliehebdo-all-rnr-threads"", ""germanwings-crash-all-rnr-threads""]","[""759251"", ""742143""]",0,5,5
20872583,2,134.0,-0.10206139087677002,2073929.0,2,0.0,"[""charliehebdo-all-rnr-threads"", ""sydneysiege-all-rnr-threads""]","[""5402612"", ""233533968""]",0,2,2
73416159,5,119.2,-0.3266249895095825,12713590.0,5,0.0,"[""charliehebdo-all-rnr-threads"", ""sydneysiege-all-rnr-threads"", ""ferguson-all-rnr-threads""]","[""16973333"", ""573788425"", ""28785486"", ""609244293"", ""1947301""]",0,5,5
2786921609,3,74.0,-0.11349717775980632,6700889.0,3,0.3333333333333333,"[""charliehebdo-all-rnr-threads"", ""ottawashooting-all-rnr-threads""]","[""2327508680"", ""16973333"", ""549587666""]",1,2,3
2864066428,6,117.0,-0.5153903961181641,2110962.0,3,0.16666666666666666,"[""charliehebdo-all-rnr-threads"", ""sydneysiege-all-rnr-threads""]","[""15400294"", ""16973333"", ""524545961""]",1,5,6
754701355,3,72.66666666666667,-0.6101818283398946,6718136.0,3,0.3333333333333333,"[""charliehebdo-all-rnr-threads"", ""ottawashooting-all-rnr-threads""]","[""15012486"", ""16973333"", ""103065157""]",1,2,3
1475561804,6,107.5,-0.22046737869580588,2093615.0,4,0.0,"[""charliehebdo-all-rnr-threads"", ""sydneysiege-all-rnr-threads""]","[""222556688"", ""87818409"", ""16973333"", ""374712154""]",0,6,6
254809254,6,90.16666666666667,-0.27459635337193805,13218128.0,5,0.0,"[""charliehebdo-all-rnr-threads"", ""sydneysiege-all-rnr-threads"", ""ferguson-all-rnr-threads""]","[""65860206"", ""1934989190"", ""87818409"", ""2345696184"", ""428333""]",0,6,6
734634998,2,139.0,-0.7114106118679047,2080981.0,2,0.0,"[""charliehebdo-all-rnr-threads"", ""sydneysiege-all-rnr-threads""]","[""3108351"", ""2799960092""]",0,2,2
322434618,3,28.666666666666668,-0.3319019277890523,2159892.0,3,0.0,"[""charliehebdo-all-rnr-threads"", ""sydneysiege-all-rnr-threads""]","[""2177710981"", ""2097571"", ""428333""]",0,3,3
27347119,2,55.5,-0.4835571050643921,2075007.0,2,0.5,"[""charliehebdo-all-rnr-threads"", ""sydneysiege-all-rnr-threads""]","[""15438913"", ""5402612""]",1,1,2
429801709,3,127.66666666666667,-0.591720700263977,2078980.0,3,0.0,"[""charliehebdo-all-rnr-threads"", ""sydneysiege-all-rnr-threads""]","[""35466620"", ""83795099"", ""20043786""]",0,3,3
92377901,5,72.0,-0.4775567054748535,7575757.0,8,0.6,"[""charliehebdo-all-rnr-threads"", ""ebola-essien-all-rnr-threads""]","[""92377901"", ""1020681224"", ""2707257263"", ""315113964"", ""1923714157"", ""143105781"", ""1262229906"", ""39985414""]",3,2,5
501061708,2,70.0,-0.3615603446960449,2067798.0,2,0.5,"[""charliehebdo-all-rnr-threads"", ""sydneysiege-all-rnr-threads""]","[""22129280"", ""76372965""]",1,1,2
56928675,3,115.66666666666667,-0.5722662210464478,2101442.0,2,0.0,"[""charliehebdo-all-rnr-threads"", ""sydneysiege-all-rnr-threads""]","[""100174414"", ""238575113""]",0,3,3
42194120,2,123.0,-0.4899635314941406,12815010.0,2,0.0,"[""charliehebdo-all-rnr-threads"", ""ferguson-all-rnr-threads""]","[""364423298"", ""17001490""]",0,2,2
2370421626,3,74.66666666666667,-0.39609930912653607,12607106.0,2,0.3333333333333333,"[""charliehebdo-all-rnr-threads"", ""ferguson-all-rnr-threads""]","[""3497941"", ""17001490""]",1,2,3
262151877,25,106.08,-0.3490704083442688,12877988.0,2,0.0,"[""charliehebdo-all-rnr-threads"", ""ferguson-all-rnr-threads""]","[""17001490"", ""14321959""]",0,25,25
902554447,4,76.0,-0.3890286833047867,2165620.0,4,0.0,"[""charliehebdo-all-rnr-threads"", ""sydneysiege-all-rnr-threads""]","[""271413771"", ""16705804"", ""118672200"", ""16973333""]",0,4,4
95091601,3,58.666666666666664,-0.20352625846862793,2075784.0,3,0.3333333333333333,"[""charliehebdo-all-rnr-threads"", ""sydneysiege-all-rnr-threads""]","[""19317766"", ""37881687"", ""524545961""]",1,2,3
984662900,15,138.80000000000004,-0.17953985929489136,2071704.0,1,0.0,"[""charliehebdo-all-rnr-threads"", ""sydneysiege-all-rnr-threads""]","[""87818409""]",0,15,15
1648253690,2,62.5,-0.17024827003479004,2142477.0,2,0.5,"[""charliehebdo-all-rnr-threads"", ""sydneysiege-all-rnr-threads""]","[""64643056"", ""503681629""]",1,1,2
181409722,2,70.0,-0.15751957893371582,5576618.0,2,0.5,"[""charliehebdo-all-rnr-threads"", ""putinmissing-all-rnr-threads""]","[""15438913"", ""2461887810""]",1,1,2
30460070,5,80.0,-0.2953679203987122,13425933.0,4,0.6,"[""charliehebdo-all-rnr-threads"", ""germanwings-crash-all-rnr-threads"", ""ottawashooting-all-rnr-threads"", ""sydneysiege-all-rnr-threads""]","[""37034483"", ""18725815"", ""75138076"", ""255187660""]",3,2,5
444748548,5,102.4,-0.12271609306335449,2165069.0,4,0.0,"[""charliehebdo-all-rnr-threads"", ""sydneysiege-all-rnr-threads""]","[""37034483"", ""1263706735"", ""14293310"", ""24506246""]",0,5,5
417997943,18,115.22222222222223,-0.4114030599594116,12741275.0,2,0.0,"[""charliehebdo-all-rnr-threads"", ""ferguson-all-rnr-threads""]","[""11265832"", ""20678866""]",0,18,18
326432600,3,74.66666666666667,-0.019071539243062336,6694212.0,2,0.6666666666666666,"[""charliehebdo-all-rnr-threads"", ""ottawashooting-all-rnr-threads""]","[""20678866"", ""5402612""]",2,1,3
1336161774,4,74.0,-0.4587155282497406,6655186.0,3,0.5,"[""charliehebdo-all-rnr-threads"", ""ottawashooting-all-rnr-threads"", ""sydneysiege-all-rnr-threads""]","[""64643056"", ""264268489"", ""807095""]",2,2,4
202324598,6,121.66666666666667,-0.45160819093386334,2078424.0,5,0.16666666666666666,"[""charliehebdo-all-rnr-threads"", ""sydneysiege-all-rnr-threads""]","[""18965916"", ""15438913"", ""20043786"", ""255753616"", ""15250661""]",1,5,6
290326947,3,29.333333333333332,0.04767334461212158,2059374.0,3,0.3333333333333333,"[""charliehebdo-all-rnr-threads"", ""sydneysiege-all-rnr-threads""]","[""14173315"", ""15438913"", ""5988062""]",1,2,3
2163076560,17,117.05882352941177,-0.27339880606707406,19525834.0,132,0.17647058823529413,"[""charliehebdo-all-rnr-threads"", ""germanwings-crash-all-rnr-threads"", ""sydneysiege-all-rnr-threads"", ""ferguson-all-rnr-threads""]","[""2171636099"", ""2784352752"", ""150544924"", ""30913941"", ""325296537"", ""363509031"", ""306018798"", ""2422857948"", ""2757045157"", ""396704107"", ""760134366"", ""34337710"", ""1242443736"", ""32798162"", ""2858720515"", ""1359226843"", ""1709543934"", ""766784684"", ""20727191"", ""1077275318"", ""64996223"", ""1482492223"", ""287084075"", ""2265918939"", ""49243929"", ""415798824"", ""528842112"", ""154483283"", ""169747186"", ""202053759"", ""2661703618"", ""2290505384"", ""261608494"", ""24425417"", ""513018928"", ""2894348446"", ""351556000"", ""1732681554"", ""2806710940"", ""2592419502"", ""17961142"", ""2210396117"", ""805901052"", ""68189622"", ""282977213"", ""2163076560"", ""877308955"", ""2736882208"", ""1559902052"", ""2245958018"", ""23682439"", ""772473500"", ""138492691"", ""2945359946"", ""207577234"", ""228099346"", ""1388148914"", ""2886586060"", ""178777000"", ""1054190610"", ""12417532"", ""2576432274"", ""106580732"", ""60086728"", ""765232009"", ""2735655330"", ""249546943"", ""477714810"", ""2274145332"", ""2361194822"", ""2904686994"", ""307554743"", ""419110471"", ""446724059"", ""2792309533"", ""2347926811"", ""1130662394"", ""789398972"", ""226299669"", ""16314503"", ""290224266"", ""1455532388"", ""36708395"", ""202380388"", ""350042055"", ""44482963"", ""265844129"", ""37259670"", ""524148197"", ""37919483"", ""238575113"", ""414374264"", ""395607953"", ""96500143"", ""425899650"", ""1073926848"", ""18367743"", ""14599545"", ""2362243668"", ""131582916"", ""69259701"", ""62463994"", ""290070138"", ""3022514362"", ""492356671"", ""2262320876"", ""439224456"", ""2397107492"", ""25508307"", ""82312427"", ""21161061"", ""769208504"", ""20496966"", ""47694347"", ""12531062"", ""175401326"", ""61507773"", ""2423754139"", ""975426242"", ""1485225582"", ""431200935"", ""2251196504"", ""338939943"", ""510455186"", ""860648802"", ""307417913"", ""1278904081"", ""63963528"", ""2239722660"", ""380648579"", ""20295264"", ""369437673""]",3,14,17
1482492223,20,88.25,-0.3155150979757309,13117436.0,3,0.05,"[""charliehebdo-all-rnr-threads"", ""ferguson-all-rnr-threads""]","[""325265073"", ""14090948"", ""2163076560""]",1,19,20
352560642,3,107.66666666666667,-0.495905081431071,6718045.0,3,0.3333333333333333,"[""charliehebdo-all-rnr-threads"", ""ottawashooting-all-rnr-threads""]","[""48743186"", ""111044562"", ""87416722""]",1,2,3
37292428,3,123.0,-0.11755216121673584,2097734.0,2,0.3333333333333333,"[""charliehebdo-all-rnr-threads"", ""sydneysiege-all-rnr-threads""]","[""514019413"", ""21548431""]",1,2,3
61958954,2,138.0,0.21315276622772217,2097401.0,2,0.0,"[""charliehebdo-all-rnr-threads"", ""sydneysiege-all-rnr-threads""]","[""60022825"", ""514019413""]",0,2,2
2234329771,3,44.666666666666664,-0.41216766834259033,2106211.0,3,0.3333333333333333,"[""charliehebdo-all-rnr-threads"", ""sydneysiege-all-rnr-threads""]","[""868112707"", ""514019413"", ""2768501""]",1,2,3
108006063,3,92.0,-0.5547462701797485,6710485.0,2,0.3333333333333333,"[""charliehebdo-all-rnr-threads"", ""germanwings-crash-all-rnr-threads""]","[""99034397"", ""19929890""]",1,2,3
478157435,15,93.53333333333333,-0.20095415512720743,2063428.0,2,0.0,"[""charliehebdo-all-rnr-threads"", ""sydneysiege-all-rnr-threads""]","[""51241574"", ""556633808""]",0,15,15
339711830,15,111.8,-0.4066055456797282,2066242.0,2,0.0,"[""charliehebdo-all-rnr-threads"", ""sydneysiege-all-rnr-threads""]","[""153029181"", ""556633808""]",0,15,15
49273182,7,92.0,-0.20269996779305594,2092087.0,3,0.14285714285714285,"[""charliehebdo-all-rnr-threads"", ""sydneysiege-all-rnr-threads""]","[""2768501"", ""268662889"", ""556633808""]",1,6,7
215598844,3,88.33333333333333,-0.16088791688283285,12848577.0,18,0.0,"[""charliehebdo-all-rnr-threads"", ""ferguson-all-rnr-threads""]","[""2581890926"", ""2258406469"", ""1339324939"", ""15072511"", ""228099346"", ""80791048"", ""35490978"", ""76388579"", ""273372448"", ""1542985573"", ""2218932426"", ""239949721"", ""390876177"", ""167927318"", ""18745886"", ""215598844"", ""311096280"", ""127059178""]",0,3,3
80791048,2,136.0,-0.4932142496109009,2077348.0,2,0.5,"[""charliehebdo-all-rnr-threads"", ""sydneysiege-all-rnr-threads""]","[""215598844"", ""51241574""]",1,1,2
390876177,2,109.5,-0.17156237363815308,12691825.0,2,0.5,"[""charliehebdo-all-rnr-threads"", ""ferguson-all-rnr-threads""]","[""215598844"", ""15220768""]",1,1,2
38635888,3,87.0,-0.1385955015818278,6699581.0,3,0.3333333333333333,"[""charliehebdo-all-rnr-threads"", ""ottawashooting-all-rnr-threads"", ""sydneysiege-all-rnr-threads""]","[""6038642"", ""19899606"", ""91334232""]",1,2,3
18693863,2,139.0,0.09977185726165771,2068824.0,2,0.0,"[""charliehebdo-all-rnr-threads"", ""sydneysiege-all-rnr-threads""]","[""2378713202"", ""15170194""]",0,2,2
1375289149,8,129.75,-0.025687769055366516,19092359.0,71,0.0,"[""charliehebdo-all-rnr-threads"", ""germanwings-crash-all-rnr-threads"", ""sydneysiege-all-rnr-threads"", ""ferguson-all-rnr-threads""]","[""395175296"", ""254925078"", ""985740451"", ""2364077750"", ""2248861878"", ""2952761242"", ""2889166382"", ""199005788"", ""465568405"", ""59238535"", ""2874171436"", ""49163683"", ""31146305"", ""433181433"", ""449443784"", ""2902676331"", ""975971120"", ""24061179"", ""171363047"", ""2549223338"", ""76483712"", ""426607238"", ""2790189994"", ""2767915762"", ""497186760"", ""1895496402"", ""546475152"", ""28406464"", ""428610677"", ""17520429"", ""23153001"", ""2885348567"", ""1855509086"", ""36033359"", ""2903436020"", ""2662865065"", ""2738338083"", ""387901653"", ""1885859976"", ""1172509285"", ""272621101"", ""343739052"", ""223707653"", ""455387087"", ""2880324122"", ""2412016321"", ""24162106"", ""145464490"", ""43283178"", ""242169112"", ""2678433367"", ""477224996"", ""305294287"", ""194931841"", ""15959104"", ""2450891154"", ""78869025"", ""28700736"", ""1272237950"", ""2289991355"", ""28103908"", ""526170505"", ""16574787"", ""414743820"", ""1375289149"", ""2491793478"", ""34446512"", ""470321789"", ""2401355906"", ""2910413544"", ""2691332454""]",0,8,8
2417387923,2,97.5,0.037517428398132324,2069031.0,2,0.0,"[""charliehebdo-all-rnr-threads"", ""sydneysiege-all-rnr-threads""]","[""27457454"", ""602609422""]",0,2,2
38017472,2,140.0,0.0372316837310791,2089694.0,2,0.0,"[""charliehebdo-all-rnr-threads"", ""sydneysiege-all-rnr-threads""]","[""17537467"", ""15907183""]",0,2,2
1962596220,2,101.5,-0.08022850751876831,5608739.0,2,0.0,"[""charliehebdo-all-rnr-threads"", ""putinmissing-all-rnr-threads""]","[""17537467"", ""17045133""]",0,2,2
35466620,5,116.4,-0.36452627182006836,2108460.0,70,0.8,"[""charliehebdo-all-rnr-threads"", ""sydneysiege-all-rnr-threads""]","[""36319737"", ""1612767643"", ""2426855263"", ""2831545369"", ""239544012"", ""209458770"", ""370534934"", ""1721130294"", ""958439773"", ""205112845"", ""16569663"", ""503693741"", ""1223839332"", ""61711701"", ""19763467"", ""42730704"", ""21055261"", ""17689864"", ""2707909225"", ""890561862"", ""226748027"", ""39456623"", ""152891927"", ""525304762"", ""58381791"", ""238473084"", ""20198278"", ""1538677646"", ""211354561"", ""257475749"", ""618456189"", ""231573091"", ""193226140"", ""1072387866"", ""429801709"", ""2469825921"", ""2191035872"", ""187044483"", ""1934026933"", ""2732467426"", ""114391867"", ""289240165"", ""137200672"", ""560664451"", ""235216483"", ""248440784"", ""23548448"", ""2160544374"", ""20032587"", ""74488170"", ""2966437894"", ""51245437"", ""327421990"", ""35690142"", ""66019107"", ""1729770470"", ""2204316950"", ""914167062"", ""42791906"", ""112145069"", ""2886586060"", ""410044370"", ""1440556951"", ""253148061"", ""2601118704"", ""465936656"", ""508316850"", ""2929175617"", ""892197414"", ""52385657""]",4,1,5
2929175617,3,100.33333333333333,-0.22592284282048544,2104727.0,2,0.0,"[""charliehebdo-all-rnr-threads"", ""sydneysiege-all-rnr-threads""]","[""35466620"", ""17984709""]",0,3,3
42791906,15,112.4,-0.3683645526568095,2090118.0,4,0.06666666666666667,"[""charliehebdo-all-rnr-threads"", ""sydneysiege-all-rnr-threads""]","[""35466620"", ""21360768"", ""254873869"", ""4970411""]",1,14,15
2707909225,2,117.5,-0.11891120672225952,6703746.0,2,0.0,"[""charliehebdo-all-rnr-threads"", ""ottawashooting-all-rnr-threads""]","[""35466620"", ""51241574""]",0,2,2
525304762,4,130.25,0.006234526634216309,2079968.0,2,0.0,"[""charliehebdo-all-rnr-threads"", ""sydneysiege-all-rnr-threads""]","[""35466620"", ""7587032""]",0,4,4
893046055,2,104.5,0.20918607711791992,2119061.0,2,0.5,"[""charliehebdo-all-rnr-threads"", ""sydneysiege-all-rnr-threads""]","[""14460241"", ""742143""]",1,1,2
2402247031,3,62.333333333333336,0.10205809275309245,2113834.0,2,0.6666666666666666,"[""charliehebdo-all-rnr-threads"", ""sydneysiege-all-rnr-threads""]","[""292777349"", ""1571428436""]",2,1,3
2217283489,2,50.5,-0.07302957773208618,2070805.0,2,0.0,"[""charliehebdo-all-rnr-threads"", ""sydneysiege-all-rnr-threads""]","[""204832963"", ""14293310""]",0,2,2
2711678270,7,66.71428571428571,-0.2959337830543518,6739610.0,5,0.2857142857142857,"[""charliehebdo-all-rnr-threads"", ""ottawashooting-all-rnr-threads"", ""sydneysiege-all-rnr-threads""]","[""110906944"", ""20771519"", ""487600344"", ""51241574"", ""126486040""]",2,5,7
73431630,5,103.6,-0.1399829149246216,2113242.0,3,0.6,"[""charliehebdo-all-rnr-threads"", ""sydneysiege-all-rnr-threads""]","[""254873869"", ""61126132"", ""20771519""]",3,2,5
15234546,3,125.66666666666667,-0.3892291784286499,6655859.0,38,0.6666666666666666,"[""charliehebdo-all-rnr-threads"", ""germanwings-crash-all-rnr-threads""]","[""2283760263"", ""38392608"", ""267400226"", ""49948272"", ""165923992"", ""74985668"", ""20375412"", ""1018064982"", ""70742005"", ""19878391"", ""2916144730"", ""441432262"", ""392420104"", ""89659936"", ""33182341"", ""2572753525"", ""26158955"", ""2375154235"", ""798445"", ""47429047"", ""50979860"", ""1786228602"", ""15229665"", ""83599454"", ""2332974355"", ""2431286900"", ""17189922"", ""351055272"", ""2862417437"", ""46054503"", ""221370044"", ""104610131"", ""24413699"", ""128077903"", ""137242245"", ""2383389739"", ""46228494"", ""850974998""]",2,1,3
366748134,18,79.49999999999999,-0.3416030638747745,12615493.0,7,0.1111111111111111,"[""charliehebdo-all-rnr-threads"", ""ferguson-all-rnr-threads""]","[""200583835"", ""52701676"", ""373783051"", ""14560097"", ""1507338108"", ""33519870"", ""69181624""]",2,16,18
1465432874,6,86.5,-0.0960006316502889,6753042.0,2,0.0,"[""charliehebdo-all-rnr-threads"", ""ottawashooting-all-rnr-threads""]","[""27487343"", ""69181624""]",0,6,6
1150947134,3,97.33333333333333,-0.10438887278238933,2041535.0,3,0.0,"[""charliehebdo-all-rnr-threads"", ""sydneysiege-all-rnr-threads""]","[""15084853"", ""87818409"", ""428333""]",0,3,3
18525497,3,93.0,-0.1719557841618856,2064905.0,2,0.0,"[""charliehebdo-all-rnr-threads"", ""sydneysiege-all-rnr-threads""]","[""489475164"", ""33315010""]",0,3,3
433366025,3,104.33333333333333,0.11284573872884114,12961130.0,3,0.3333333333333333,"[""charliehebdo-all-rnr-threads"", ""ferguson-all-rnr-threads""]","[""1381926373"", ""16973333"", ""374712154""]",1,2,3
2367650918,9,92.33333333333333,-0.13230447636710274,6728156.0,4,0.2222222222222222,"[""charliehebdo-all-rnr-threads"", ""ottawashooting-all-rnr-threads"", ""sydneysiege-all-rnr-threads""]","[""315878798"", ""1367531"", ""249339016"", ""374712154""]",2,7,9
1876428638,3,48.333333333333336,0.04082651933034261,6719627.0,3,0.6666666666666666,"[""charliehebdo-all-rnr-threads"", ""ottawashooting-all-rnr-threads""]","[""24630719"", ""66967746"", ""5402612""]",2,1,3
612505092,2,75.5,-0.15741974115371704,6473149.0,2,0.0,"[""charliehebdo-all-rnr-threads"", ""germanwings-crash-all-rnr-threads""]","[""5943072"", ""33315010""]",0,2,2
14957784,3,64.66666666666667,-0.30806148052215576,2090744.0,3,0.0,"[""charliehebdo-all-rnr-threads"", ""sydneysiege-all-rnr-threads""]","[""15384969"", ""69181624"", ""16734909""]",0,3,3
1591762152,7,112.28571428571429,-0.10744185107094902,6823875.0,5,0.14285714285714285,"[""charliehebdo-all-rnr-threads"", ""ottawashooting-all-rnr-threads""]","[""19038934"", ""2396242676"", ""64643056"", ""34713362"", ""69181624""]",1,6,7
794921233,5,67.2,-0.16234441995620727,6719772.0,3,0.6,"[""charliehebdo-all-rnr-threads"", ""ottawashooting-all-rnr-threads"", ""sydneysiege-all-rnr-threads""]","[""237632983"", ""87416722"", ""7587032""]",3,2,5
1494212108,5,137.8,-0.2835535168647766,12600123.0,3,0.0,"[""charliehebdo-all-rnr-threads"", ""ferguson-all-rnr-threads""]","[""15754281"", ""73929665"", ""17469289""]",0,5,5
20361510,3,63.666666666666664,-0.6349638303120931,6478929.0,3,0.0,"[""charliehebdo-all-rnr-threads"", ""germanwings-crash-all-rnr-threads""]","[""16973333"", ""14291684"", ""19968074""]",0,3,3
362659950,2,110.5,0.1733769178390503,6737213.0,2,0.5,"[""charliehebdo-all-rnr-threads"", ""ottawashooting-all-rnr-threads""]","[""1652541"", ""868112707""]",1,1,2
1344951,2,104.0,-0.4221000373363495,6611280.0,32,0.5,"[""charliehebdo-all-rnr-threads"", ""germanwings-crash-all-rnr-threads""]","[""101581270"", ""1232417551"", ""1173263149"", ""274778775"", ""838492698"", ""1547227064"", ""76025896"", ""330348798"", ""72423865"", ""2914057853"", ""38407134"", ""14132993"", ""2464502209"", ""80818399"", ""103437676"", ""505943647"", ""1945778683"", ""166479009"", ""185109989"", ""2600078317"", ""26169650"", ""5817092"", ""2836847514"", ""3091638145"", ""138372255"", ""19578708"", ""73332074"", ""123757970"", ""316405268"", ""2952048011"", ""118828087"", ""45279852""]",1,1,2
316405268,8,90.125,-0.28126420080661774,2104717.0,6,0.375,"[""charliehebdo-all-rnr-threads"", ""sydneysiege-all-rnr-threads""]","[""14173315"", ""125486974"", ""1344951"", ""13496142"", ""211105315"", ""16834659""]",3,5,8
35515215,6,126.83333333333333,-0.26747967799504596,2148460.0,2,0.0,"[""charliehebdo-all-rnr-threads"", ""sydneysiege-all-rnr-threads""]","[""17537467"", ""87087057""]",0,6,6
270343236,3,103.66666666666667,-0.3629772861798604,2117823.0,2,0.6666666666666666,"[""charliehebdo-all-rnr-threads"", ""sydneysiege-all-rnr-threads""]","[""2622553496"", ""9609632""]",2,1,3
971547314,2,119.0,-0.27889204025268555,12563155.0,2,0.0,"[""charliehebdo-all-rnr-threads"", ""ferguson-all-rnr-threads""]","[""27376958"", ""2622553496""]",0,2,2
27234309,3,94.0,-0.15526890754699707,2060864.0,2,0.0,"[""charliehebdo-all-rnr-threads"", ""sydneysiege-all-rnr-threads""]","[""16416978"", ""1125937411""]",0,3,3
2180135409,2,28.0,0.4415254592895508,2069798.0,2,0.0,"[""charliehebdo-all-rnr-threads"", ""sydneysiege-all-rnr-threads""]","[""16416978"", ""271413771""]",0,2,2
508278502,4,109.75,0.016341745853424072,2419814.0,3,0.25,"[""charliehebdo-all-rnr-threads"", ""sydneysiege-all-rnr-threads""]","[""245354027"", ""868112707"", ""22650211""]",1,3,4
16807528,2,128.5,0.7631261348724365,2076042.0,39,0.0,"[""charliehebdo-all-rnr-threads"", ""sydneysiege-all-rnr-threads""]","[""2912528860"", ""17052499"", ""830038945"", ""2963403290"", ""137165722"", ""615332164"", ""286101234"", ""2650824742"", ""19763467"", ""60165404"", ""165546381"", ""102837987"", ""1288737078"", ""2908772864"", ""2838330203"", ""129250534"", ""537177835"", ""132482991"", ""241517692"", ""200078494"", ""20756649"", ""953490462"", ""2813685018"", ""2584501496"", ""181645519"", ""282561121"", ""142631056"", ""2906539788"", ""1849407440"", ""279627059"", ""254425460"", ""2798972827"", ""403381287"", ""353309244"", ""47919685"", ""1657114626"", ""2425582092"", ""268129374"", ""2886586060""]",0,2,2
66284799,4,83.75,0.04090401530265808,2174798.0,3,0.5,"[""charliehebdo-all-rnr-threads"", ""sydneysiege-all-rnr-threads""]","[""49591803"", ""16589206"", ""16973333""]",2,2,4
16675569,19,120.73684210526316,-0.26216878702766017,2116638.0,199,0.47368421052631576,"[""charliehebdo-all-rnr-threads"", ""sydneysiege-all-rnr-threads""]","[""2714881369"", ""43493268"", ""151025635"", ""149455862"", ""409529323"", ""264103932"", ""280242927"", ""25658504"", ""105098310"", ""21471016"", ""61121566"", ""175282160"", ""28938180"", ""5526692"", ""166999175"", ""286872483"", ""407897444"", ""2891096840"", ""1428723944"", ""20140331"", ""371131975"", ""13128922"", ""35703335"", ""207606693"", ""23811498"", ""749587081"", ""2293109486"", ""341087665"", ""812542670"", ""1621733996"", ""50436472"", ""481865531"", ""305508680"", ""178127989"", ""207930099"", ""1970791"", ""1542767918"", ""217212414"", ""1698251107"", ""33757942"", ""24878451"", ""162848820"", ""59503113"", ""406758089"", ""2861527184"", ""220363425"", ""121120097"", ""2744678191"", ""24082382"", ""2601118704"", ""15616878"", ""38669647"", ""28372386"", ""3847661"", ""183832473"", ""147128397"", ""49697215"", ""1391351"", ""61466200"", ""94001503"", ""185554632"", ""17167644"", ""2243999444"", ""19803724"", ""568119166"", ""2212096597"", ""626919867"", ""347883924"", ""324198458"", ""334489254"", ""312696314"", ""869068254"", ""28080447"", ""141826134"", ""33838503"", ""193129397"", ""959859638"", ""80713334"", ""22351659"", ""1654719594"", ""464840550"", ""61621978"", ""86718958"", ""202060924"", ""1635298872"", ""34065579"", ""102584544"", ""19898890"", ""1245231990"", ""1724568876"", ""768365011"", ""1057354111"", ""778896979"", ""182949996"", ""33559205"", ""1558361336"", ""349445673"", ""188672541"", ""303283534"", ""76877739"", ""2886586060"", ""371295497"", ""1687941666"", ""389195162"", ""142129666"", ""2384915342"", ""459023633"", ""1147665374"", ""565936487"", ""1460901524"", ""255730745"", ""1725045786"", ""264698143"", ""51963883"", ""1556339839"", ""260552411"", ""45739022"", ""2192202210"", ""636147584"", ""19352387"", ""446634114"", ""960439934"", ""465790247"", ""28098604"", ""257395153"", ""1069474172"", ""137887076"", ""2695643996"", ""1173694938"", ""2281283534"", ""1314797419"", ""438042918"", ""2861206728"", ""45179220"", ""18455693"", ""2887197776"", ""937897969"", ""107889537"", ""2575926475"", ""60006673"", ""523992136"", ""7755"", ""402738328"", ""132731043"", ""41395813"", ""909894727"", ""323499989"", ""999907196"", ""403516709"", ""35175092"", ""1931711646"", ""476083093"", ""28322848"", ""19911489"", ""80253523"", ""1368100356"", ""29515773"", ""113267913"", ""1595683692"", ""138559532"", ""14643310"", ""1279453093"", ""548126161"", ""135265953"", ""299615822"", ""138948142"", ""26238498"", ""1634512056"", ""1693969812"", ""2502895924"", ""48684811"", ""1732121486"", ""634391656"", ""84745032"", ""25733280"", ""2329801698"", ""306673996"", ""2334635804"", ""210751927"", ""504866029"", ""16106619"", ""1849407440"", ""1591341"", ""50956665"", ""60498116"", ""211113654"", ""599181271"", ""573490762"", ""2231330071"", ""431867098"", ""37595323"", ""1657081471"", ""204043844"", ""51643960"", ""2835341775"", ""131138919"", ""2833082389"", ""17286340"", ""28282978""]",9,10,19
120588038,4,86.25,-0.586572915315628,6476911.0,3,0.0,"[""charliehebdo-all-rnr-threads"", ""germanwings-crash-all-rnr-threads""]","[""877551276"", ""2180126766"", ""149913262""]",0,4,4
137200672,3,66.66666666666667,0.06132038434346517,2092440.0,3,0.6666666666666666,"[""charliehebdo-all-rnr-threads"", ""sydneysiege-all-rnr-threads""]","[""35466620"", ""215957468"", ""24202701""]",2,1,3
22993014,15,114.2,-0.44311800400416057,8725992.0,93,0.8666666666666667,"[""charliehebdo-all-rnr-threads"", ""germanwings-crash-all-rnr-threads"", ""sydneysiege-all-rnr-threads""]","[""340160734"", ""1487580918"", ""289242244"", ""84464003"", ""2652526820"", ""2886799455"", ""27637361"", ""101845567"", ""2882535500"", ""2893779372"", ""75926057"", ""1213592012"", ""17984709"", ""1486577036"", ""1133538883"", ""450436433"", ""326709238"", ""748181582"", ""22907290"", ""260525423"", ""2871280115"", ""2264503075"", ""42814345"", ""7479922"", ""631013204"", ""378639234"", ""37896521"", ""1122062046"", ""289240165"", ""1415578772"", ""24156429"", ""108556027"", ""552400640"", ""187815608"", ""507794602"", ""2196242099"", ""360548873"", ""2603240130"", ""498772850"", ""17832938"", ""602777418"", ""1119792055"", ""2154332281"", ""84107423"", ""318938422"", ""1964684353"", ""114115853"", ""165975771"", ""20167195"", ""769595918"", ""146805439"", ""583122991"", ""701089236"", ""516237864"", ""1956036432"", ""2546977356"", ""199633038"", ""2356127598"", ""146012766"", ""15072413"", ""2884931843"", ""350201324"", ""27112599"", ""3067130364"", ""2163919651"", ""9360352"", ""278852089"", ""2690688206"", ""293570482"", ""329315021"", ""1962366000"", ""102042591"", ""165805316"", ""27382397"", ""2502895924"", ""538928997"", ""168343491"", ""210408678"", ""2467026366"", ""597244003"", ""99986032"", ""36796138"", ""1466312012"", ""21753554"", ""79802631"", ""951710294"", ""2721116647"", ""221373945"", ""77739297"", ""1087978056"", ""66357545"", ""1569252751"", ""285482887""]",13,2,15
1465463371,2,133.5,0.34463727474212646,6699483.0,2,0.5,"[""charliehebdo-all-rnr-threads"", ""germanwings-crash-all-rnr-threads""]","[""288283415"", ""76858507""]",1,1,2
1379250560,3,63.0,-0.4373539288838704,2116506.0,2,0.3333333333333333,"[""charliehebdo-all-rnr-threads"", ""sydneysiege-all-rnr-threads""]","[""14173315"", ""28785486""]",1,2,3
581831550,3,46.0,0.13972795009613037,6478049.0,2,0.0,"[""charliehebdo-all-rnr-threads"", ""germanwings-crash-all-rnr-threads""]","[""22021978"", ""100936791""]",0,3,3
569900167,7,98.14285714285714,-0.5241178359304156,12745614.0,4,0.14285714285714285,"[""charliehebdo-all-rnr-threads"", ""sydneysiege-all-rnr-threads"", ""ferguson-all-rnr-threads""]","[""495464885"", ""20639175"", ""22021978"", ""26567591""]",1,6,7
2417900712,6,104.33333333333333,-0.5241620143254598,6884222.0,3,0.5,"[""charliehebdo-all-rnr-threads"", ""ottawashooting-all-rnr-threads""]","[""1652541"", ""166612219"", ""14569869""]",3,3,6
1349989992,4,80.75,-0.5149413496255875,2136075.0,2,0.0,"[""charliehebdo-all-rnr-threads"", ""sydneysiege-all-rnr-threads""]","[""373783051"", ""357584312""]",0,4,4
1630630458,9,116.33333333333333,-0.36622802416483563,2090254.0,3,0.0,"[""charliehebdo-all-rnr-threads"", ""sydneysiege-all-rnr-threads""]","[""628073"", ""17537467"", ""56039856""]",0,9,9
15688765,2,45.5,-0.3110065460205078,2091139.0,2,0.5,"[""charliehebdo-all-rnr-threads"", ""sydneysiege-all-rnr-threads""]","[""64643056"", ""428333""]",1,1,2
245571248,4,75.5,-0.261544406414032,6731709.0,2,0.5,"[""charliehebdo-all-rnr-threads"", ""ottawashooting-all-rnr-threads""]","[""19038934"", ""64643056""]",2,2,4
266236372,2,68.0,-0.2609444856643677,2117477.0,2,0.5,"[""charliehebdo-all-rnr-threads"", ""sydneysiege-all-rnr-threads""]","[""2768501"", ""64643056""]",1,1,2
17469289,6,121.5,-0.43002795179684955,13396171.0,64,0.5,"[""charliehebdo-all-rnr-threads"", ""germanwings-crash-all-rnr-threads"", ""ottawashooting-all-rnr-threads"", ""sydneysiege-all-rnr-threads""]","[""1355675563"", ""360060895"", ""614289577"", ""1726242560"", ""569655756"", ""17925247"", ""260267051"", ""257653898"", ""845136643"", ""2159337710"", ""500410336"", ""1359986802"", ""1450252777"", ""1494212108"", ""495121007"", ""501970474"", ""2424763149"", ""25704795"", ""2798078771"", ""2833294352"", ""102238015"", ""295445727"", ""92558629"", ""465790247"", ""49692288"", ""394470787"", ""1344297120"", ""1478585395"", ""1625316350"", ""2354261358"", ""31607232"", ""26595683"", ""2374092688"", ""2442219132"", ""248803369"", ""1212459181"", ""135685204"", ""329734806"", ""407048454"", ""460513085"", ""19159352"", ""238997526"", ""1030891255"", ""32428110"", ""824250668"", ""492529570"", ""29493511"", ""1123024728"", ""2914968646"", ""257234986"", ""829039422"", ""772610156"", ""24170100"", ""2200771147"", ""1382947069"", ""937532058"", ""497485493"", ""1609295678"", ""1635932448"", ""515537401"", ""253021891"", ""386163662"", ""62155958"", ""75896584""]",3,3,6
75896584,3,108.0,-0.7150455514589945,2061486.0,3,0.0,"[""charliehebdo-all-rnr-threads"", ""sydneysiege-all-rnr-threads""]","[""1367531"", ""51241574"", ""17469289""]",0,3,3
386163662,2,50.5,0.15370982885360718,2079409.0,2,0.0,"[""charliehebdo-all-rnr-threads"", ""sydneysiege-all-rnr-threads""]","[""14173315"", ""17469289""]",0,2,2
465790247,18,107.88888888888889,-0.32619158758057476,8821748.0,15,0.3333333333333333,"[""charliehebdo-all-rnr-threads"", ""germanwings-crash-all-rnr-threads"", ""sydneysiege-all-rnr-threads""]","[""9609632"", ""5402612"", ""19211550"", ""2738397743"", ""3108351"", ""1634077976"", ""2799960092"", ""35051304"", ""428333"", ""28785486"", ""28443608"", ""16675569"", ""1367531"", ""69181624"", ""17469289""]",6,12,18
403504067,2,115.0,0.39710527658462524,2067331.0,2,0.0,"[""charliehebdo-all-rnr-threads"", ""sydneysiege-all-rnr-threads""]","[""47992292"", ""16973333""]",0,2,2
105303715,3,122.66666666666667,-0.04960314432779948,2130688.0,3,0.0,"[""charliehebdo-all-rnr-threads"", ""sydneysiege-all-rnr-threads""]","[""3108351"", ""16811829"", ""111250814""]",0,3,3
20423979,8,92.25,-0.4017968475818634,12749140.0,3,0.25,"[""charliehebdo-all-rnr-threads"", ""sydneysiege-all-rnr-threads"", ""ferguson-all-rnr-threads""]","[""3108351"", ""2351100937"", ""5402612""]",2,6,8
2396848697,4,93.75,-0.2898689806461334,2063369.0,2,0.0,"[""charliehebdo-all-rnr-threads"", ""sydneysiege-all-rnr-threads""]","[""972651"", ""106118793""]",0,4,4
20013397,5,81.8,-0.21390396356582642,2119909.0,5,0.0,"[""charliehebdo-all-rnr-threads"", ""sydneysiege-all-rnr-threads""]","[""238575113"", ""106118793"", ""711348452"", ""82048287"", ""19534873""]",0,5,5
1725724380,2,97.5,-0.713644951581955,2065480.0,2,0.0,"[""charliehebdo-all-rnr-threads"", ""sydneysiege-all-rnr-threads""]","[""14173315"", ""2768501""]",0,2,2
2445446947,3,120.33333333333333,-0.012246251106262207,12620150.0,3,0.0,"[""charliehebdo-all-rnr-threads"", ""ferguson-all-rnr-threads""]","[""14173315"", ""27966935"", ""13557972""]",0,3,3
2404923614,2,70.5,-0.15604379773139954,2064240.0,2,0.0,"[""charliehebdo-all-rnr-threads"", ""sydneysiege-all-rnr-threads""]","[""14173315"", ""5988062""]",0,2,2
451019170,3,57.0,-0.24897213776906332,12611506.0,3,0.6666666666666666,"[""charliehebdo-all-rnr-threads"", ""ferguson-all-rnr-threads""]","[""14173315"", ""12004852"", ""14090948""]",2,1,3
225937279,5,109.2,0.3192411184310913,6476360.0,4,0.0,"[""charliehebdo-all-rnr-threads"", ""germanwings-crash-all-rnr-threads""]","[""3108351"", ""87818409"", ""64643056"", ""5402612""]",0,5,5
60848534,3,129.66666666666666,-0.3735663096110026,2090765.0,3,0.3333333333333333,"[""charliehebdo-all-rnr-threads"", ""sydneysiege-all-rnr-threads""]","[""239964092"", ""87818409"", ""5402612""]",1,2,3
22650211,3,114.66666666666667,0.11059880256652832,8552055.0,32,0.3333333333333333,"[""charliehebdo-all-rnr-threads"", ""germanwings-crash-all-rnr-threads"", ""sydneysiege-all-rnr-threads""]","[""1708285562"", ""41534916"", ""2153120337"", ""2782806799"", ""508278502"", ""2899192880"", ""284383121"", ""78272041"", ""129834146"", ""27017083"", ""560848999"", ""902817020"", ""2591370314"", ""1273983980"", ""725179554"", ""2322095298"", ""121754839"", ""20727451"", ""26886020"", ""1373090220"", ""33668198"", ""2882624429"", ""102758473"", ""409600225"", ""279788564"", ""2953601541"", ""414013525"", ""2346757280"", ""18790009"", ""937655960"", ""1969699327"", ""2945871636""]",1,2,3
409600225,5,91.2,-0.5073774576187133,12744669.0,4,0.2,"[""charliehebdo-all-rnr-threads"", ""ottawashooting-all-rnr-threads"", ""ferguson-all-rnr-threads""]","[""28139873"", ""6017542"", ""41747410"", ""22650211""]",1,4,5
2782737520,2,73.0,0.2848498821258545,2125886.0,2,0.5,"[""charliehebdo-all-rnr-threads"", ""sydneysiege-all-rnr-threads""]","[""15250661"", ""14291684""]",1,1,2
105497418,4,117.0,-0.4200458377599716,5636838.0,3,0.25,"[""charliehebdo-all-rnr-threads"", ""putinmissing-all-rnr-threads""]","[""18424289"", ""16343974"", ""516525338""]",1,3,4
2612152058,16,116.0625,-0.3127295523881912,13008251.0,3,0.0,"[""charliehebdo-all-rnr-threads"", ""ferguson-all-rnr-threads""]","[""16343974"", ""5513002"", ""7768402""]",0,16,16
593715286,7,74.14285714285714,-0.3320938689368112,2120667.0,3,0.7142857142857143,"[""charliehebdo-all-rnr-threads"", ""sydneysiege-all-rnr-threads""]","[""16973333"", ""25036511"", ""9609632""]",5,2,7
267906861,9,59.44444444444444,-0.4711601601706611,9076634.0,7,0.1111111111111111,"[""charliehebdo-all-rnr-threads"", ""putinmissing-all-rnr-threads"", ""germanwings-crash-all-rnr-threads"", ""sydneysiege-all-rnr-threads""]","[""403647191"", ""16973333"", ""2862224447"", ""6017542"", ""28785486"", ""64643056"", ""87818409""]",1,8,9
15936802,2,106.5,-0.3321559429168701,12592374.0,2,0.5,"[""charliehebdo-all-rnr-threads"", ""ferguson-all-rnr-threads""]","[""1716581"", ""239964092""]",1,1,2
279533332,2,80.5,-0.3250097632408142,2095525.0,2,0.5,"[""charliehebdo-all-rnr-threads"", ""sydneysiege-all-rnr-threads""]","[""87818409"", ""19346439""]",1,1,2
2181425453,4,100.75,-0.33574533462524414,2096496.0,3,0.75,"[""charliehebdo-all-rnr-threads"", ""sydneysiege-all-rnr-threads""]","[""7587032"", ""807095"", ""5402612""]",3,1,4
63708761,2,45.5,-0.35110530257225037,6649461.0,2,0.5,"[""charliehebdo-all-rnr-threads"", ""germanwings-crash-all-rnr-threads""]","[""87416722"", ""5402612""]",1,1,2
139106364,2,125.5,-0.015781044960021973,6473596.0,2,0.0,"[""charliehebdo-all-rnr-threads"", ""germanwings-crash-all-rnr-threads""]","[""14511951"", ""14123751""]",0,2,2
372875229,5,116.2,-0.6051534533500671,19211447.0,4,0.8,"[""charliehebdo-all-rnr-threads"", ""germanwings-crash-all-rnr-threads"", ""ottawashooting-all-rnr-threads"", ""ferguson-all-rnr-threads""]","[""972651"", ""3108351"", ""9763482"", ""2097571""]",4,1,5
1620537127,2,91.0,-0.4887174963951111,6728007.0,2,0.0,"[""charliehebdo-all-rnr-threads"", ""ottawashooting-all-rnr-threads""]","[""3108351"", ""148116121""]",0,2,2
1893224126,2,89.0,-0.28499722480773926,2087651.0,2,0.0,"[""charliehebdo-all-rnr-threads"", ""sydneysiege-all-rnr-threads""]","[""2768501"", ""238575113""]",0,2,2
255722041,2,52.0,-0.36437809467315674,12599731.0,2,0.5,"[""charliehebdo-all-rnr-threads"", ""ferguson-all-rnr-threads""]","[""16170253"", ""268476335""]",1,1,2
45916809,2,85.0,0.12582474946975708,6732959.0,2,0.0,"[""charliehebdo-all-rnr-threads"", ""ottawashooting-all-rnr-threads""]","[""16170253"", ""16076032""]",0,2,2
43089397,10,79.4,-0.14084749221801757,13482783.0,8,0.4,"[""charliehebdo-all-rnr-threads"", ""germanwings-crash-all-rnr-threads"", ""sydneysiege-all-rnr-threads"", ""putinmissing-all-rnr-threads"", ""ottawashooting-all-rnr-threads""]","[""19636948"", ""238575113"", ""148653311"", ""82048287"", ""988324790"", ""64643056"", ""16170253"", ""1462833583""]",4,6,10
2746589669,19,115.63157894736842,-0.3302050828933716,2128839.0,2,0.0,"[""charliehebdo-all-rnr-threads"", ""sydneysiege-all-rnr-threads""]","[""16170253"", ""49279876""]",0,19,19
16955991,4,132.5,-0.3761787414550781,12603003.0,24,0.5,"[""charliehebdo-all-rnr-threads"", ""ferguson-all-rnr-threads""]","[""259526020"", ""78427460"", ""1639113372"", ""283959988"", ""2351478066"", ""185798831"", ""2160013399"", ""359923590"", ""286202573"", ""2768927670"", ""486964841"", ""23363599"", ""601342849"", ""135538706"", ""119709056"", ""16955991"", ""1223349182"", ""180902640"", ""42786325"", ""283505633"", ""728607890"", ""2434612520"", ""46902019"", ""123557107""]",2,2,4
17936078,2,86.5,-0.4031117558479309,2141659.0,2,0.5,"[""charliehebdo-all-rnr-threads"", ""sydneysiege-all-rnr-threads""]","[""144313594"", ""4033561""]",1,1,2
302498850,2,67.5,-0.44600456953048706,2093168.0,2,0.5,"[""charliehebdo-all-rnr-threads"", ""sydneysiege-all-rnr-threads""]","[""87818409"", ""2097571""]",1,1,2
261093402,47,123.48936170212764,-0.2340067206545079,2124044.0,4,0.0,"[""charliehebdo-all-rnr-threads"", ""sydneysiege-all-rnr-threads""]","[""87818409"", ""65045121"", ""24062457"", ""2768501""]",0,47,47
893485608,7,99.57142857142857,-0.4349273698670523,2118416.0,4,0.7142857142857143,"[""charliehebdo-all-rnr-threads"", ""sydneysiege-all-rnr-threads""]","[""3108351"", ""83638901"", ""2768501"", ""14569869""]",5,2,7
165109443,2,54.0,-0.7557452619075775,2069176.0,2,0.5,"[""charliehebdo-all-rnr-threads"", ""sydneysiege-all-rnr-threads""]","[""83638901"", ""16973333""]",1,1,2
110129833,2,139.0,-0.27655595541000366,12603216.0,2,0.0,"[""charliehebdo-all-rnr-threads"", ""ferguson-all-rnr-threads""]","[""28785486"", ""73929665""]",0,2,2
2497286180,8,115.5,-0.3923502638936043,6735016.0,7,0.25,"[""charliehebdo-all-rnr-threads"", ""germanwings-crash-all-rnr-threads""]","[""14173315"", ""3022045469"", ""807095"", ""28785486"", ""952112047"", ""2467791"", ""5402612""]",2,6,8
14606079,3,122.66666666666667,0.06867941220601399,12757560.0,34,0.0,"[""charliehebdo-all-rnr-threads"", ""ferguson-all-rnr-threads""]","[""300911755"", ""35443658"", ""15372043"", ""59816480"", ""548357566"", ""471279858"", ""1451170099"", ""1933506578"", ""16074163"", ""1603601076"", ""485084898"", ""2941973702"", ""43553304"", ""22707692"", ""2790196259"", ""14606079"", ""15121509"", ""2199283718"", ""2562271622"", ""1597610311"", ""93676837"", ""80909919"", ""2716897794"", ""19049396"", ""420223654"", ""111372561"", ""460657243"", ""18980578"", ""89592667"", ""430439152"", ""147010281"", ""1485125072"", ""20402116"", ""240114180""]",0,3,3
471279858,3,71.33333333333333,-0.5654126405715942,12575802.0,2,0.0,"[""charliehebdo-all-rnr-threads"", ""ferguson-all-rnr-threads""]","[""14606079"", ""14715424""]",0,3,3
5695632,3,110.33333333333333,0.07576938470204671,2110132.0,33,0.3333333333333333,"[""charliehebdo-all-rnr-threads"", ""sydneysiege-all-rnr-threads""]","[""21547276"", ""2571780841"", ""1909390567"", ""2442517623"", ""473190968"", ""2742828972"", ""141092727"", ""2826395787"", ""190280139"", ""2911803011"", ""464106584"", ""2923225726"", ""25785671"", ""36012116"", ""632539802"", ""2424363320"", ""67889884"", ""248363765"", ""43840492"", ""393457695"", ""573337909"", ""2777192663"", ""1064618233"", ""126038431"", ""348301649"", ""11250092"", ""97285519"", ""519465808"", ""28107803"", ""150360761"", ""170129605"", ""144042156"", ""62420909""]",1,2,3
2900321062,2,71.0,0.8247110843658447,5635784.0,2,0.5,"[""charliehebdo-all-rnr-threads"", ""putinmissing-all-rnr-threads""]","[""1020058453"", ""15438913""]",1,1,2
2406353654,2,110.0,-0.5244108736515045,5539202.0,4,0.0,"[""charliehebdo-all-rnr-threads"", ""putinmissing-all-rnr-threads""]","[""1020058453"", ""877739094"", ""213878611"", ""206819306""]",0,2,2
2329801698,2,98.0,-0.1532781720161438,2120496.0,2,0.5,"[""charliehebdo-all-rnr-threads"", ""sydneysiege-all-rnr-threads""]","[""16675569"", ""18576537""]",1,1,2
203442882,4,86.5,-0.18642456829547882,2074886.0,3,0.0,"[""charliehebdo-all-rnr-threads"", ""sydneysiege-all-rnr-threads""]","[""22021978"", ""16973333"", ""489475164""]",0,4,4
28139873,3,108.33333333333333,-0.3068253993988037,10370523.0,16,0.6666666666666666,"[""charliehebdo-all-rnr-threads"", ""gurlitt-all-rnr-threads"", ""germanwings-crash-all-rnr-threads""]","[""409600225"", ""2905066780"", ""1596737431"", ""2584501496"", ""2264739086"", ""57124428"", ""221150133"", ""2175159803"", ""102348840"", ""23630235"", ""368997311"", ""2725911162"", ""289445328"", ""2777121654"", ""2520670394"", ""34034694""]",2,1,3
106608764,3,111.0,0.07031206289927165,2077730.0,2,0.0,"[""charliehebdo-all-rnr-threads"", ""sydneysiege-all-rnr-threads""]","[""1649548520"", ""2370486097""]",0,3,3
181873706,7,73.71428571428571,-0.12329818521227155,12718493.0,5,0.0,"[""charliehebdo-all-rnr-threads"", ""sydneysiege-all-rnr-threads"", ""ferguson-all-rnr-threads""]","[""16589206"", ""7587032"", ""2396242676"", ""379481082"", ""18643437""]",0,7,7
458768756,5,106.0,-0.18777000904083252,2131128.0,3,0.6,"[""charliehebdo-all-rnr-threads"", ""sydneysiege-all-rnr-threads""]","[""80803819"", ""7587032"", ""64643056""]",3,2,5
128091407,5,90.2,-0.4111865282058716,12606926.0,4,0.2,"[""charliehebdo-all-rnr-threads"", ""ottawashooting-all-rnr-threads"", ""ferguson-all-rnr-threads""]","[""180887271"", ""20375332"", ""183341278"", ""14090948""]",1,4,5
126732937,2,58.5,-0.8107028603553772,2070419.0,2,0.5,"[""charliehebdo-all-rnr-threads"", ""sydneysiege-all-rnr-threads""]","[""20639175"", ""15164565""]",1,1,2
2898545532,3,70.0,0.3366770346959432,2076784.0,2,0.0,"[""charliehebdo-all-rnr-threads"", ""sydneysiege-all-rnr-threads""]","[""15164565"", ""2097571""]",0,3,3
277501298,2,125.0,0.020358622074127197,12762302.0,18,0.5,"[""charliehebdo-all-rnr-threads"", ""ferguson-all-rnr-threads""]","[""55348286"", ""159447476"", ""339267415"", ""2952373972"", ""954124423"", ""2782941807"", ""2811083186"", ""253034379"", ""534329922"", ""885944552"", ""22268924"", ""55004670"", ""2668286088"", ""2494237140"", ""2270616696"", ""436129937"", ""40796569"", ""2212943522""]",1,1,2
253034379,2,138.0,-0.6177871227264404,2108971.0,2,0.5,"[""charliehebdo-all-rnr-threads"", ""sydneysiege-all-rnr-threads""]","[""277501298"", ""1367531""]",1,1,2
436129937,3,76.66666666666667,-0.25737573703130084,2108649.0,2,0.0,"[""charliehebdo-all-rnr-threads"", ""sydneysiege-all-rnr-threads""]","[""277501298"", ""269167743""]",0,3,3
885944552,2,67.5,-0.330320805311203,2134910.0,2,0.0,"[""charliehebdo-all-rnr-threads"", ""sydneysiege-all-rnr-threads""]","[""277501298"", ""17537467""]",0,2,2
159447476,6,77.16666666666667,-0.17106810212135315,2088169.0,6,0.0,"[""charliehebdo-all-rnr-threads"", ""sydneysiege-all-rnr-threads""]","[""14173315"", ""272388054"", ""43182702"", ""28443608"", ""277501298"", ""17672825""]",0,6,6
1498965000,2,60.0,-0.2792854309082031,2053855.0,2,0.5,"[""charliehebdo-all-rnr-threads"", ""sydneysiege-all-rnr-threads""]","[""1367531"", ""428333""]",1,1,2
127689975,2,98.5,0.17006438970565796,12571250.0,2,0.0,"[""charliehebdo-all-rnr-threads"", ""ferguson-all-rnr-threads""]","[""1594679162"", ""2467791""]",0,2,2
160300478,2,129.0,-0.17427116632461548,12748842.0,2,0.0,"[""charliehebdo-all-rnr-threads"", ""ferguson-all-rnr-threads""]","[""6017542"", ""279390084""]",0,2,2
565978620,2,61.0,-0.42400914430618286,2088091.0,2,0.0,"[""charliehebdo-all-rnr-threads"", ""sydneysiege-all-rnr-threads""]","[""14260960"", ""403338386""]",0,2,2
1014842906,2,119.0,0.20965135097503662,2011712.0,2,0.0,"[""charliehebdo-all-rnr-threads"", ""sydneysiege-all-rnr-threads""]","[""87818409"", ""16973333""]",0,2,2
258551101,11,118.81818181818181,-0.39511803605339746,12778454.0,5,0.0,"[""charliehebdo-all-rnr-threads"", ""ferguson-all-rnr-threads""]","[""329121956"", ""14675395"", ""97327765"", ""5971922"", ""279390084""]",0,11,11
20772763,4,107.25,-0.06731930375099182,12753237.0,60,0.5,"[""charliehebdo-all-rnr-threads"", ""ferguson-all-rnr-threads""]","[""459867428"", ""37311844"", ""260301540"", ""22713011"", ""221986346"", ""92189292"", ""1596926072"", ""2329326803"", ""244589701"", ""388365142"", ""377751695"", ""344953081"", ""17292561"", ""23338474"", ""437032241"", ""153805650"", ""2734677633"", ""376565512"", ""2421007736"", ""707758978"", ""193402733"", ""72651596"", ""73276861"", ""361031326"", ""342499442"", ""359617326"", ""248737367"", ""19009248"", ""801785286"", ""2600277932"", ""20772763"", ""2656614540"", ""21884532"", ""137576060"", ""113424415"", ""622100503"", ""16316267"", ""2332642788"", ""275785388"", ""1311628110"", ""24133143"", ""2573215164"", ""1912657171"", ""468701417"", ""2559192704"", ""49156508"", ""894194737"", ""393771226"", ""185448870"", ""53228449"", ""260290494"", ""408959358"", ""41019698"", ""1365091302"", ""902814223"", ""248318637"", ""155681507"", ""1733506141"", ""18597764"", ""24691658""]",2,2,4
46472191,5,99.6,-0.6885429143905639,12766536.0,2,0.0,"[""charliehebdo-all-rnr-threads"", ""ferguson-all-rnr-threads""]","[""1020058453"", ""279390084""]",0,5,5
18510860,8,109.875,-0.03888925909996033,12614358.0,78,0.125,"[""charliehebdo-all-rnr-threads"", ""ottawashooting-all-rnr-threads"", ""ferguson-all-rnr-threads"", ""sydneysiege-all-rnr-threads""]","[""18424493"", ""902528816"", ""886058389"", ""23219195"", ""249028866"", ""2307296066"", ""488950123"", ""6857232"", ""234924597"", ""5781452"", ""845781468"", ""2435810782"", ""20914115"", ""29305382"", ""898374318"", ""41767207"", ""386759401"", ""59913153"", ""394350155"", ""462305473"", ""186860446"", ""1045942554"", ""18510860"", ""25568513"", ""126216040"", ""72204671"", ""245322493"", ""111425384"", ""50736522"", ""347534990"", ""25912403"", ""1431651026"", ""17699061"", ""1873113278"", ""136918688"", ""28242803"", ""284149960"", ""1191208519"", ""9167712"", ""307401285"", ""256147840"", ""17327231"", ""63452015"", ""237321959"", ""282894960"", ""16535777"", ""339312080"", ""9177342"", ""378241649"", ""163249730"", ""466927482"", ""1554738476"", ""142542130"", ""601342849"", ""18176362"", ""20460055"", ""1410603181"", ""625802134"", ""92653916"", ""935456701"", ""21362105"", ""71530832"", ""1877971308"", ""1692934940"", ""24691658"", ""172243973"", ""2354954125"", ""743180706"", ""1511224255"", ""36797564"", ""2732943264"", ""1713036884"", ""705564782"", ""2241415574"", ""1849407440"", ""303772214"", ""176664765"", ""54106266""]",1,7,8
71530832,2,83.0,-0.1359550952911377,2116327.0,2,0.5,"[""charliehebdo-all-rnr-threads"", ""sydneysiege-all-rnr-threads""]","[""18510860"", ""15220768""]",1,1,2
1374510187,2,96.5,-0.6230645179748535,2113648.0,2,0.5,"[""charliehebdo-all-rnr-threads"", ""sydneysiege-all-rnr-threads""]","[""254873869"", ""15439395""]",1,1,2
185947193,3,93.66666666666667,-0.2037002444267273,6726790.0,3,0.3333333333333333,"[""charliehebdo-all-rnr-threads"", ""ottawashooting-all-rnr-threads""]","[""19346439"", ""1877831"", ""82120358""]",1,2,3
610028948,3,97.0,-0.16331976652145386,2092104.0,3,0.3333333333333333,"[""charliehebdo-all-rnr-threads"", ""sydneysiege-all-rnr-threads""]","[""19346439"", ""7587032"", ""5402612""]",1,2,3
283582930,2,141.0,-0.705389142036438,6708673.0,2,0.0,"[""charliehebdo-all-rnr-threads"", ""ottawashooting-all-rnr-threads""]","[""16973333"", ""64643056""]",0,2,2
2848043788,9,76.11111111111111,-0.35608943303426105,2126445.0,4,0.6666666666666666,"[""charliehebdo-all-rnr-threads"", ""sydneysiege-all-rnr-threads""]","[""7587032"", ""1960878613"", ""87416722"", ""5402612""]",6,3,9
1022590015,3,81.66666666666667,-0.40577268600463867,2065620.0,2,0.0,"[""charliehebdo-all-rnr-threads"", ""sydneysiege-all-rnr-threads""]","[""211105315"", ""14293310""]",0,3,3
225071374,5,74.2,-0.09365971088409424,13040393.0,5,0.4,"[""charliehebdo-all-rnr-threads"", ""ottawashooting-all-rnr-threads"", ""ferguson-all-rnr-threads""]","[""16106584"", ""16834491"", ""807095"", ""11265832"", ""168843567""]",2,3,5
1615736210,12,112.58333333333333,-0.3735760947068532,13132614.0,9,0.16666666666666666,"[""charliehebdo-all-rnr-threads"", ""ferguson-all-rnr-threads""]","[""44361097"", ""6482142"", ""1716581"", ""16106584"", ""2611766492"", ""14155907"", ""12004852"", ""168843567"", ""100136358""]",2,10,12
1412522216,2,90.0,-0.5441387295722961,2103868.0,2,0.0,"[""charliehebdo-all-rnr-threads"", ""sydneysiege-all-rnr-threads""]","[""407871140"", ""16343974""]",0,2,2
258991152,5,69.2,-0.411932635307312,2131259.0,2,0.8,"[""charliehebdo-all-rnr-threads"", ""sydneysiege-all-rnr-threads""]","[""16343974"", ""1056552596""]",4,1,5
78837703,5,56.2,0.1592163324356079,6516739.0,3,0.0,"[""charliehebdo-all-rnr-threads"", ""germanwings-crash-all-rnr-threads""]","[""3108351"", ""14293310"", ""5402612""]",0,5,5
34123611,8,111.875,-0.2511148303747177,12768739.0,21,0.75,"[""charliehebdo-all-rnr-threads"", ""ferguson-all-rnr-threads""]","[""217656733"", ""2407363820"", ""808115250"", ""15603299"", ""1352299160"", ""382101681"", ""34123611"", ""136309784"", ""2468382834"", ""193349528"", ""2622553496"", ""22982919"", ""19950990"", ""829123928"", ""50419697"", ""2472817628"", ""83739980"", ""2285147504"", ""53456567"", ""15730258"", ""114032121""]",6,2,8
518129224,2,138.0,-0.717361718416214,6705551.0,2,0.5,"[""charliehebdo-all-rnr-threads"", ""ottawashooting-all-rnr-threads""]","[""14465607"", ""27947088""]",1,1,2
19017675,3,102.33333333333333,-0.27266834179560345,2160834.0,72,0.0,"[""charliehebdo-all-rnr-threads"", ""sydneysiege-all-rnr-threads""]","[""2563487501"", ""103038998"", ""2168497026"", ""935021904"", ""21862223"", ""213513491"", ""339866695"", ""51052182"", ""392867590"", ""1041883994"", ""2821061050"", ""1454534240"", ""25980607"", ""2746117229"", ""29986370"", ""507239123"", ""15348883"", ""72846747"", ""1268438574"", ""25591507"", ""370236180"", ""599663555"", ""112703470"", ""242077563"", ""465973"", ""16513349"", ""413646006"", ""157899542"", ""320275643"", ""225739439"", ""968138851"", ""1577706050"", ""1547719904"", ""2876499075"", ""32372694"", ""1444843555"", ""85953988"", ""1006257686"", ""548133519"", ""2888053786"", ""370689583"", ""24233842"", ""19962033"", ""636913431"", ""92795096"", ""47992292"", ""2752626905"", ""65695658"", ""21282561"", ""19532660"", ""354914590"", ""595969050"", ""336536137"", ""1564167697"", ""132660956"", ""103309339"", ""457152457"", ""1268671406"", ""253148061"", ""1628552390"", ""1005033720"", ""85831860"", ""1456923787"", ""594470164"", ""1397423635"", ""21686046"", ""2938623403"", ""44114927"", ""1562847648"", ""19816004"", ""89570289"", ""43713337""]",0,3,3
65695658,4,111.5,0.24367332458496094,12677041.0,3,0.0,"[""charliehebdo-all-rnr-threads"", ""ferguson-all-rnr-threads""]","[""15438913"", ""19017675"", ""195271137""]",0,4,4
320275643,3,82.0,0.1756990154584249,2089465.0,2,0.0,"[""charliehebdo-all-rnr-threads"", ""sydneysiege-all-rnr-threads""]","[""8197942"", ""19017675""]",0,3,3
1444843555,2,107.0,-0.3084322214126587,2096658.0,1,0.0,"[""charliehebdo-all-rnr-threads"", ""sydneysiege-all-rnr-threads""]","[""19017675""]",0,2,2
177568437,2,44.0,-0.1309632658958435,6705744.0,2,0.5,"[""charliehebdo-all-rnr-threads"", ""ottawashooting-all-rnr-threads""]","[""2326482060"", ""149913262""]",1,1,2
45265619,2,47.5,-0.37868010997772217,12768760.0,2,0.5,"[""charliehebdo-all-rnr-threads"", ""ferguson-all-rnr-threads""]","[""954124423"", ""149913262""]",1,1,2
237488620,4,95.0,-0.1097276508808136,12592125.0,4,0.5,"[""charliehebdo-all-rnr-threads"", ""ottawashooting-all-rnr-threads"", ""ferguson-all-rnr-threads"", ""sydneysiege-all-rnr-threads""]","[""1652541"", ""5402612"", ""16553638"", ""149913262""]",2,2,4
628636580,3,128.66666666666666,-0.16922577222188315,2157131.0,2,0.0,"[""charliehebdo-all-rnr-threads"", ""sydneysiege-all-rnr-threads""]","[""7744592"", ""1379288282""]",0,3,3
300773836,2,95.5,0.17437505722045898,2078619.0,2,0.0,"[""charliehebdo-all-rnr-threads"", ""sydneysiege-all-rnr-threads""]","[""16012783"", ""1379288282""]",0,2,2
185798831,2,54.0,0.07659575343132019,6723015.0,2,0.0,"[""charliehebdo-all-rnr-threads"", ""ottawashooting-all-rnr-threads""]","[""16955991"", ""742143""]",0,2,2
2513043992,2,71.0,0.2417958378791809,6735672.0,2,0.5,"[""charliehebdo-all-rnr-threads"", ""ottawashooting-all-rnr-threads""]","[""34713362"", ""3108351""]",1,1,2
469180343,3,43.333333333333336,-0.3179302215576172,2086425.0,3,0.3333333333333333,"[""charliehebdo-all-rnr-threads"", ""sydneysiege-all-rnr-threads""]","[""1960878613"", ""2966351008"", ""16973333""]",1,2,3
105199945,3,102.0,-0.423544704914093,12652287.0,3,0.3333333333333333,"[""charliehebdo-all-rnr-threads"", ""ferguson-all-rnr-threads""]","[""69773058"", ""253186785"", ""862374578""]",1,2,3
2489876530,10,120.0,-0.6298998713493347,2215813.0,3,0.1,"[""charliehebdo-all-rnr-threads"", ""sydneysiege-all-rnr-threads""]","[""292777349"", ""64643056"", ""428333""]",1,9,10
209845048,3,103.66666666666667,-0.28808025519053143,12590920.0,2,0.3333333333333333,"[""charliehebdo-all-rnr-threads"", ""ottawashooting-all-rnr-threads"", ""ferguson-all-rnr-threads""]","[""16589206"", ""64643056""]",1,2,3
148116121,3,89.33333333333333,0.09809219837188721,6733597.0,33,0.0,"[""charliehebdo-all-rnr-threads"", ""ottawashooting-all-rnr-threads""]","[""22389207"", ""9606552"", ""13059342"", ""1620537127"", ""137203036"", ""16310843"", ""1516705844"", ""36367488"", ""2234881"", ""297080451"", ""532779460"", ""19308477"", ""118618828"", ""9960512"", ""17666799"", ""18405412"", ""204844864"", ""28404999"", ""469845522"", ""342313862"", ""330378192"", ""270921976"", ""109532325"", ""134430704"", ""555275062"", ""310845198"", ""18220818"", ""148116121"", ""19848814"", ""11462742"", ""18005848"", ""52503887"", ""203088036""]",0,3,3
77943492,5,99.4,-0.28253487348556516,2220769.0,4,0.4,"[""charliehebdo-all-rnr-threads"", ""sydneysiege-all-rnr-threads""]","[""15400294"", ""532779460"", ""7702542"", ""1269181292""]",2,3,5
285693924,6,56.833333333333336,0.05147409439086914,6739875.0,5,0.0,"[""charliehebdo-all-rnr-threads"", ""ottawashooting-all-rnr-threads""]","[""407779393"", ""532779460"", ""1169109691"", ""2924591292"", ""458008892""]",0,6,6
22819351,5,118.4,-0.023969745635986327,12633189.0,4,0.0,"[""charliehebdo-all-rnr-threads"", ""ferguson-all-rnr-threads""]","[""20639175"", ""215694545"", ""15279429"", ""12811952""]",0,5,5
2457682945,2,91.5,-0.22664359211921692,6740184.0,2,0.0,"[""charliehebdo-all-rnr-threads"", ""ottawashooting-all-rnr-threads""]","[""220081875"", ""5402612""]",0,2,2
41204528,2,106.5,0.08461380004882812,12597436.0,20,0.0,"[""charliehebdo-all-rnr-threads"", ""ferguson-all-rnr-threads""]","[""218272201"", ""2961649574"", ""221543326"", ""326583197"", ""201732018"", ""382766279"", ""805430684"", ""58580535"", ""2495613440"", ""71103637"", ""2462785775"", ""2696931547"", ""28046447"", ""503975884"", ""247334850"", ""2880020654"", ""90158041"", ""1623513836"", ""2306521326"", ""26960518""]",0,2,2
34698912,2,89.0,-0.5976800918579102,6729368.0,2,0.5,"[""charliehebdo-all-rnr-threads"", ""ottawashooting-all-rnr-threads""]","[""14293310"", ""18217574""]",1,1,2
89502079,2,135.5,-0.1629531979560852,2086240.0,2,0.5,"[""charliehebdo-all-rnr-threads"", ""sydneysiege-all-rnr-threads""]","[""37874853"", ""14293310""]",1,1,2
20727451,4,46.75,0.021269232034683228,2161118.0,4,0.25,"[""charliehebdo-all-rnr-threads"", ""sydneysiege-all-rnr-threads""]","[""972651"", ""15012486"", ""14293310"", ""22650211""]",1,3,4
2172659323,2,70.0,0.1408253312110901,2147136.0,2,0.0,"[""charliehebdo-all-rnr-threads"", ""sydneysiege-all-rnr-threads""]","[""18424289"", ""2461887810""]",0,2,2
1602656936,2,119.5,-0.4610474109649658,12756099.0,2,0.0,"[""charliehebdo-all-rnr-threads"", ""ferguson-all-rnr-threads""]","[""183341278"", ""15995155""]",0,2,2
1523383896,2,117.5,0.41111087799072266,2134653.0,2,0.5,"[""charliehebdo-all-rnr-threads"", ""sydneysiege-all-rnr-threads""]","[""16343974"", ""92242282""]",1,1,2
52557443,2,78.0,0.09271907806396484,6470245.0,12,0.0,"[""charliehebdo-all-rnr-threads"", ""germanwings-crash-all-rnr-threads""]","[""75794152"", ""45876164"", ""38166456"", ""2933454641"", ""2212926706"", ""210221037"", ""1462638932"", ""218824250"", ""2878365920"", ""431686303"", ""9507342"", ""1252082678""]",0,2,2
101202244,2,84.5,-0.518887460231781,6475532.0,2,0.5,"[""charliehebdo-all-rnr-threads"", ""germanwings-crash-all-rnr-threads""]","[""2280470022"", ""38291055""]",1,1,2
1648568587,7,68.85714285714286,-0.14920043093817575,2092127.0,4,0.0,"[""charliehebdo-all-rnr-threads"", ""sydneysiege-all-rnr-threads""]","[""1960878613"", ""17537467"", ""292777349"", ""111250814""]",0,7,7
593604107,2,60.0,0.3187374472618103,7590765.0,2,0.5,"[""charliehebdo-all-rnr-threads"", ""ebola-essien-all-rnr-threads""]","[""1262229906"", ""138749160""]",1,1,2
2861194665,4,122.75,-0.5131509155035019,2082131.0,3,0.0,"[""charliehebdo-all-rnr-threads"", ""sydneysiege-all-rnr-threads""]","[""15439395"", ""87416722"", ""374712154""]",0,4,4
1857982483,12,111.0,-0.3846215655406316,6816356.0,6,0.4166666666666667,"[""charliehebdo-all-rnr-threads"", ""ottawashooting-all-rnr-threads"", ""sydneysiege-all-rnr-threads""]","[""1877831"", ""34310801"", ""2097571"", ""1367531"", ""16525194"", ""76858507""]",5,7,12
2738912233,2,114.5,-0.6423378586769104,2070467.0,2,0.0,"[""charliehebdo-all-rnr-threads"", ""sydneysiege-all-rnr-threads""]","[""1877831"", ""807095""]",0,2,2
930963812,2,35.0,-0.14066475629806519,13003925.0,2,0.0,"[""charliehebdo-all-rnr-threads"", ""ferguson-all-rnr-threads""]","[""5513002"", ""428333""]",0,2,2
2423599832,2,59.5,0.20837366580963135,6737836.0,2,0.5,"[""charliehebdo-all-rnr-threads"", ""ottawashooting-all-rnr-threads""]","[""1367531"", ""428333""]",1,1,2
2222065434,2,103.5,-0.23221129179000854,2129972.0,1,0.0,"[""charliehebdo-all-rnr-threads"", ""sydneysiege-all-rnr-threads""]","[""428333""]",0,2,2
2288286954,3,38.0,-0.18444353342056274,12766275.0,2,0.0,"[""charliehebdo-all-rnr-threads"", ""ferguson-all-rnr-threads""]","[""244452760"", ""16973333""]",0,3,3
426561297,4,85.75,-0.38122905790805817,2129278.0,3,0.5,"[""charliehebdo-all-rnr-threads"", ""sydneysiege-all-rnr-threads""]","[""16973333"", ""742143"", ""374712154""]",2,2,4
26550151,6,100.0,-0.3513186077276866,2118895.0,4,0.0,"[""charliehebdo-all-rnr-threads"", ""sydneysiege-all-rnr-threads""]","[""169844049"", ""15754281"", ""282977213"", ""43568964""]",0,6,6
23262069,3,142.0,-0.5860065420468649,12827667.0,3,0.0,"[""charliehebdo-all-rnr-threads"", ""ferguson-all-rnr-threads""]","[""232235048"", ""87818409"", ""14849562""]",0,3,3
29283,2,131.5,0.26660192012786865,12857271.0,2,0.0,"[""charliehebdo-all-rnr-threads"", ""ferguson-all-rnr-threads""]","[""121817564"", ""14090948""]",0,2,2
506958753,3,120.66666666666667,-0.31374913454055786,12758523.0,3,0.0,"[""charliehebdo-all-rnr-threads"", ""ferguson-all-rnr-threads""]","[""11265832"", ""1877831"", ""19259102""]",0,3,3
22096507,3,133.0,-0.7029771407445272,6719730.0,3,0.3333333333333333,"[""charliehebdo-all-rnr-threads"", ""ottawashooting-all-rnr-threads""]","[""14138785"", ""1634077976"", ""1877831""]",1,2,3
737304938,7,65.0,-0.3251991186823164,13089019.0,6,0.14285714285714285,"[""charliehebdo-all-rnr-threads"", ""ferguson-all-rnr-threads""]","[""1877831"", ""15951166"", ""61149653"", ""5513002"", ""325265073"", ""414488432""]",1,6,7
67197351,2,115.0,0.31058454513549805,2108941.0,24,0.0,"[""charliehebdo-all-rnr-threads"", ""sydneysiege-all-rnr-threads""]","[""2871419496"", ""1386106560"", ""2556184104"", ""254299214"", ""236644479"", ""1437521503"", ""2809308063"", ""414241777"", ""90814009"", ""2874478519"", ""245498894"", ""2738332984"", ""506449640"", ""2878798384"", ""1713079837"", ""276721626"", ""23554648"", ""52396489"", ""331975264"", ""161026267"", ""373725327"", ""219158202"", ""29803990"", ""150711897""]",0,2,2
1666280082,15,96.8,-0.14902561902999878,2076749.0,3,0.0,"[""charliehebdo-all-rnr-threads"", ""sydneysiege-all-rnr-threads""]","[""618972073"", ""87818409"", ""51241574""]",0,15,15
1458557011,2,139.5,-0.4981515407562256,12942439.0,2,0.0,"[""charliehebdo-all-rnr-threads"", ""ferguson-all-rnr-threads""]","[""16589206"", ""14722589""]",0,2,2
25675905,2,136.0,-0.22057664394378662,2075533.0,10,0.0,"[""charliehebdo-all-rnr-threads"", ""sydneysiege-all-rnr-threads""]","[""185062591"", ""47921034"", ""263745551"", ""2905442233"", ""978063000"", ""369430275"", ""2318883571"", ""2285858051"", ""2887520353"", ""524875121""]",0,2,2
2242637850,3,90.66666666666667,-0.496172567208608,2114655.0,2,0.0,"[""charliehebdo-all-rnr-threads"", ""sydneysiege-all-rnr-threads""]","[""17537467"", ""47685065""]",0,3,3
1614088758,5,86.8,-0.4000972151756287,2123709.0,2,0.0,"[""charliehebdo-all-rnr-threads"", ""sydneysiege-all-rnr-threads""]","[""60937837"", ""47685065""]",0,5,5
1531465705,2,114.0,0.3150746822357178,2078335.0,2,0.0,"[""charliehebdo-all-rnr-threads"", ""sydneysiege-all-rnr-threads""]","[""47685065"", ""2574072036""]",0,2,2
1561413559,2,121.5,-0.2153203785419464,2076604.0,2,0.0,"[""charliehebdo-all-rnr-threads"", ""sydneysiege-all-rnr-threads""]","[""1367531"", ""5402612""]",0,2,2
390576798,5,90.4,-0.18306365013122558,12785852.0,5,0.4,"[""charliehebdo-all-rnr-threads"", ""sydneysiege-all-rnr-threads"", ""ferguson-all-rnr-threads""]","[""111157878"", ""109065990"", ""718612494"", ""9507342"", ""5402612""]",2,3,5
289732005,2,137.5,-0.2504364848136902,2101899.0,2,0.0,"[""charliehebdo-all-rnr-threads"", ""sydneysiege-all-rnr-threads""]","[""2097571"", ""153029181""]",0,2,2
502510877,2,132.5,-0.4142181873321533,13022878.0,2,0.0,"[""charliehebdo-all-rnr-threads"", ""ferguson-all-rnr-threads""]","[""5513002"", ""60296618""]",0,2,2
26156936,2,40.5,-0.1135450005531311,6598640.0,2,0.0,"[""charliehebdo-all-rnr-threads"", ""germanwings-crash-all-rnr-threads""]","[""182251918"", ""3108351""]",0,2,2
173720699,3,140.0,-0.41504067182540894,6817133.0,3,0.3333333333333333,"[""charliehebdo-all-rnr-threads"", ""ottawashooting-all-rnr-threads""]","[""3108351"", ""14138785"", ""807095""]",1,2,3
469845522,5,84.6,-0.24176148176193238,12363965.0,5,0.4,"[""charliehebdo-all-rnr-threads"", ""putinmissing-all-rnr-threads"", ""ottawashooting-all-rnr-threads""]","[""16973333"", ""148116121"", ""33946296"", ""50657158"", ""1735194972""]",2,3,5
18102864,3,58.666666666666664,-0.3421304225921631,12636576.0,2,0.6666666666666666,"[""charliehebdo-all-rnr-threads"", ""ferguson-all-rnr-threads""]","[""23569016"", ""16031927""]",2,1,3
334389274,2,126.0,-0.5029341876506805,6752477.0,2,0.0,"[""charliehebdo-all-rnr-threads"", ""ottawashooting-all-rnr-threads""]","[""23569016"", ""14216661""]",0,2,2
245200769,2,68.5,0.2550165057182312,12623926.0,2,0.5,"[""charliehebdo-all-rnr-threads"", ""ferguson-all-rnr-threads""]","[""373783051"", ""23569016""]",1,1,2
14677919,3,127.0,-0.2267815669377645,19292161.0,21,0.0,"[""charliehebdo-all-rnr-threads"", ""germanwings-crash-all-rnr-threads"", ""ferguson-all-rnr-threads""]","[""26016523"", ""713218818"", ""134106940"", ""1444790491"", ""1109685884"", ""3101709250"", ""465514030"", ""2174025815"", ""2478883562"", ""249716754"", ""312291066"", ""111319219"", ""2813685018"", ""18259520"", ""28848420"", ""2968626767"", ""404292555"", ""129636453"", ""64020370"", ""288231375"", ""14429327""]",0,3,3
38124709,3,41.0,-0.12779698769251505,12924572.0,3,0.0,"[""charliehebdo-all-rnr-threads"", ""ferguson-all-rnr-threads""]","[""18066812"", ""9890492"", ""255527829""]",0,3,3
184599763,20,115.15,-0.13855717182159427,12706454.0,3,0.0,"[""charliehebdo-all-rnr-threads"", ""ferguson-all-rnr-threads""]","[""200583835"", ""123979525"", ""382376904""]",0,20,20
462924454,2,89.0,0.00919315218925476,2119860.0,1,0.0,"[""charliehebdo-all-rnr-threads"", ""sydneysiege-all-rnr-threads""]","[""520011678""]",0,2,2
788018329,2,56.0,0.23745667934417725,5523988.0,2,0.5,"[""charliehebdo-all-rnr-threads"", ""putinmissing-all-rnr-threads""]","[""520011678"", ""635608354""]",1,1,2
255730745,14,99.78571428571429,-0.23632266691752843,12767611.0,5,0.42857142857142855,"[""charliehebdo-all-rnr-threads"", ""sydneysiege-all-rnr-threads"", ""ferguson-all-rnr-threads""]","[""16184358"", ""1269181292"", ""7768402"", ""520011678"", ""16675569""]",6,8,14
63463165,8,123.0,0.06160593777894974,6741060.0,5,0.75,"[""charliehebdo-all-rnr-threads"", ""ottawashooting-all-rnr-threads""]","[""19636948"", ""272172091"", ""19038934"", ""759251"", ""39728435""]",6,2,8
1654442893,3,110.33333333333333,-0.30200767517089844,12840229.0,2,0.0,"[""charliehebdo-all-rnr-threads"", ""ferguson-all-rnr-threads""]","[""46549541"", ""807095""]",0,3,3
1373532835,2,67.5,-0.6183289587497711,2086936.0,2,0.5,"[""charliehebdo-all-rnr-threads"", ""sydneysiege-all-rnr-threads""]","[""14173315"", ""807095""]",1,1,2
16645396,6,81.5,-0.36493266622225445,6743238.0,5,0.6666666666666666,"[""charliehebdo-all-rnr-threads"", ""ottawashooting-all-rnr-threads""]","[""47409343"", ""16184358"", ""8736882"", ""2467791"", ""203123011""]",4,2,6
1634077976,13,67.38461538461539,0.09383321725405179,19527372.0,31,0.38461538461538464,"[""charliehebdo-all-rnr-threads"", ""germanwings-crash-all-rnr-threads"", ""ferguson-all-rnr-threads""]","[""308174015"", ""26900055"", ""2249569357"", ""4207961"", ""2962279318"", ""1634077976"", ""1870811431"", ""946623726"", ""1413416460"", ""59106942"", ""26947929"", ""88494677"", ""2663033660"", ""465790247"", ""2899380339"", ""2528131686"", ""2273282888"", ""2171147042"", ""845997336"", ""34874047"", ""366538990"", ""133005157"", ""111579633"", ""2508619652"", ""954124423"", ""928053308"", ""1553039516"", ""373783051"", ""22096507"", ""228134082"", ""1924014294""]",5,8,13
2508619652,2,56.0,0.0831993818283081,6742840.0,2,0.0,"[""charliehebdo-all-rnr-threads"", ""ottawashooting-all-rnr-threads""]","[""1634077976"", ""6433472""]",0,2,2
95823753,3,115.66666666666667,-0.2598077456156413,12779666.0,2,0.0,"[""charliehebdo-all-rnr-threads"", ""ferguson-all-rnr-threads""]","[""1609475190"", ""13493302""]",0,3,3
93223589,2,143.0,-0.6150520443916321,6721054.0,2,0.5,"[""charliehebdo-all-rnr-threads"", ""ottawashooting-all-rnr-threads""]","[""24630719"", ""13493302""]",1,1,2
2580917595,17,104.05882352941177,-0.2098774839850033,2131183.0,2,0.058823529411764705,"[""charliehebdo-all-rnr-threads"", ""sydneysiege-all-rnr-threads""]","[""23818581"", ""292777349""]",1,16,17
2408067523,10,103.5,-0.38227717876434325,6830473.0,5,0.4,"[""charliehebdo-all-rnr-threads"", ""ottawashooting-all-rnr-threads"", ""sydneysiege-all-rnr-threads""]","[""4970411"", ""380648579"", ""428333"", ""53789862"", ""5402612""]",4,6,10
2164996727,8,67.0,-0.2278197780251503,2118407.0,2,0.0,"[""charliehebdo-all-rnr-threads"", ""sydneysiege-all-rnr-threads""]","[""23465218"", ""2170265940""]",0,8,8
68729028,4,90.25,-0.24352002143859863,2096092.0,3,0.0,"[""charliehebdo-all-rnr-threads"", ""sydneysiege-all-rnr-threads""]","[""94816809"", ""53044031"", ""76858507""]",0,4,4
14427663,2,105.5,-0.01981806755065918,12758973.0,2,0.0,"[""charliehebdo-all-rnr-threads"", ""ferguson-all-rnr-threads""]","[""17060020"", ""495464885""]",0,2,2
6332882,2,136.5,-0.3980829119682312,2102256.0,2,0.5,"[""charliehebdo-all-rnr-threads"", ""sydneysiege-all-rnr-threads""]","[""17060020"", ""16589206""]",1,1,2
171393117,2,112.0,-0.6750952899456024,2131099.0,2,0.0,"[""charliehebdo-all-rnr-threads"", ""sydneysiege-all-rnr-threads""]","[""16012783"", ""60937837""]",0,2,2
32189808,3,101.0,-0.4734630584716797,6694550.0,2,0.3333333333333333,"[""charliehebdo-all-rnr-threads"", ""germanwings-crash-all-rnr-threads""]","[""1630896181"", ""17561562""]",1,2,3
920277535,2,49.0,-0.49899032711982727,2131174.0,2,0.0,"[""charliehebdo-all-rnr-threads"", ""sydneysiege-all-rnr-threads""]","[""1630896181"", ""58360124""]",0,2,2
117477749,2,65.0,-0.14766061305999756,2081440.0,2,0.0,"[""charliehebdo-all-rnr-threads"", ""sydneysiege-all-rnr-threads""]","[""1263706735"", ""47685065""]",0,2,2
5988062,4,137.25,0.015178173780441284,12795870.0,35,0.0,"[""charliehebdo-all-rnr-threads"", ""sydneysiege-all-rnr-threads"", ""ferguson-all-rnr-threads""]","[""1902400610"", ""2796860460"", ""212099695"", ""149689622"", ""1000585567"", ""723049153"", ""2174951289"", ""1646380698"", ""756704442"", ""87985842"", ""290326947"", ""62818589"", ""345017819"", ""856482139"", ""36959224"", ""505592204"", ""604968039"", ""16071327"", ""2780648743"", ""700836830"", ""917988938"", ""2819572487"", ""128917051"", ""1667257460"", ""2573619805"", ""350042055"", ""156632677"", ""19867582"", ""270588444"", ""3331401"", ""467111044"", ""2404923614"", ""24367031"", ""5988062"", ""50014086""]",0,4,4
62818589,3,62.0,-0.3097987373669942,2100885.0,2,0.6666666666666666,"[""charliehebdo-all-rnr-threads"", ""sydneysiege-all-rnr-threads""]","[""2799960092"", ""5988062""]",2,1,3
50014086,25,121.24,-0.4655147433280946,12670130.0,4,0.28,"[""charliehebdo-all-rnr-threads"", ""ottawashooting-all-rnr-threads"", ""ferguson-all-rnr-threads""]","[""5988062"", ""7587032"", ""2097571"", ""8736882""]",7,18,25
114533091,2,127.0,-0.5542326867580414,2088839.0,2,0.0,"[""charliehebdo-all-rnr-threads"", ""sydneysiege-all-rnr-threads""]","[""330906573"", ""46078438""]",0,2,2
1117363285,3,115.33333333333333,-0.28941933314005536,2074971.0,2,0.0,"[""charliehebdo-all-rnr-threads"", ""sydneysiege-all-rnr-threads""]","[""1626294277"", ""64643056""]",0,3,3
53363343,2,135.5,-0.21424156427383423,2089767.0,2,0.0,"[""charliehebdo-all-rnr-threads"", ""sydneysiege-all-rnr-threads""]","[""16973333"", ""2461887810""]",0,2,2
518780169,2,109.5,0.001636505126953125,12704741.0,2,0.0,"[""charliehebdo-all-rnr-threads"", ""ferguson-all-rnr-threads""]","[""487600344"", ""7768402""]",0,2,2
5971922,3,131.66666666666666,-0.42499279975891113,12761830.0,21,0.0,"[""charliehebdo-all-rnr-threads"", ""ferguson-all-rnr-threads""]","[""118115770"", ""258551101"", ""2310314074"", ""2156961082"", ""2613825849"", ""2873434727"", ""754775250"", ""1190891329"", ""468379842"", ""251797076"", ""352394401"", ""202417232"", ""39517463"", ""117509232"", ""5971922"", ""2152748239"", ""13138812"", ""232372741"", ""35079852"", ""227827584"", ""1390847160""]",0,3,3
109986058,2,95.0,-0.514247715473175,6470331.0,2,0.5,"[""charliehebdo-all-rnr-threads"", ""germanwings-crash-all-rnr-threads""]","[""1068121346"", ""428333""]",1,1,2
16992416,11,111.9090909090909,-0.4156775582920421,2120073.0,35,0.0,"[""charliehebdo-all-rnr-threads"", ""sydneysiege-all-rnr-threads""]","[""183278249"", ""187959550"", ""189756616"", ""1138527853"", ""65679618"", ""16851641"", ""2758744286"", ""2422329920"", ""281519746"", ""846309955"", ""907057602"", ""1072596854"", ""29913890"", ""559645321"", ""2412988327"", ""2273282888"", ""45450902"", ""60933564"", ""2828640809"", ""1633495021"", ""45512762"", ""402041234"", ""632540961"", ""342737639"", ""404481715"", ""562232794"", ""574031250"", ""896400632"", ""16703058"", ""2827694780"", ""117213468"", ""1552341818"", ""397587164"", ""16992416"", ""25864669""]",0,11,11
896400632,4,118.5,-0.329591304063797,2158650.0,4,0.0,"[""charliehebdo-all-rnr-threads"", ""sydneysiege-all-rnr-threads""]","[""2566535282"", ""1717464030"", ""952112047"", ""16992416""]",0,4,4
397587164,13,127.3076923076923,-0.2704779872527489,2134310.0,2,0.0,"[""charliehebdo-all-rnr-threads"", ""sydneysiege-all-rnr-threads""]","[""7587032"", ""16992416""]",0,13,13
76376399,2,59.5,0.49244487285614014,2065418.0,2,0.0,"[""charliehebdo-all-rnr-threads"", ""sydneysiege-all-rnr-threads""]","[""1717464030"", ""1379288282""]",0,2,2
2193094410,5,114.2,-0.3635767936706543,12803292.0,4,0.0,"[""charliehebdo-all-rnr-threads"", ""ottawashooting-all-rnr-threads"", ""ferguson-all-rnr-threads""]","[""193725962"", ""18560045"", ""1379288282"", ""584797578""]",0,5,5
2552698171,2,61.5,-0.19967791438102722,2131859.0,2,0.5,"[""charliehebdo-all-rnr-threads"", ""sydneysiege-all-rnr-threads""]","[""15438913"", ""1367531""]",1,1,2
505309269,2,123.5,-0.5488787293434143,6722578.0,2,0.5,"[""charliehebdo-all-rnr-threads"", ""ottawashooting-all-rnr-threads""]","[""15438913"", ""249339016""]",1,1,2
310016294,2,118.5,-0.386196494102478,5629448.0,2,0.0,"[""charliehebdo-all-rnr-threads"", ""putinmissing-all-rnr-threads""]","[""15438913"", ""28784606""]",0,2,2
109065990,7,119.57142857142857,-0.44069543906620573,12789707.0,60,0.0,"[""charliehebdo-all-rnr-threads"", ""ottawashooting-all-rnr-threads"", ""ferguson-all-rnr-threads""]","[""216798210"", ""787739868"", ""250084743"", ""2370914096"", ""948589416"", ""905019768"", ""383583763"", ""87558021"", ""25476815"", ""451610568"", ""1717016598"", ""1483418840"", ""2490105806"", ""110499349"", ""25100452"", ""1634128746"", ""359237331"", ""391741335"", ""112233246"", ""250338868"", ""2828697281"", ""109065990"", ""2152439431"", ""2256985338"", ""2732943264"", ""2902209786"", ""252694579"", ""58649310"", ""1023332719"", ""2826907218"", ""82800655"", ""390576798"", ""279683174"", ""538765846"", ""14305940"", ""2369318622"", ""1337411749"", ""804917785"", ""492957533"", ""2244943075"", ""449298797"", ""24787367"", ""471484737"", ""156772733"", ""2889295276"", ""115217320"", ""155602260"", ""529147778"", ""1000036514"", ""15549747"", ""23302751"", ""116081213"", ""1739650556"", ""39456357"", ""305259854"", ""2773566528"", ""494822288"", ""131596986"", ""75682950"", ""28672653""]",0,7,7
2582427774,5,68.0,-0.5726097583770752,6360208.0,4,0.8,"[""charliehebdo-all-rnr-threads"", ""germanwings-crash-all-rnr-threads""]","[""2566535282"", ""87416722"", ""454099919"", ""2097571""]",4,1,5
543529717,2,134.0,-0.33026742935180664,6462962.0,2,0.0,"[""charliehebdo-all-rnr-threads"", ""germanwings-crash-all-rnr-threads""]","[""275686563"", ""3108351""]",0,2,2
2918068353,2,78.5,-0.6521764993667603,6728183.0,2,0.5,"[""charliehebdo-all-rnr-threads"", ""germanwings-crash-all-rnr-threads""]","[""275686563"", ""3022045469""]",1,1,2
18655567,2,136.5,-0.3603479266166687,12621290.0,16,0.5,"[""charliehebdo-all-rnr-threads"", ""ferguson-all-rnr-threads""]","[""59815635"", ""2962701754"", ""196341304"", ""1074436872"", ""310581147"", ""954391770"", ""149938650"", ""2920093727"", ""793346330"", ""1748080555"", ""2400634020"", ""2747150550"", ""65709071"", ""67221594"", ""2892349024"", ""788481151""]",1,1,2
793346330,2,116.0,-0.1724696159362793,12808999.0,2,0.0,"[""charliehebdo-all-rnr-threads"", ""ferguson-all-rnr-threads""]","[""53503202"", ""18655567""]",0,2,2
21043723,4,57.25,-0.2193177044391632,13058270.0,4,0.25,"[""charliehebdo-all-rnr-threads"", ""ferguson-all-rnr-threads""]","[""12004852"", ""15754281"", ""379481082"", ""807095""]",1,3,4
348301649,5,106.4,0.004370343685150146,12612820.0,2,0.0,"[""charliehebdo-all-rnr-threads"", ""ferguson-all-rnr-threads""]","[""5695632"", ""19259102""]",0,5,5
2856694188,2,136.0,-0.6283598244190216,2100792.0,2,0.0,"[""charliehebdo-all-rnr-threads"", ""sydneysiege-all-rnr-threads""]","[""852269288"", ""20159596""]",0,2,2
26302594,7,91.28571428571429,-0.22025309290204728,12627778.0,4,0.0,"[""charliehebdo-all-rnr-threads"", ""sydneysiege-all-rnr-threads"", ""ferguson-all-rnr-threads""]","[""225235528"", ""40962194"", ""366066427"", ""807095""]",0,7,7
2912429401,10,76.7,-0.44420798420906066,2149801.0,4,0.2,"[""charliehebdo-all-rnr-threads"", ""sydneysiege-all-rnr-threads""]","[""407871140"", ""5402612"", ""7309052"", ""807095""]",2,8,10
44361097,24,95.33333333333333,-0.3199661423762639,12853815.0,39,0.0,"[""charliehebdo-all-rnr-threads"", ""ferguson-all-rnr-threads""]","[""228089048"", ""844057104"", ""93974172"", ""338968012"", ""416663701"", ""49245107"", ""1396857223"", ""482628166"", ""331105666"", ""67568556"", ""2396886176"", ""243323309"", ""412408929"", ""477683306"", ""368532118"", ""1941264979"", ""7768402"", ""2572556132"", ""324585833"", ""1361446477"", ""1670968050"", ""44361097"", ""372611338"", ""2711017410"", ""1615736210"", ""611949393"", ""351203752"", ""543228444"", ""50027047"", ""187245170"", ""217841225"", ""417560239"", ""2881168789"", ""359406750"", ""15754478"", ""318435893"", ""26841676"", ""33151368"", ""269494951""]",0,24,24
368196789,3,76.33333333333333,0.228572408358256,12829559.0,16,0.0,"[""charliehebdo-all-rnr-threads"", ""ferguson-all-rnr-threads""]","[""368196789"", ""107822040"", ""404460410"", ""291318651"", ""32764473"", ""18117617"", ""246054283"", ""461221248"", ""1509803635"", ""92486613"", ""39347474"", ""2740533298"", ""2727897656"", ""2893772003"", ""802446223"", ""2402972599""]",0,3,3
2252890903,37,112.72972972972973,0.11389993332527779,13198257.0,6,0.5675675675675675,"[""charliehebdo-all-rnr-threads"", ""germanwings-crash-all-rnr-threads"", ""ottawashooting-all-rnr-threads"", ""sydneysiege-all-rnr-threads""]","[""9624742"", ""14224719"", ""3108351"", ""428333"", ""17001435"", ""5402612""]",21,16,37
81305054,3,118.66666666666667,-0.728225588798523,8547802.0,36,0.3333333333333333,"[""charliehebdo-all-rnr-threads"", ""germanwings-crash-all-rnr-threads"", ""sydneysiege-all-rnr-threads""]","[""103079525"", ""1089688345"", ""26209222"", ""57366399"", ""44071849"", ""2281169706"", ""618893366"", ""1058096088"", ""2273636460"", ""51094429"", ""1693392673"", ""2257993742"", ""216110913"", ""3101709250"", ""153277522"", ""2988953009"", ""1727008657"", ""2457119346"", ""417862376"", ""2411925429"", ""633371822"", ""584122311"", ""248620495"", ""2919587314"", ""1890349608"", ""918865729"", ""2759447897"", ""365955722"", ""2514132154"", ""573856841"", ""1656989522"", ""121082517"", ""1662249475"", ""16660006"", ""563591448"", ""591868225""]",1,2,3
18441335,3,112.33333333333333,-0.3352506160736084,2175468.0,2,0.0,"[""charliehebdo-all-rnr-threads"", ""sydneysiege-all-rnr-threads""]","[""33315010"", ""38123342""]",0,3,3
452172857,5,132.0,-0.07518692016601562,13087012.0,2,0.0,"[""charliehebdo-all-rnr-threads"", ""ferguson-all-rnr-threads""]","[""16012783"", ""14090948""]",0,5,5
1220360485,13,109.23076923076923,-0.34072763186234695,7045360.0,2,0.0,"[""charliehebdo-all-rnr-threads"", ""ottawashooting-all-rnr-threads""]","[""16012783"", ""51241574""]",0,13,13
134196350,19,123.52631578947368,-0.2678132841461583,6438339.0,237,0.3684210526315789,"[""charliehebdo-all-rnr-threads"", ""germanwings-crash-all-rnr-threads""]","[""394155302"", ""2870871435"", ""396890769"", ""190624049"", ""506278413"", ""579092746"", ""1679446832"", ""108577840"", ""269190942"", ""39086886"", ""563413317"", ""81132822"", ""2929341712"", ""91208242"", ""416352474"", ""247324712"", ""380292534"", ""166943853"", ""928638726"", ""152171256"", ""2821083209"", ""369977629"", ""345246348"", ""322298346"", ""2261651430"", ""295510001"", ""369100270"", ""1831434540"", ""3114712289"", ""2957556713"", ""162432531"", ""134196350"", ""847440853"", ""825718544"", ""405683625"", ""582187936"", ""1735171"", ""212366011"", ""19592724"", ""21627425"", ""22949618"", ""219470552"", ""19103793"", ""3084667744"", ""196591040"", ""2318054241"", ""610829574"", ""15687408"", ""3021822897"", ""114421715"", ""6575472"", ""2540899814"", ""89191401"", ""244321352"", ""10007522"", ""48032974"", ""1636464877"", ""2601948929"", ""228997458"", ""19704528"", ""180747828"", ""389539490"", ""20983376"", ""1622201040"", ""279255938"", ""432914039"", ""2966128480"", ""223985013"", ""395240033"", ""2796143326"", ""193558656"", ""20060474"", ""2472403826"", ""2459278543"", ""1107268454"", ""953958546"", ""62330401"", ""43553304"", ""728867184"", ""2705950254"", ""10427392"", ""17618786"", ""543154591"", ""1415396743"", ""334811270"", ""2159724111"", ""221384440"", ""17705511"", ""16441545"", ""14921092"", ""45397823"", ""271526736"", ""2695297518"", ""312790086"", ""52064239"", ""240279011"", ""372257840"", ""51575486"", ""78378685"", ""7432222"", ""29883618"", ""35684829"", ""139631790"", ""1541989867"", ""2729887797"", ""231140504"", ""49562311"", ""73180846"", ""15817213"", ""132275243"", ""600943942"", ""104276976"", ""228102184"", ""320228774"", ""143527839"", ""277034268"", ""469131974"", ""422630773"", ""248816974"", ""951272851"", ""1912284924"", ""556503810"", ""789014144"", ""22395404"", ""244134922"", ""59630847"", ""189053479"", ""2640788234"", ""465565189"", ""135886035"", ""7743542"", ""280922341"", ""89186339"", ""39495524"", ""52065935"", ""2303621388"", ""368561400"", ""576499459"", ""3079475403"", ""58449246"", ""77734437"", ""15016162"", ""526795556"", ""33083887"", ""270390078"", ""230681000"", ""2292613654"", ""220521994"", ""20231840"", ""2434159284"", ""15148343"", ""48612569"", ""18581038"", ""19067011"", ""43878918"", ""186445670"", ""82731503"", ""435800441"", ""41433466"", ""307228640"", ""91828494"", ""1468401108"", ""22069271"", ""599473774"", ""17196743"", ""150385397"", ""2556353232"", ""522549589"", ""15902347"", ""2366616593"", ""39472172"", ""15605776"", ""153379916"", ""44873648"", ""12929322"", ""20637969"", ""281591919"", ""182476548"", ""1662639104"", ""31190470"", ""225071446"", ""125139513"", ""32202559"", ""2906321806"", ""450614775"", ""476243412"", ""2198217702"", ""2797706837"", ""303367555"", ""320760982"", ""18015844"", ""220139590"", ""390830392"", ""1245499735"", ""191701613"", ""41351193"", ""897485071"", ""63478437"", ""543634523"", ""16743832"", ""27618702"", ""198123914"", ""2900807218"", ""481418510"", ""19568011"", ""492535102"", ""805414416"", ""55790155"", ""20159596"", ""18863590"", ""390564179"", ""119129371"", ""347511105"", ""2201655457"", ""576106730"", ""223469011"", ""175333468"", ""132512167"", ""1082410501"", ""517388640"", ""27589515"", ""47071301"", ""293420884"", ""2771463148"", ""39252761"", ""3035193311"", ""14790135"", ""809042136"", ""2169512643"", ""193770843"", ""15988842"", ""102797434"", ""347272430"", ""296303544"", ""20749160"", ""273718425"", ""242810893""]",7,12,19
711719886,3,137.33333333333334,-0.6958012580871582,13223774.0,2,0.0,"[""charliehebdo-all-rnr-threads"", ""ferguson-all-rnr-threads""]","[""2315411725"", ""23831448""]",0,3,3
578919489,3,75.33333333333333,-0.10091298818588257,2141763.0,3,0.3333333333333333,"[""charliehebdo-all-rnr-threads"", ""sydneysiege-all-rnr-threads""]","[""292777349"", ""103245739"", ""292765961""]",1,2,3
1667055776,2,47.5,0.23751956224441528,2176420.0,2,0.0,"[""charliehebdo-all-rnr-threads"", ""sydneysiege-all-rnr-threads""]","[""162304163"", ""292765961""]",0,2,2
238575113,11,121.63636363636364,-0.16354554891586304,2188121.0,103,0.09090909090909091,"[""charliehebdo-all-rnr-threads"", ""sydneysiege-all-rnr-threads""]","[""165738461"", ""622470327"", ""2478979537"", ""172224174"", ""56928675"", ""2864513751"", ""567193275"", ""1198665894"", ""18025958"", ""1709543934"", ""15900982"", ""358506497"", ""2647566577"", ""2832061728"", ""1159538076"", ""179113074"", ""499436238"", ""2868618635"", ""2263201122"", ""1189316166"", ""56018585"", ""1893224126"", ""59402289"", ""1892743464"", ""56306569"", ""43089397"", ""2693028200"", ""173003749"", ""517688173"", ""2196766572"", ""2163076560"", ""130668639"", ""120971922"", ""35742815"", ""96972731"", ""101392537"", ""363010394"", ""786616838"", ""2262932935"", ""2284965018"", ""51486226"", ""1547364434"", ""1416347076"", ""1408458926"", ""98339267"", ""15688113"", ""64062322"", ""2208005863"", ""1576286196"", ""174313621"", ""56363520"", ""402546243"", ""1928479412"", ""17871279"", ""78272041"", ""588177972"", ""1592926764"", ""20167195"", ""1302169776"", ""32339623"", ""1223352072"", ""2558099150"", ""149770065"", ""2345994319"", ""396796839"", ""125323374"", ""39979596"", ""2336670397"", ""238575113"", ""98141307"", ""1269908395"", ""1018684608"", ""175626751"", ""255807625"", ""1253927575"", ""2271035214"", ""1337777035"", ""131417314"", ""20292607"", ""2615670872"", ""2785717076"", ""2253189972"", ""20013397"", ""19346439"", ""19111502"", ""975220500"", ""2536803352"", ""18785429"", ""904873177"", ""366538990"", ""2350935702"", ""175452918"", ""2842870973"", ""474745988"", ""1850925216"", ""84440344"", ""28197830"", ""126176821"", ""545726041"", ""1978253712"", ""44082577"", ""2318356536"", ""1276177524""]",1,10,11
149770065,2,126.5,-0.4649181365966797,2172246.0,2,0.0,"[""charliehebdo-all-rnr-threads"", ""sydneysiege-all-rnr-threads""]","[""18101696"", ""238575113""]",0,2,2
1592926764,2,115.5,0.14158254861831665,2223552.0,2,0.0,"[""charliehebdo-all-rnr-threads"", ""sydneysiege-all-rnr-threads""]","[""78586909"", ""238575113""]",0,2,2
2271035214,11,86.54545454545455,-0.1549091013995084,2236569.0,14,0.2727272727272727,"[""charliehebdo-all-rnr-threads"", ""sydneysiege-all-rnr-threads""]","[""475492463"", ""1418377147"", ""93337348"", ""1375717166"", ""527264765"", ""238575113"", ""2336713098"", ""459157501"", ""23916763"", ""413624285"", ""2807389429"", ""262040253"", ""2271035214"", ""244337006""]",3,8,11
139659661,6,106.33333333333333,-0.15642093618710837,2191839.0,2,0.0,"[""charliehebdo-all-rnr-threads"", ""sydneysiege-all-rnr-threads""]","[""270569708"", ""1920286333""]",0,6,6
561427595,15,84.93333333333334,-0.24144556125005087,13161788.0,2,0.0,"[""charliehebdo-all-rnr-threads"", ""ferguson-all-rnr-threads""]","[""87818409"", ""23831448""]",0,15,15
2574072036,2,139.5,-0.5518637597560883,2137433.0,35,0.0,"[""charliehebdo-all-rnr-threads"", ""sydneysiege-all-rnr-threads""]","[""77602866"", ""86302457"", ""142195258"", ""73321397"", ""119306992"", ""50619514"", ""761638963"", ""108348577"", ""52343977"", ""191376204"", ""90821118"", ""18687794"", ""1531465705"", ""147867506"", ""79802631"", ""2549309472"", ""361113541"", ""116447689"", ""782143255"", ""113072221"", ""306824900"", ""71504313"", ""14300066"", ""45118903"", ""62024538"", ""132001724"", ""335246965"", ""1207093476"", ""389491470"", ""230347081"", ""28775598"", ""308329253"", ""80330381"", ""405502862"", ""21643419""]",0,2,2
77602866,5,112.2,-0.4281893491744995,8767753.0,3,0.6,"[""charliehebdo-all-rnr-threads"", ""germanwings-crash-all-rnr-threads"", ""sydneysiege-all-rnr-threads""]","[""99034397"", ""268676434"", ""2574072036""]",3,2,5
89570289,2,120.5,-0.5808857679367065,2189023.0,2,0.5,"[""charliehebdo-all-rnr-threads"", ""sydneysiege-all-rnr-threads""]","[""19017675"", ""27831488""]",1,1,2
1562847648,4,109.0,0.060129761695861816,2164633.0,2,0.0,"[""charliehebdo-all-rnr-threads"", ""sydneysiege-all-rnr-threads""]","[""19017675"", ""14224719""]",0,4,4
1397423635,24,109.54166666666667,-0.3744734426339467,2190439.0,5,0.0,"[""charliehebdo-all-rnr-threads"", ""sydneysiege-all-rnr-threads""]","[""60022825"", ""19017675"", ""64643056"", ""1960878613"", ""16343974""]",0,24,24
354914590,9,46.22222222222222,-0.08878516488605076,12821753.0,2,0.0,"[""charliehebdo-all-rnr-threads"", ""ferguson-all-rnr-threads""]","[""19017675"", ""183341278""]",0,9,9
548133519,10,97.4,-0.5619768619537353,13364366.0,3,0.0,"[""charliehebdo-all-rnr-threads"", ""ferguson-all-rnr-threads""]","[""19017675"", ""40997767"", ""5513002""]",0,10,10
23626411,2,116.0,-0.5938991010189056,12701928.0,2,0.0,"[""charliehebdo-all-rnr-threads"", ""ferguson-all-rnr-threads""]","[""214205356"", ""14293310""]",0,2,2
108959881,2,82.0,-0.17015618085861206,12748020.0,2,0.0,"[""charliehebdo-all-rnr-threads"", ""ferguson-all-rnr-threads""]","[""279390084"", ""46335511""]",0,2,2
526244601,2,122.0,-0.2363419532775879,2167050.0,2,0.0,"[""charliehebdo-all-rnr-threads"", ""sydneysiege-all-rnr-threads""]","[""85794542"", ""742143""]",0,2,2
769754899,15,135.79999999999998,-0.44890708128611245,12962628.0,2,0.0,"[""charliehebdo-all-rnr-threads"", ""ferguson-all-rnr-threads""]","[""65698096"", ""2257598532""]",0,15,15
2758107898,2,114.0,-0.2789720892906189,2193413.0,2,0.5,"[""charliehebdo-all-rnr-threads"", ""sydneysiege-all-rnr-threads""]","[""142696824"", ""162304163""]",1,1,2
2823532027,3,45.333333333333336,0.0817811091740926,2180962.0,2,0.3333333333333333,"[""charliehebdo-all-rnr-threads"", ""sydneysiege-all-rnr-threads""]","[""18424289"", ""742143""]",1,2,3
23698809,3,98.33333333333333,0.0602653423945109,2151950.0,2,0.6666666666666666,"[""charliehebdo-all-rnr-threads"", ""sydneysiege-all-rnr-threads""]","[""18424289"", ""464311706""]",2,1,3
2292748574,5,103.2,-0.25096309185028076,5524002.0,2,0.4,"[""charliehebdo-all-rnr-threads"", ""putinmissing-all-rnr-threads""]","[""358204197"", ""988324790""]",2,3,5
2274145332,3,93.33333333333333,0.27249828974405926,6797321.0,2,0.0,"[""charliehebdo-all-rnr-threads"", ""ottawashooting-all-rnr-threads""]","[""19636948"", ""2163076560""]",0,3,3
2478979537,4,78.0,0.019184157252311707,6525259.0,3,0.0,"[""charliehebdo-all-rnr-threads"", ""ottawashooting-all-rnr-threads"", ""sydneysiege-all-rnr-threads""]","[""838673408"", ""51241574"", ""238575113""]",0,4,4
1215763321,4,120.25,-0.4858575016260147,2190257.0,4,0.25,"[""charliehebdo-all-rnr-threads"", ""sydneysiege-all-rnr-threads""]","[""838673408"", ""28785486"", ""87818409"", ""16811829""]",1,3,4
1196986207,2,142.0,-0.8570196032524109,6408452.0,2,0.0,"[""charliehebdo-all-rnr-threads"", ""germanwings-crash-all-rnr-threads""]","[""16343974"", ""292777349""]",0,2,2
16437620,3,97.0,-0.35668762524922687,13167102.0,3,0.0,"[""charliehebdo-all-rnr-threads"", ""ferguson-all-rnr-threads""]","[""24165761"", ""14831475"", ""58""]",0,3,3
238647436,2,100.0,0.38143783807754517,12873102.0,2,0.0,"[""charliehebdo-all-rnr-threads"", ""ferguson-all-rnr-threads""]","[""18018877"", ""1381926373""]",0,2,2
522132942,5,80.8,-0.37001957893371584,2221466.0,2,0.0,"[""charliehebdo-all-rnr-threads"", ""sydneysiege-all-rnr-threads""]","[""69231187"", ""282977213""]",0,5,5
373528975,13,96.15384615384616,-0.5713658653772794,2165382.0,2,0.0,"[""charliehebdo-all-rnr-threads"", ""sydneysiege-all-rnr-threads""]","[""69231187"", ""1562935142""]",0,13,13
103245739,2,140.0,-0.6246627271175385,2165180.0,35,0.0,"[""charliehebdo-all-rnr-threads"", ""sydneysiege-all-rnr-threads""]","[""106319256"", ""767479848"", ""1962277789"", ""427251938"", ""2418740916"", ""165365811"", ""1103760043"", ""65877282"", ""369438749"", ""136271388"", ""783951558"", ""781011324"", ""2375124864"", ""144181012"", ""365441846"", ""1111615790"", ""2303386854"", ""17675283"", ""2416973881"", ""753316309"", ""583872072"", ""578919489"", ""108005160"", ""134034277"", ""1628683939"", ""1693779254"", ""2534074718"", ""2610724536"", ""2556084846"", ""83609838"", ""226553297"", ""2875043466"", ""2208873193"", ""267646266"", ""153590033""]",0,2,2
1962277789,2,71.0,-0.153273344039917,6802864.0,2,0.0,"[""charliehebdo-all-rnr-threads"", ""ottawashooting-all-rnr-threads""]","[""34310801"", ""103245739""]",0,2,2
52990482,6,113.66666666666667,-0.18985188007354736,2196406.0,18,0.16666666666666666,"[""charliehebdo-all-rnr-threads"", ""sydneysiege-all-rnr-threads""]","[""126335481"", ""28279637"", ""100899006"", ""115393565"", ""1656622657"", ""141102947"", ""77695588"", ""356802712"", ""1214894034"", ""1471931208"", ""52990482"", ""617682189"", ""25777812"", ""2524146902"", ""1103760043"", ""1540654248"", ""1867348423"", ""1617261140""]",1,5,6
851896567,2,107.0,-0.21740418672561646,2138731.0,2,0.0,"[""charliehebdo-all-rnr-threads"", ""sydneysiege-all-rnr-threads""]","[""28785486"", ""428333""]",0,2,2
68397297,2,77.5,0.03248465061187744,2196339.0,2,0.5,"[""charliehebdo-all-rnr-threads"", ""sydneysiege-all-rnr-threads""]","[""14569869"", ""428333""]",1,1,2
800787145,2,81.5,-0.4077109694480896,6809923.0,2,0.5,"[""charliehebdo-all-rnr-threads"", ""ottawashooting-all-rnr-threads""]","[""8736882"", ""14095052""]",1,1,2
280495086,7,91.14285714285714,-0.1718337024961199,2171044.0,2,0.8571428571428571,"[""charliehebdo-all-rnr-threads"", ""sydneysiege-all-rnr-threads""]","[""742143"", ""14095052""]",6,1,7
2891662632,2,84.5,0.034970998764038086,2163509.0,2,0.0,"[""charliehebdo-all-rnr-threads"", ""sydneysiege-all-rnr-threads""]","[""87818409"", ""99238190""]",0,2,2
330507395,3,123.66666666666667,-0.5017509857813517,2163090.0,2,0.0,"[""charliehebdo-all-rnr-threads"", ""sydneysiege-all-rnr-threads""]","[""6473022"", ""22092333""]",0,3,3
5854302,9,103.77777777777777,-0.35162127680248684,12904991.0,5,0.1111111111111111,"[""charliehebdo-all-rnr-threads"", ""ottawashooting-all-rnr-threads"", ""ferguson-all-rnr-threads"", ""sydneysiege-all-rnr-threads""]","[""343082774"", ""103065157"", ""10876852"", ""16753407"", ""27453886""]",1,8,9
460623393,5,80.4,-0.13839470148086547,2220044.0,3,0.2,"[""charliehebdo-all-rnr-threads"", ""sydneysiege-all-rnr-threads""]","[""615112213"", ""64643056"", ""9609632""]",1,4,5
271033788,3,138.0,-0.5147957603136698,2179122.0,2,0.0,"[""charliehebdo-all-rnr-threads"", ""sydneysiege-all-rnr-threads""]","[""20043786"", ""268866184""]",0,3,3
427655976,4,123.75,-0.2733951807022095,13318806.0,2,0.25,"[""charliehebdo-all-rnr-threads"", ""ferguson-all-rnr-threads""]","[""414488432"", ""268866184""]",1,3,4
1360852878,8,108.25,0.07499223947525024,2164363.0,2,0.0,"[""charliehebdo-all-rnr-threads"", ""sydneysiege-all-rnr-threads""]","[""14287669"", ""24062457""]",0,8,8
2910413544,3,77.66666666666667,-0.19438509146372476,6391520.0,3,0.0,"[""charliehebdo-all-rnr-threads"", ""germanwings-crash-all-rnr-threads""]","[""1375289149"", ""546749928"", ""759251""]",0,3,3
608804472,2,31.5,0.1548781394958496,2315914.0,2,0.5,"[""charliehebdo-all-rnr-threads"", ""sydneysiege-all-rnr-threads""]","[""20639175"", ""31351557""]",1,1,2
244200716,4,85.25,-0.27640484273433685,12700887.0,3,0.0,"[""charliehebdo-all-rnr-threads"", ""sydneysiege-all-rnr-threads"", ""ferguson-all-rnr-threads""]","[""254873869"", ""937696388"", ""130778462""]",0,4,4
153531949,3,59.0,-0.25019049644470215,12868453.0,3,0.3333333333333333,"[""charliehebdo-all-rnr-threads"", ""ferguson-all-rnr-threads""]","[""195271137"", ""270412323"", ""130778462""]",1,2,3
216202571,9,117.55555555555556,-0.4495117465655009,2225086.0,3,0.4444444444444444,"[""charliehebdo-all-rnr-threads"", ""sydneysiege-all-rnr-threads""]","[""1399909376"", ""35051304"", ""167494843""]",4,5,9
516065423,2,112.5,0.43590247631073,12759790.0,2,0.0,"[""charliehebdo-all-rnr-threads"", ""ferguson-all-rnr-threads""]","[""101848151"", ""167494843""]",0,2,2
18535471,2,106.0,-0.32099786400794983,12841009.0,2,0.0,"[""charliehebdo-all-rnr-threads"", ""ferguson-all-rnr-threads""]","[""36252186"", ""42921216""]",0,2,2
2400408805,8,97.75,-0.4793775603175163,13378615.0,6,0.875,"[""charliehebdo-all-rnr-threads"", ""germanwings-crash-all-rnr-threads"", ""ottawashooting-all-rnr-threads""]","[""8736882"", ""51241574"", ""2097571"", ""12848262"", ""22930902"", ""232235048""]",7,1,8
14460241,5,117.0,-0.18674170970916748,7648827.0,48,0.8,"[""charliehebdo-all-rnr-threads"", ""putinmissing-all-rnr-threads"", ""sydneysiege-all-rnr-threads""]","[""152230489"", ""504866726"", ""15631357"", ""166420823"", ""190101068"", ""32491529"", ""488309364"", ""110807429"", ""247981000"", ""408241447"", ""728048323"", ""16058280"", ""884202938"", ""142838995"", ""2265151616"", ""2744227350"", ""420837942"", ""2377011036"", ""311022831"", ""2638107556"", ""2845798764"", ""198629198"", ""29226134"", ""316364374"", ""2715760431"", ""156306739"", ""43533997"", ""1249746145"", ""251643204"", ""23561477"", ""298532531"", ""155923543"", ""165947913"", ""31059230"", ""25202268"", ""14460241"", ""129024290"", ""893046055"", ""2484888469"", ""32364630"", ""85737977"", ""337096297"", ""416291420"", ""25981978"", ""336344015"", ""2833082389"", ""1449711066"", ""41378087""]",4,1,5
23561477,2,100.5,0.4478633403778076,2181396.0,2,0.0,"[""charliehebdo-all-rnr-threads"", ""sydneysiege-all-rnr-threads""]","[""14460241"", ""86753745""]",0,2,2
728048323,2,137.0,-0.39265650510787964,12695292.0,2,0.5,"[""charliehebdo-all-rnr-threads"", ""ferguson-all-rnr-threads""]","[""14460241"", ""15220768""]",1,1,2
2833082389,3,111.66666666666667,0.09572827816009521,2250772.0,3,0.3333333333333333,"[""charliehebdo-all-rnr-threads"", ""sydneysiege-all-rnr-threads""]","[""16675569"", ""14460241"", ""17668544""]",1,2,3
294203824,8,94.625,-0.15238185226917267,2190416.0,2,0.0,"[""charliehebdo-all-rnr-threads"", ""sydneysiege-all-rnr-threads""]","[""2160653996"", ""162304163""]",0,8,8
392340964,16,121.50000000000001,-0.12314987927675247,2161562.0,2,0.0,"[""charliehebdo-all-rnr-threads"", ""sydneysiege-all-rnr-threads""]","[""1562935142"", ""807095""]",0,16,16
1952614448,4,90.0,-0.4668475091457367,2180081.0,3,0.5,"[""charliehebdo-all-rnr-threads"", ""sydneysiege-all-rnr-threads""]","[""17537467"", ""2097571"", ""807095""]",2,2,4
352939772,2,40.5,0.21130883693695068,6817961.0,2,0.0,"[""charliehebdo-all-rnr-threads"", ""ottawashooting-all-rnr-threads""]","[""443146128"", ""204832963""]",0,2,2
1334459611,2,38.5,-0.5705348551273346,2195795.0,2,0.0,"[""charliehebdo-all-rnr-threads"", ""sydneysiege-all-rnr-threads""]","[""153029181"", ""204089551""]",0,2,2
567240884,2,63.5,-0.38891932368278503,2204040.0,2,0.0,"[""charliehebdo-all-rnr-threads"", ""sydneysiege-all-rnr-threads""]","[""250603308"", ""24187097""]",0,2,2
525452610,5,99.0,-0.5475215911865234,12872608.0,3,0.2,"[""charliehebdo-all-rnr-threads"", ""ferguson-all-rnr-threads""]","[""11265832"", ""24187097"", ""158426909""]",1,4,5
2416973881,3,116.66666666666667,-0.3355027635892232,2176412.0,3,0.0,"[""charliehebdo-all-rnr-threads"", ""sydneysiege-all-rnr-threads""]","[""103245739"", ""47685065"", ""1073676020""]",0,3,3
431686303,3,46.666666666666664,0.05396378040313721,8573787.0,3,0.3333333333333333,"[""charliehebdo-all-rnr-threads"", ""germanwings-crash-all-rnr-threads"", ""sydneysiege-all-rnr-threads""]","[""52557443"", ""292777349"", ""1073676020""]",1,2,3
497537643,2,57.5,-0.3764508366584778,2191439.0,2,0.5,"[""charliehebdo-all-rnr-threads"", ""sydneysiege-all-rnr-threads""]","[""780024367"", ""64643056""]",1,1,2
615331081,11,115.18181818181819,-0.431946646083485,12949005.0,2,0.0,"[""charliehebdo-all-rnr-threads"", ""ferguson-all-rnr-threads""]","[""1379288282"", ""937696388""]",0,11,11
2327615780,3,48.333333333333336,-0.1645271380742391,6740025.0,3,0.0,"[""charliehebdo-all-rnr-threads"", ""ottawashooting-all-rnr-threads"", ""sydneysiege-all-rnr-threads""]","[""2260706071"", ""952112047"", ""1379288282""]",0,3,3
83182871,2,54.5,-0.0916900634765625,2154833.0,2,0.0,"[""charliehebdo-all-rnr-threads"", ""sydneysiege-all-rnr-threads""]","[""1626294277"", ""47685065""]",0,2,2
369181340,3,96.66666666666667,0.3213958740234375,6391320.0,2,0.3333333333333333,"[""charliehebdo-all-rnr-threads"", ""germanwings-crash-all-rnr-threads""]","[""7587032"", ""1379288282""]",1,2,3
798442806,2,127.5,0.5512656569480896,12917509.0,2,0.0,"[""charliehebdo-all-rnr-threads"", ""ferguson-all-rnr-threads""]","[""21998314"", ""14090948""]",0,2,2
524159710,5,65.2,-0.4062751293182373,2278387.0,2,0.0,"[""charliehebdo-all-rnr-threads"", ""sydneysiege-all-rnr-threads""]","[""299734653"", ""28785486""]",0,5,5
2685926647,3,85.33333333333333,-0.3516644438107808,2199529.0,3,0.0,"[""charliehebdo-all-rnr-threads"", ""sydneysiege-all-rnr-threads""]","[""1663752234"", ""3108351"", ""1662016292""]",0,3,3
2836941830,2,133.5,-0.5709404051303864,2179816.0,21,0.5,"[""charliehebdo-all-rnr-threads"", ""sydneysiege-all-rnr-threads""]","[""1030435626"", ""2205992556"", ""2237549338"", ""33857678"", ""275450877"", ""532299353"", ""495328347"", ""2330136229"", ""2931709299"", ""2462310905"", ""1288199940"", ""1054320426"", ""2191434150"", ""86394645"", ""97854720"", ""281846298"", ""36631460"", ""2786512625"", ""2959360301"", ""2942220232"", ""13003922""]",1,1,2
824328062,2,49.5,-0.4243898391723633,12685790.0,2,0.0,"[""charliehebdo-all-rnr-threads"", ""ferguson-all-rnr-threads""]","[""236488883"", ""2836421""]",0,2,2
5501422,2,66.0,-0.03255176544189453,2206668.0,2,0.5,"[""charliehebdo-all-rnr-threads"", ""sydneysiege-all-rnr-threads""]","[""1056552596"", ""64643056""]",1,1,2
318691517,6,92.5,-0.4656903147697449,2168271.0,2,0.8333333333333334,"[""charliehebdo-all-rnr-threads"", ""sydneysiege-all-rnr-threads""]","[""742143"", ""64643056""]",5,1,6
104341080,5,111.4,-0.17168956995010376,2200462.0,2,0.0,"[""charliehebdo-all-rnr-threads"", ""sydneysiege-all-rnr-threads""]","[""18435601"", ""93766096""]",0,5,5
2206788811,7,131.57142857142858,-0.2923374857221331,2380993.0,2,0.14285714285714285,"[""charliehebdo-all-rnr-threads"", ""sydneysiege-all-rnr-threads""]","[""20639175"", ""93766096""]",1,6,7
33874101,7,108.14285714285714,-0.3712467466081892,2257893.0,2,0.0,"[""charliehebdo-all-rnr-threads"", ""sydneysiege-all-rnr-threads""]","[""93766096"", ""818212956""]",0,7,7
65212833,3,130.33333333333334,-0.25653239091237384,2303836.0,2,0.0,"[""charliehebdo-all-rnr-threads"", ""sydneysiege-all-rnr-threads""]","[""16725276"", ""93766096""]",0,3,3
1421542783,2,131.0,0.07273513078689575,2278900.0,2,0.0,"[""charliehebdo-all-rnr-threads"", ""sydneysiege-all-rnr-threads""]","[""254873869"", ""93766096""]",0,2,2
94185085,2,108.5,-0.3950912356376648,2248602.0,2,0.0,"[""charliehebdo-all-rnr-threads"", ""sydneysiege-all-rnr-threads""]","[""17995040"", ""93766096""]",0,2,2
15224867,2,118.0,0.0537295937538147,6790067.0,38,0.0,"[""charliehebdo-all-rnr-threads"", ""ottawashooting-all-rnr-threads""]","[""1419893490"", ""87678019"", ""21923301"", ""72848824"", ""54050340"", ""26613837"", ""202991265"", ""119038924"", ""19126668"", ""14815956"", ""22331129"", ""22538359"", ""127034719"", ""30394227"", ""34037126"", ""122668948"", ""96156607"", ""16754729"", ""19785278"", ""33760765"", ""540903074"", ""156466334"", ""2582983692"", ""2393316120"", ""193549014"", ""1376446975"", ""272112035"", ""89064820"", ""67661896"", ""236654379"", ""218333534"", ""32088419"", ""2665795941"", ""18573284"", ""378952385"", ""47373104"", ""1897485415"", ""38611736""]",0,2,2
1345535262,2,136.0,-0.3915935158729553,12664605.0,2,0.0,"[""charliehebdo-all-rnr-threads"", ""ferguson-all-rnr-threads""]","[""225235528"", ""807095""]",0,2,2
563506837,2,124.0,-0.2815698981285095,6793092.0,2,0.0,"[""charliehebdo-all-rnr-threads"", ""ottawashooting-all-rnr-threads""]","[""13374"", ""1652541""]",0,2,2
281942499,2,121.5,-0.25226283073425293,7362839.0,2,0.0,"[""charliehebdo-all-rnr-threads"", ""ottawashooting-all-rnr-threads""]","[""13374"", ""148653311""]",0,2,2
2896380156,3,52.0,-0.0662422776222229,6629726.0,3,0.6666666666666666,"[""charliehebdo-all-rnr-threads"", ""germanwings-crash-all-rnr-threads""]","[""72882689"", ""30122242"", ""2345696184""]",2,1,3
19114497,2,114.5,0.15001189708709717,6829938.0,2,0.5,"[""charliehebdo-all-rnr-threads"", ""ottawashooting-all-rnr-threads""]","[""18999969"", ""2345696184""]",1,1,2
353147411,11,46.18181818181818,-0.21238477663560348,6805827.0,9,0.6363636363636364,"[""charliehebdo-all-rnr-threads"", ""ottawashooting-all-rnr-threads"", ""sydneysiege-all-rnr-threads""]","[""14173315"", ""1630896181"", ""16973333"", ""246130881"", ""2097571"", ""807095"", ""2799960092"", ""15012486"", ""15250661""]",7,4,11
190624049,7,134.71428571428572,-0.25390889814921785,8545491.0,5,0.14285714285714285,"[""charliehebdo-all-rnr-threads"", ""germanwings-crash-all-rnr-threads"", ""sydneysiege-all-rnr-threads""]","[""134196350"", ""47722134"", ""203123011"", ""64643056"", ""15012486""]",1,6,7
44099200,3,86.0,-0.21563692887624106,12687069.0,3,0.3333333333333333,"[""charliehebdo-all-rnr-threads"", ""sydneysiege-all-rnr-threads"", ""ferguson-all-rnr-threads""]","[""2725579568"", ""99238190"", ""17152053""]",1,2,3
1205878502,2,101.5,-0.03571879863739014,2181164.0,1,0.5,"[""charliehebdo-all-rnr-threads"", ""sydneysiege-all-rnr-threads""]","[""5402612""]",1,1,2
58167203,6,69.0,-0.2866038680076599,2218638.0,4,0.6666666666666666,"[""charliehebdo-all-rnr-threads"", ""sydneysiege-all-rnr-threads""]","[""171802941"", ""64643056"", ""2768501"", ""5402612""]",4,2,6
96820406,2,65.5,0.08535230159759521,7670479.0,2,0.5,"[""charliehebdo-all-rnr-threads"", ""ebola-essien-all-rnr-threads""]","[""159412087"", ""5402612""]",1,1,2
19103793,5,123.4,0.09854679107666016,6394760.0,4,0.0,"[""charliehebdo-all-rnr-threads"", ""germanwings-crash-all-rnr-threads""]","[""2280470022"", ""87818409"", ""134196350"", ""5402612""]",0,5,5
2396462640,2,80.0,-0.4918660521507263,2240614.0,2,0.0,"[""charliehebdo-all-rnr-threads"", ""sydneysiege-all-rnr-threads""]","[""18424289"", ""3108351""]",0,2,2
2703246275,2,67.0,-0.3015793263912201,6818547.0,2,0.5,"[""charliehebdo-all-rnr-threads"", ""ottawashooting-all-rnr-threads""]","[""22434517"", ""5402612""]",1,1,2
458008892,2,84.0,-0.13849639892578125,12680808.0,8,0.0,"[""charliehebdo-all-rnr-threads"", ""ferguson-all-rnr-threads""]","[""27966935"", ""36611990"", ""108136454"", ""2811807426"", ""2413247540"", ""197232446"", ""348613062"", ""285693924""]",0,2,2
220689036,8,121.625,-0.5569207817316055,12901668.0,2,0.0,"[""charliehebdo-all-rnr-threads"", ""ferguson-all-rnr-threads""]","[""16589206"", ""14321959""]",0,8,8
307221635,4,90.25,0.03531378507614136,2182776.0,2,0.0,"[""charliehebdo-all-rnr-threads"", ""sydneysiege-all-rnr-threads""]","[""429533485"", ""15143478""]",0,4,4
18643437,11,123.0,-0.18357256325808438,12890147.0,99,0.2727272727272727,"[""charliehebdo-all-rnr-threads"", ""ottawashooting-all-rnr-threads"", ""ferguson-all-rnr-threads"", ""sydneysiege-all-rnr-threads""]","[""256669236"", ""292559322"", ""891564612"", ""28352458"", ""15777611"", ""467026225"", ""235887538"", ""28849371"", ""2586038851"", ""18643437"", ""16587031"", ""40643223"", ""200859041"", ""2719063284"", ""153770827"", ""77423407"", ""1735381548"", ""311460807"", ""2417601924"", ""211280553"", ""2303077585"", ""1284014714"", ""260734204"", ""861344060"", ""155602260"", ""2462480718"", ""373652791"", ""246725820"", ""607925802"", ""555532124"", ""250365695"", ""2179916998"", ""1026613897"", ""531821053"", ""841131644"", ""2739826553"", ""1668371516"", ""624557599"", ""1107096824"", ""17448574"", ""7227522"", ""20070432"", ""94821790"", ""20415405"", ""75864150"", ""96740182"", ""604243082"", ""2638124864"", ""85475834"", ""879038035"", ""2727770608"", ""131613136"", ""1007845926"", ""883838280"", ""44126879"", ""24540476"", ""340514531"", ""27912912"", ""181873706"", ""157496375"", ""11204782"", ""557444087"", ""19433066"", ""842047760"", ""24639297"", ""118184465"", ""51622601"", ""203756288"", ""2773566528"", ""2728649010"", ""950435708"", ""2793276151"", ""190624477"", ""582390700"", ""228444327"", ""25832979"", ""456806183"", ""2401987555"", ""1121561198"", ""454811069"", ""2917371459"", ""2454961027"", ""443516364"", ""2496329197"", ""515327616"", ""474054440"", ""102271403"", ""2708897486"", ""520882800"", ""603341720"", ""147758381"", ""2168531659"", ""17164442"", ""1618325365"", ""287980552"", ""36153458"", ""1935265058"", ""24006632"", ""20328741""]",3,8,11
2608834147,3,106.33333333333333,-0.010392387708028158,6561705.0,1,0.3333333333333333,"[""charliehebdo-all-rnr-threads"", ""germanwings-crash-all-rnr-threads""]","[""2566535282""]",1,2,3
2516920201,3,126.0,-0.19304807980855307,13219782.0,3,0.0,"[""charliehebdo-all-rnr-threads"", ""ferguson-all-rnr-threads""]","[""1630896181"", ""313379422"", ""14090948""]",0,3,3
404095923,2,27.0,0.11719328165054321,2161805.0,1,0.0,"[""charliehebdo-all-rnr-threads"", ""sydneysiege-all-rnr-threads""]","[""7587032""]",0,2,2
2722033756,2,65.5,-0.6047508418560028,6799396.0,2,0.5,"[""charliehebdo-all-rnr-threads"", ""ottawashooting-all-rnr-threads""]","[""7587032"", ""5402612""]",1,1,2
55044037,9,95.55555555555556,-0.21016913652420044,2171208.0,2,0.8888888888888888,"[""charliehebdo-all-rnr-threads"", ""sydneysiege-all-rnr-threads""]","[""16589206"", ""18965916""]",8,1,9
507794602,2,75.0,-0.5164063572883606,2157997.0,2,0.5,"[""charliehebdo-all-rnr-threads"", ""sydneysiege-all-rnr-threads""]","[""3108351"", ""22993014""]",1,1,2
19589595,2,129.0,-0.20787972211837769,2181580.0,2,0.0,"[""charliehebdo-all-rnr-threads"", ""sydneysiege-all-rnr-threads""]","[""14224719"", ""5402612""]",0,2,2
556543428,3,112.66666666666667,-0.36658211549123126,13167031.0,2,0.0,"[""charliehebdo-all-rnr-threads"", ""ferguson-all-rnr-threads""]","[""19088288"", ""17995040""]",0,3,3
23485619,10,113.7,-0.34639171957969667,6843699.0,2,0.1,"[""charliehebdo-all-rnr-threads"", ""ottawashooting-all-rnr-threads""]","[""292777349"", ""1452874872""]",1,9,10
242367693,2,85.5,-0.4338715076446533,5435847.0,2,0.0,"[""charliehebdo-all-rnr-threads"", ""putinmissing-all-rnr-threads""]","[""766462243"", ""1452874872""]",0,2,2
1571699462,2,91.5,0.016895651817321777,2008114.0,2,0.0,"[""charliehebdo-all-rnr-threads"", ""sydneysiege-all-rnr-threads""]","[""14173315"", ""1452874872""]",0,2,2
22625357,2,35.5,-0.43906688690185547,2186711.0,1,0.0,"[""charliehebdo-all-rnr-threads"", ""sydneysiege-all-rnr-threads""]","[""7587032""]",0,2,2
174950408,3,81.66666666666667,-0.45555996894836426,2230204.0,3,0.0,"[""charliehebdo-all-rnr-threads"", ""sydneysiege-all-rnr-threads""]","[""55911799"", ""16973333"", ""69181624""]",0,3,3
494999217,7,105.85714285714286,-0.3316930191857474,12789788.0,2,0.0,"[""charliehebdo-all-rnr-threads"", ""ferguson-all-rnr-threads""]","[""97474887"", ""69181624""]",0,7,7
64205894,2,71.5,0.014451026916503906,2355124.0,2,0.0,"[""charliehebdo-all-rnr-threads"", ""sydneysiege-all-rnr-threads""]","[""69181624"", ""5402612""]",0,2,2
30489994,2,109.5,0.14770478010177612,2207705.0,2,0.5,"[""charliehebdo-all-rnr-threads"", ""sydneysiege-all-rnr-threads""]","[""254873869"", ""374712154""]",1,1,2
368392804,2,140.0,-0.7592381238937378,6826814.0,2,0.5,"[""charliehebdo-all-rnr-threads"", ""ottawashooting-all-rnr-threads""]","[""16525194"", ""8736882""]",1,1,2
254536058,4,86.75,-0.6169673204421997,2157797.0,2,0.75,"[""charliehebdo-all-rnr-threads"", ""sydneysiege-all-rnr-threads""]","[""20639175"", ""2097571""]",3,1,4
2663115926,5,61.6,-0.30073256492614747,13198289.0,3,0.2,"[""charliehebdo-all-rnr-threads"", ""germanwings-crash-all-rnr-threads"", ""ottawashooting-all-rnr-threads""]","[""14138785"", ""51241574"", ""742143""]",1,4,5
67732952,2,86.5,-0.17131558060646057,6628934.0,2,0.5,"[""charliehebdo-all-rnr-threads"", ""germanwings-crash-all-rnr-threads""]","[""1652541"", ""2396242676""]",1,1,2
2744928150,2,39.0,0.445670485496521,2202248.0,2,0.0,"[""charliehebdo-all-rnr-threads"", ""sydneysiege-all-rnr-threads""]","[""64643056"", ""5402612""]",0,2,2
107573070,3,133.33333333333334,-0.5799855987230936,6821309.0,2,0.3333333333333333,"[""charliehebdo-all-rnr-threads"", ""ottawashooting-all-rnr-threads""]","[""23937894"", ""64643056""]",1,2,3
179250417,3,103.0,-0.13664005200068155,8906027.0,3,0.6666666666666666,"[""charliehebdo-all-rnr-threads"", ""germanwings-crash-all-rnr-threads"", ""sydneysiege-all-rnr-threads""]","[""171802941"", ""2941152158"", ""64643056""]",2,1,3
473317256,3,127.0,-0.11732602119445801,8770888.0,3,0.6666666666666666,"[""charliehebdo-all-rnr-threads"", ""germanwings-crash-all-rnr-threads"", ""sydneysiege-all-rnr-threads""]","[""2566535282"", ""568143078"", ""1056552596""]",2,1,3
2474493694,2,123.0,-0.5007359385490417,2160629.0,2,0.0,"[""charliehebdo-all-rnr-threads"", ""sydneysiege-all-rnr-threads""]","[""14173315"", ""3108351""]",0,2,2
184827391,2,64.5,-0.35701847076416016,2221909.0,2,0.5,"[""charliehebdo-all-rnr-threads"", ""sydneysiege-all-rnr-threads""]","[""14173315"", ""37874853""]",1,1,2
1149353412,4,92.5,-0.1740216612815857,6818028.0,2,0.5,"[""charliehebdo-all-rnr-threads"", ""ottawashooting-all-rnr-threads"", ""sydneysiege-all-rnr-threads""]","[""14173315"", ""28785486""]",2,2,4
262329855,2,88.0,0.22541141510009766,2181611.0,1,0.5,"[""charliehebdo-all-rnr-threads"", ""sydneysiege-all-rnr-threads""]","[""7587032""]",1,1,2
2664984804,5,102.4,-0.4079143047332764,2204284.0,3,0.2,"[""charliehebdo-all-rnr-threads"", ""sydneysiege-all-rnr-threads""]","[""9235982"", ""35051304"", ""17983365""]",1,4,5
2581857086,7,100.85714285714286,-0.4192562188420977,2193320.0,0,0.5714285714285714,"[""charliehebdo-all-rnr-threads"", ""sydneysiege-all-rnr-threads""]",[],4,3,7
182690569,2,59.5,-0.06594306230545044,6825088.0,2,0.5,"[""charliehebdo-all-rnr-threads"", ""ottawashooting-all-rnr-threads""]","[""164075542"", ""149913262""]",1,1,2
53401994,2,128.5,-0.5054555833339691,6392671.0,2,0.5,"[""charliehebdo-all-rnr-threads"", ""germanwings-crash-all-rnr-threads""]","[""7744592"", ""15108702""]",1,1,2
2546312611,2,46.5,0.26874566078186035,12840957.0,2,0.0,"[""charliehebdo-all-rnr-threads"", ""ferguson-all-rnr-threads""]","[""952112047"", ""279390084""]",0,2,2
2744227350,2,40.0,0.36155128479003906,2205428.0,2,0.5,"[""charliehebdo-all-rnr-threads"", ""sydneysiege-all-rnr-threads""]","[""14460241"", ""952112047""]",1,1,2
2217007286,2,107.5,-0.48538804054260254,2209919.0,2,0.5,"[""charliehebdo-all-rnr-threads"", ""sydneysiege-all-rnr-threads""]","[""952112047"", ""292777349""]",1,1,2
15544922,3,70.66666666666667,-0.18441383043924967,2208264.0,2,0.0,"[""charliehebdo-all-rnr-threads"", ""sydneysiege-all-rnr-threads""]","[""23888081"", ""952112047""]",0,3,3
168802748,2,130.5,-0.13764309883117676,2201487.0,2,0.0,"[""charliehebdo-all-rnr-threads"", ""sydneysiege-all-rnr-threads""]","[""20973388"", ""22021978""]",0,2,2
14322902,4,95.25,0.07690095901489258,2165242.0,4,0.0,"[""charliehebdo-all-rnr-threads"", ""sydneysiege-all-rnr-threads""]","[""17995040"", ""959529762"", ""868112707"", ""149913262""]",0,4,4
437673995,14,125.14285714285714,-0.4892148460660662,6674047.0,2,0.07142857142857142,"[""charliehebdo-all-rnr-threads"", ""germanwings-crash-all-rnr-threads""]","[""26900055"", ""868112707""]",1,13,14
494822288,7,72.71428571428571,-0.29652499301092966,12959770.0,4,0.0,"[""charliehebdo-all-rnr-threads"", ""ferguson-all-rnr-threads""]","[""16935292"", ""109065990"", ""868112707"", ""64643056""]",0,7,7
2734291692,3,82.0,-0.047872344652811684,8816615.0,3,0.3333333333333333,"[""charliehebdo-all-rnr-threads"", ""germanwings-crash-all-rnr-threads"", ""sydneysiege-all-rnr-threads""]","[""16343974"", ""76453835"", ""16973333""]",1,2,3
526162113,2,93.5,-0.5308420360088348,6639273.0,2,0.5,"[""charliehebdo-all-rnr-threads"", ""germanwings-crash-all-rnr-threads""]","[""16330790"", ""26900055""]",1,1,2
405229960,4,88.0,0.06195293366909027,6782480.0,3,0.5,"[""charliehebdo-all-rnr-threads"", ""ottawashooting-all-rnr-threads"", ""sydneysiege-all-rnr-threads""]","[""16330790"", ""351120282"", ""1855737487""]",2,2,4
551264176,21,130.66666666666666,-0.3632023817016965,12849892.0,3,0.0,"[""charliehebdo-all-rnr-threads"", ""ferguson-all-rnr-threads""]","[""11265832"", ""11018152"", ""14090948""]",0,21,21
224833414,2,61.0,-0.6958736777305603,2158812.0,1,0.0,"[""charliehebdo-all-rnr-threads"", ""sydneysiege-all-rnr-threads""]","[""1367531""]",0,2,2
361022019,3,97.0,-0.25922727584838867,12699546.0,3,0.3333333333333333,"[""charliehebdo-all-rnr-threads"", ""ferguson-all-rnr-threads""]","[""18963809"", ""17995040"", ""195271137""]",1,2,3
191324405,4,81.0,0.003033965826034546,12841866.0,3,0.0,"[""charliehebdo-all-rnr-threads"", ""ottawashooting-all-rnr-threads"", ""ferguson-all-rnr-threads""]","[""244452760"", ""17995040"", ""25516222""]",0,4,4
335426737,4,121.75,-0.22096243500709534,6818896.0,2,0.0,"[""charliehebdo-all-rnr-threads"", ""ottawashooting-all-rnr-threads""]","[""14892665"", ""268416076""]",0,4,4
107525017,2,136.0,-0.4639522433280945,12877224.0,2,0.0,"[""charliehebdo-all-rnr-threads"", ""ferguson-all-rnr-threads""]","[""279390084"", ""14892665""]",0,2,2
827681827,2,110.0,-0.26901018619537354,2214306.0,2,0.5,"[""charliehebdo-all-rnr-threads"", ""sydneysiege-all-rnr-threads""]","[""17995040"", ""742143""]",1,1,2
2426855263,7,70.14285714285714,-0.391694392476763,2207430.0,7,0.5714285714285714,"[""charliehebdo-all-rnr-threads"", ""sydneysiege-all-rnr-threads""]","[""246130881"", ""51241574"", ""16019070"", ""2799960092"", ""49591803"", ""330378192"", ""35466620""]",4,3,7
48354257,2,47.5,-0.029693961143493652,2161865.0,2,0.0,"[""charliehebdo-all-rnr-threads"", ""sydneysiege-all-rnr-threads""]","[""3108351"", ""1626294277""]",0,2,2
82637042,2,134.5,-0.30355387926101685,6390115.0,2,0.0,"[""charliehebdo-all-rnr-threads"", ""germanwings-crash-all-rnr-threads""]","[""3108351"", ""5402612""]",0,2,2
261547866,4,76.0,-0.09585130214691162,12913245.0,3,0.0,"[""charliehebdo-all-rnr-threads"", ""ferguson-all-rnr-threads""]","[""3108351"", ""1381926373"", ""66533920""]",0,4,4
2723303783,2,72.5,-0.3495687246322632,6805369.0,2,0.5,"[""charliehebdo-all-rnr-threads"", ""ottawashooting-all-rnr-threads""]","[""3108351"", ""8736882""]",1,1,2
125192735,4,118.0,-0.28541842103004456,12876593.0,2,0.0,"[""charliehebdo-all-rnr-threads"", ""ferguson-all-rnr-threads""]","[""227837742"", ""14090948""]",0,4,4
224564319,2,118.0,-0.29292309284210205,2159831.0,2,0.0,"[""charliehebdo-all-rnr-threads"", ""sydneysiege-all-rnr-threads""]","[""271413771"", ""16343974""]",0,2,2
1263236965,2,115.0,-0.6878276765346527,12842950.0,2,0.0,"[""charliehebdo-all-rnr-threads"", ""ferguson-all-rnr-threads""]","[""15164565"", ""279390084""]",0,2,2
942662162,3,79.33333333333333,-0.06030348936716715,12855528.0,2,0.0,"[""charliehebdo-all-rnr-threads"", ""ferguson-all-rnr-threads""]","[""15164565"", ""14090948""]",0,3,3
2530367546,2,131.0,-0.40643614530563354,2155960.0,2,0.5,"[""charliehebdo-all-rnr-threads"", ""sydneysiege-all-rnr-threads""]","[""1367531"", ""6107422""]",1,1,2
38218247,7,118.57142857142857,-0.6014959641865322,13043505.0,4,0.0,"[""charliehebdo-all-rnr-threads"", ""ferguson-all-rnr-threads""]","[""487600344"", ""325265073"", ""14849562"", ""245689692""]",0,7,7
430297317,4,114.0,-0.4875350743532181,6815450.0,4,0.25,"[""charliehebdo-all-rnr-threads"", ""ottawashooting-all-rnr-threads""]","[""487600344"", ""272172091"", ""121483664"", ""302071347""]",1,3,4
34874047,4,94.25,-0.30136802792549133,2205028.0,2,0.0,"[""charliehebdo-all-rnr-threads"", ""sydneysiege-all-rnr-threads""]","[""1634077976"", ""954124423""]",0,4,4
366538990,2,58.5,0.026985466480255127,2213221.0,2,0.0,"[""charliehebdo-all-rnr-threads"", ""sydneysiege-all-rnr-threads""]","[""1634077976"", ""238575113""]",0,2,2
228134082,3,48.0,-0.0485991636912028,12727766.0,3,0.3333333333333333,"[""charliehebdo-all-rnr-threads"", ""sydneysiege-all-rnr-threads"", ""ferguson-all-rnr-threads""]","[""156464691"", ""1634077976"", ""279390084""]",1,2,3
374357782,8,55.25,-0.13683513551950455,6829375.0,4,0.75,"[""charliehebdo-all-rnr-threads"", ""ottawashooting-all-rnr-threads"", ""sydneysiege-all-rnr-threads""]","[""6017542"", ""1367531"", ""292777349"", ""28785486""]",6,2,8
2878831764,4,138.5,-0.567246824502945,2212996.0,1,0.25,"[""charliehebdo-all-rnr-threads"", ""sydneysiege-all-rnr-threads""]","[""292777349""]",1,3,4
462552106,2,99.5,-0.32817938923835754,12703584.0,2,0.5,"[""charliehebdo-all-rnr-threads"", ""ferguson-all-rnr-threads""]","[""487600344"", ""19948174""]",1,1,2
19355955,3,48.666666666666664,-0.3970429102579753,2201515.0,3,0.6666666666666666,"[""charliehebdo-all-rnr-threads"", ""sydneysiege-all-rnr-threads""]","[""487600344"", ""24202701"", ""718612494""]",2,1,3
143598168,3,92.66666666666667,-0.32360343138376874,2157908.0,2,0.0,"[""charliehebdo-all-rnr-threads"", ""sydneysiege-all-rnr-threads""]","[""7587032"", ""518991950""]",0,3,3
15206951,2,96.5,-0.5867749154567719,13083258.0,2,0.0,"[""charliehebdo-all-rnr-threads"", ""ferguson-all-rnr-threads""]","[""26015031"", ""24506246""]",0,2,2
2900922205,3,103.66666666666667,-0.767068088054657,2204821.0,2,0.0,"[""charliehebdo-all-rnr-threads"", ""sydneysiege-all-rnr-threads""]","[""357191485"", ""24506246""]",0,3,3
93000133,3,111.66666666666667,-0.2884559631347656,6824215.0,3,0.3333333333333333,"[""charliehebdo-all-rnr-threads"", ""ottawashooting-all-rnr-threads""]","[""23937894"", ""2097571"", ""428333""]",1,2,3
1168972057,2,132.0,-0.41615864634513855,6626123.0,2,0.5,"[""charliehebdo-all-rnr-threads"", ""germanwings-crash-all-rnr-threads""]","[""26900055"", ""149913262""]",1,1,2
1176480541,2,139.5,-0.484036386013031,2179461.0,2,0.0,"[""charliehebdo-all-rnr-threads"", ""sydneysiege-all-rnr-threads""]","[""7587032"", ""149913262""]",0,2,2
56312505,2,118.5,-0.45017001032829285,2251709.0,2,0.0,"[""charliehebdo-all-rnr-threads"", ""sydneysiege-all-rnr-threads""]","[""742143"", ""149913262""]",0,2,2
50367908,3,82.33333333333333,0.27395665645599365,12875099.0,7,0.0,"[""charliehebdo-all-rnr-threads"", ""ferguson-all-rnr-threads""]","[""16168504"", ""212000622"", ""357319445"", ""50367908"", ""153805650"", ""117183709"", ""927081422""]",0,3,3
2616159025,4,79.25,-0.2308272421360016,3993537.0,2,0.25,"[""charliehebdo-all-rnr-threads"", ""gurlitt-all-rnr-threads"", ""sydneysiege-all-rnr-threads""]","[""22021978"", ""5402612""]",1,3,4
34672175,5,73.8,-0.3028286099433899,6832367.0,2,0.4,"[""charliehebdo-all-rnr-threads"", ""ottawashooting-all-rnr-threads""]","[""19636948"", ""21355321""]",2,3,5
459983485,5,115.6,-0.517160964012146,12684804.0,4,0.6,"[""charliehebdo-all-rnr-threads"", ""ferguson-all-rnr-threads"", ""sydneysiege-all-rnr-threads"", ""ebola-essien-all-rnr-threads""]","[""83638901"", ""579635019"", ""64643056"", ""7587032""]",3,2,5
608069196,3,55.0,-0.2029690146446228,6826742.0,2,0.6666666666666666,"[""charliehebdo-all-rnr-threads"", ""ottawashooting-all-rnr-threads""]","[""83638901"", ""7587032""]",2,1,3
2960946279,4,134.25,-0.6518293768167496,6380423.0,3,0.0,"[""charliehebdo-all-rnr-threads"", ""germanwings-crash-all-rnr-threads""]","[""759251"", ""83638901"", ""64643056""]",0,4,4
2791235354,14,88.78571428571429,-0.177431515284947,2183053.0,3,0.21428571428571427,"[""charliehebdo-all-rnr-threads"", ""sydneysiege-all-rnr-threads""]","[""49591803"", ""83638901"", ""8197942""]",3,11,14
341439889,12,70.16666666666667,-0.4149531424045563,6807050.0,2,0.9166666666666666,"[""charliehebdo-all-rnr-threads"", ""ottawashooting-all-rnr-threads""]","[""5402612"", ""24506246""]",11,1,12
47617232,3,108.0,-0.23538575569788614,2206767.0,2,0.6666666666666666,"[""charliehebdo-all-rnr-threads"", ""sydneysiege-all-rnr-threads""]","[""16343974"", ""1855737487""]",2,1,3
187303839,2,133.5,-0.44222745299339294,2165121.0,9,0.0,"[""charliehebdo-all-rnr-threads"", ""sydneysiege-all-rnr-threads""]","[""1408458926"", ""374157128"", ""54813695"", ""2543769749"", ""551551599"", ""2449455408"", ""23167903"", ""2212943522"", ""2605571990""]",0,2,2
1498709924,4,55.25,0.13463664054870605,2211115.0,4,0.0,"[""charliehebdo-all-rnr-threads"", ""sydneysiege-all-rnr-threads""]","[""2799960092"", ""17537467"", ""3108351"", ""50348344""]",0,4,4
118737912,3,93.0,0.18557647864023843,2161499.0,3,0.0,"[""charliehebdo-all-rnr-threads"", ""sydneysiege-all-rnr-threads""]","[""16012783"", ""50348344"", ""2461887810""]",0,3,3
379270752,2,105.0,-0.47112900018692017,12074999.0,2,0.0,"[""charliehebdo-all-rnr-threads"", ""ferguson-all-rnr-threads""]","[""487600344"", ""43261344""]",0,2,2
1107594619,4,47.25,0.16561388969421387,12845855.0,3,0.0,"[""charliehebdo-all-rnr-threads"", ""ferguson-all-rnr-threads""]","[""487600344"", ""495464885"", ""100136358""]",0,4,4
1123024728,3,90.33333333333333,-0.23027499516805014,2215819.0,2,0.3333333333333333,"[""charliehebdo-all-rnr-threads"", ""sydneysiege-all-rnr-threads""]","[""487600344"", ""17469289""]",1,2,3
59581076,3,121.0,-0.3796623945236206,12707936.0,2,0.0,"[""charliehebdo-all-rnr-threads"", ""ferguson-all-rnr-threads""]","[""487600344"", ""8071902""]",0,3,3
2298877380,7,126.0,-0.45237668071474346,13120776.0,5,0.5714285714285714,"[""charliehebdo-all-rnr-threads"", ""ferguson-all-rnr-threads""]","[""232851192"", ""487600344"", ""53503202"", ""50192480"", ""62510409""]",4,3,7
15253950,4,67.25,0.06875038146972656,12857477.0,4,0.25,"[""charliehebdo-all-rnr-threads"", ""ferguson-all-rnr-threads""]","[""414488432"", ""26642006"", ""5513002"", ""2461887810""]",1,3,4
422868987,8,103.625,-0.5958761423826218,6882413.0,2,0.0,"[""charliehebdo-all-rnr-threads"", ""ottawashooting-all-rnr-threads""]","[""103065157"", ""166612219""]",0,8,8
1092400777,2,79.5,-0.2966742515563965,6297757.0,2,0.0,"[""charliehebdo-all-rnr-threads"", ""germanwings-crash-all-rnr-threads""]","[""7587032"", ""166612219""]",0,2,2
217044098,2,47.0,0.10809770226478577,6645800.0,2,0.0,"[""charliehebdo-all-rnr-threads"", ""germanwings-crash-all-rnr-threads""]","[""403647191"", ""166612219""]",0,2,2
384332900,2,118.5,-0.22012966871261597,12691884.0,2,0.0,"[""charliehebdo-all-rnr-threads"", ""ferguson-all-rnr-threads""]","[""742143"", ""1994321""]",0,2,2
86602719,15,66.26666666666668,-0.14928014278411866,6382835.0,2,0.9333333333333333,"[""charliehebdo-all-rnr-threads"", ""germanwings-crash-all-rnr-threads""]","[""7587032"", ""100936791""]",14,1,15
546838312,3,138.33333333333334,-0.4067885677019755,6818605.0,3,0.6666666666666666,"[""charliehebdo-all-rnr-threads"", ""ottawashooting-all-rnr-threads""]","[""2566535282"", ""289998339"", ""428333""]",2,1,3
47502031,7,104.71428571428571,-0.4002822296960013,8602352.0,4,0.7142857142857143,"[""charliehebdo-all-rnr-threads"", ""germanwings-crash-all-rnr-threads"", ""sydneysiege-all-rnr-threads""]","[""1652541"", ""28785486"", ""34713362"", ""5402612""]",5,2,7
20711027,3,42.0,0.2179278532663981,6828503.0,2,0.0,"[""charliehebdo-all-rnr-threads"", ""ottawashooting-all-rnr-threads""]","[""35757320"", ""5402612""]",0,3,3
929959202,4,94.5,-0.39616793394088745,12612671.0,3,0.0,"[""charliehebdo-all-rnr-threads"", ""sydneysiege-all-rnr-threads"", ""ferguson-all-rnr-threads""]","[""1280328260"", ""8071902"", ""64643056""]",0,4,4
203957869,2,135.5,-0.06891471147537231,6824795.0,2,0.0,"[""charliehebdo-all-rnr-threads"", ""ottawashooting-all-rnr-threads""]","[""14584903"", ""428333""]",0,2,2
2183631739,2,64.5,-0.101837158203125,6821173.0,2,0.5,"[""charliehebdo-all-rnr-threads"", ""ottawashooting-all-rnr-threads""]","[""759251"", ""428333""]",1,1,2
308766861,10,87.6,0.11524354219436646,2195741.0,1,0.5,"[""charliehebdo-all-rnr-threads"", ""sydneysiege-all-rnr-threads""]","[""428333""]",5,5,10
2293915237,58,105.56896551724138,-0.1691105848756329,12881039.0,5,0.0,"[""charliehebdo-all-rnr-threads"", ""ferguson-all-rnr-threads""]","[""195271137"", ""529784320"", ""16116288"", ""14090948"", ""472962312""]",0,58,58
1668697268,4,65.25,0.015076518058776855,6835018.0,4,0.25,"[""charliehebdo-all-rnr-threads"", ""ottawashooting-all-rnr-threads"", ""sydneysiege-all-rnr-threads""]","[""271413771"", ""30699754"", ""16973333"", ""472962312""]",1,3,4
118384061,2,125.0,-0.2083669900894165,2215436.0,2,0.5,"[""charliehebdo-all-rnr-threads"", ""sydneysiege-all-rnr-threads""]","[""380648579"", ""14293310""]",1,1,2
13361042,2,101.0,-0.1505102813243866,12885923.0,2,0.0,"[""charliehebdo-all-rnr-threads"", ""ferguson-all-rnr-threads""]","[""51241574"", ""529784320""]",0,2,2
2361372481,3,69.66666666666667,0.0679014523824056,13417706.0,3,0.3333333333333333,"[""charliehebdo-all-rnr-threads"", ""germanwings-crash-all-rnr-threads"", ""ottawashooting-all-rnr-threads""]","[""1367531"", ""51241574"", ""112562263""]",1,2,3
37425092,3,126.0,-0.4065738121668498,2162294.0,3,0.6666666666666666,"[""charliehebdo-all-rnr-threads"", ""sydneysiege-all-rnr-threads""]","[""22129280"", ""51241574"", ""428333""]",2,1,3
1334659567,3,94.0,-0.1891996661822001,2211729.0,1,0.6666666666666666,"[""charliehebdo-all-rnr-threads"", ""sydneysiege-all-rnr-threads""]","[""292777349""]",2,1,3
20779110,2,128.5,-0.4546894431114197,2160546.0,4,0.0,"[""charliehebdo-all-rnr-threads"", ""sydneysiege-all-rnr-threads""]","[""2778507091"", ""75854948"", ""41479292"", ""2613676772""]",0,2,2
1598896028,8,115.0,-0.0604514479637146,6816458.0,3,0.625,"[""charliehebdo-all-rnr-threads"", ""ottawashooting-all-rnr-threads""]","[""19038934"", ""1367531"", ""285383650""]",5,3,8
1597398924,4,70.75,-0.2927648425102234,12689875.0,2,0.0,"[""charliehebdo-all-rnr-threads"", ""ferguson-all-rnr-threads""]","[""27966935"", ""1367531""]",0,4,4
503580426,5,58.6,-0.06792287826538086,12713397.0,5,0.8,"[""charliehebdo-all-rnr-threads"", ""ottawashooting-all-rnr-threads"", ""ferguson-all-rnr-threads""]","[""15108530"", ""1652541"", ""89887215"", ""15754281"", ""428333""]",4,1,5
2412920598,2,107.5,-0.25882577896118164,6698932.0,2,0.5,"[""charliehebdo-all-rnr-threads"", ""ottawashooting-all-rnr-threads""]","[""19038934"", ""959529762""]",1,1,2
729433772,2,55.0,0.22464817762374878,2331451.0,2,0.5,"[""charliehebdo-all-rnr-threads"", ""sydneysiege-all-rnr-threads""]","[""959529762"", ""302974524""]",1,1,2
2404454630,7,116.42857142857143,-0.6825249024799892,8809726.0,3,0.0,"[""charliehebdo-all-rnr-threads"", ""germanwings-crash-all-rnr-threads"", ""sydneysiege-all-rnr-threads""]","[""236488883"", ""2097571"", ""818212956""]",0,7,7
1036747494,2,106.5,-0.2955477833747864,2190050.0,2,0.5,"[""charliehebdo-all-rnr-threads"", ""sydneysiege-all-rnr-threads""]","[""2097571"", ""5402612""]",1,1,2
523996194,3,115.33333333333333,-0.3979303042093913,2218321.0,3,0.3333333333333333,"[""charliehebdo-all-rnr-threads"", ""sydneysiege-all-rnr-threads""]","[""1652541"", ""15012486"", ""5402612""]",1,2,3
143008727,3,100.33333333333333,-0.6785433491071066,6817080.0,2,0.6666666666666666,"[""charliehebdo-all-rnr-threads"", ""ottawashooting-all-rnr-threads""]","[""19636948"", ""428333""]",2,1,3
2147835768,7,78.14285714285714,-0.23916315180914743,6816825.0,2,0.7142857142857143,"[""charliehebdo-all-rnr-threads"", ""ottawashooting-all-rnr-threads""]","[""7587032"", ""5402612""]",5,2,7
76392453,2,75.5,-0.5272125601768494,6817367.0,2,0.0,"[""charliehebdo-all-rnr-threads"", ""ottawashooting-all-rnr-threads""]","[""742143"", ""807095""]",0,2,2
2283483315,3,116.66666666666667,0.15898668766021729,2203463.0,3,0.3333333333333333,"[""charliehebdo-all-rnr-threads"", ""sydneysiege-all-rnr-threads""]","[""3108351"", ""7587032"", ""807095""]",1,2,3
20709918,2,141.0,-0.4792957901954651,12965771.0,2,0.0,"[""charliehebdo-all-rnr-threads"", ""ferguson-all-rnr-threads""]","[""13557782"", ""1407822289""]",0,2,2
1343546233,7,118.57142857142857,-0.42934911591666086,13122483.0,6,0.42857142857142855,"[""charliehebdo-all-rnr-threads"", ""ferguson-all-rnr-threads""]","[""534675241"", ""17447972"", ""23995748"", ""35490978"", ""64643056"", ""41292655""]",3,4,7
18622869,2,101.0,0.23027491569519043,6813202.0,37,0.0,"[""charliehebdo-all-rnr-threads"", ""ottawashooting-all-rnr-threads""]","[""2330962234"", ""755864660"", ""292604030"", ""67408245"", ""275804230"", ""229166082"", ""31596098"", ""14560097"", ""17535206"", ""191305054"", ""701094366"", ""2369949012"", ""166535606"", ""315347420"", ""14074541"", ""58604522"", ""1748080555"", ""18695790"", ""113673277"", ""92192133"", ""1409271"", ""288286986"", ""48792875"", ""38181453"", ""15431251"", ""2751081982"", ""545776434"", ""496667191"", ""572297334"", ""139695871"", ""92659714"", ""1234681772"", ""280316807"", ""2244268621"", ""18774241"", ""1231811838"", ""390471701""]",0,2,2
14560097,2,55.0,-0.060989439487457275,12681590.0,23,0.5,"[""charliehebdo-all-rnr-threads"", ""ferguson-all-rnr-threads""]","[""17023049"", ""15294551"", ""902528816"", ""2549520571"", ""19086695"", ""366748134"", ""17665712"", ""32294348"", ""14731096"", ""41410702"", ""410122661"", ""114625323"", ""579858097"", ""249424032"", ""18622869"", ""1636077204"", ""977200838"", ""15347644"", ""64671130"", ""29049770"", ""466696679"", ""415826305"", ""1195684554""]",1,1,2
292604030,2,73.0,0.04670536518096924,12688478.0,2,0.5,"[""charliehebdo-all-rnr-threads"", ""ferguson-all-rnr-threads""]","[""1716581"", ""18622869""]",1,1,2
19636948,36,112.52777777777777,-0.32080913417869145,6834294.0,262,0.7222222222222222,"[""charliehebdo-all-rnr-threads"", ""ottawashooting-all-rnr-threads"", ""prince-toronto-all-rnr-threads""]","[""239264478"", ""246310423"", ""21923301"", ""247704374"", ""67393469"", ""20267673"", ""25296154"", ""38313366"", ""554073874"", ""36122739"", ""1466215338"", ""2241104768"", ""541903836"", ""596895450"", ""280765317"", ""132368086"", ""286834511"", ""246071221"", ""16458742"", ""139872835"", ""121872719"", ""269777701"", ""530962991"", ""2745404073"", ""23775585"", ""177991742"", ""21821331"", ""67117897"", ""33722041"", ""1600036070"", ""175662236"", ""1092891890"", ""433092131"", ""600617800"", ""181033896"", ""2476131062"", ""36609356"", ""34404941"", ""78898625"", ""259509975"", ""845757864"", ""26759726"", ""2264940392"", ""28884015"", ""366644497"", ""248036782"", ""416656127"", ""251184474"", ""956895854"", ""201295178"", ""533389119"", ""22584331"", ""74628309"", ""21929177"", ""322148870"", ""23857263"", ""2638274326"", ""63463165"", ""94885717"", ""27060751"", ""410912897"", ""437188111"", ""242489151"", ""1105430388"", ""407788333"", ""102083980"", ""202919146"", ""2760425855"", ""246781104"", ""6278102"", ""24035263"", ""574785694"", ""69559910"", ""93560831"", ""421510963"", ""228545413"", ""293559261"", ""70215330"", ""175742582"", ""66525934"", ""1064247085"", ""635507316"", ""456648619"", ""29101584"", ""747291006"", ""310009602"", ""346761432"", ""143008727"", ""2161221234"", ""723479318"", ""404610392"", ""1424334847"", ""2316193393"", ""158879326"", ""24815044"", ""451901387"", ""526487803"", ""93046663"", ""471232039"", ""425383187"", ""1263758832"", ""19636948"", ""464114914"", ""275359430"", ""358161395"", ""160398040"", ""930938779"", ""1091058638"", ""28914990"", ""1284273828"", ""53359301"", ""230245840"", ""339813004"", ""360042106"", ""615141677"", ""1435964408"", ""279590409"", ""701453563"", ""573206160"", ""1488080096"", ""1099528262"", ""43089397"", ""1410307298"", ""44491255"", ""2293637563"", ""178110602"", ""821977051"", ""2853653587"", ""369883067"", ""77083292"", ""167918900"", ""587677480"", ""292760122"", ""19167941"", ""113152512"", ""335650597"", ""366652585"", ""122027688"", ""387778800"", ""115785635"", ""20957280"", ""2484888469"", ""481694798"", ""149412419"", ""57065755"", ""2187147559"", ""2564750423"", ""2651807532"", ""199002117"", ""893516330"", ""169750416"", ""2736351071"", ""59418279"", ""1671362664"", ""2493350586"", ""242379345"", ""1378567909"", ""57550348"", ""211021409"", ""42981443"", ""2274145332"", ""213128516"", ""348243844"", ""38741981"", ""2444982048"", ""464893712"", ""67378083"", ""50791051"", ""404318839"", ""548867821"", ""118805581"", ""2798871876"", ""960221840"", ""73267432"", ""82534241"", ""228199232"", ""380943068"", ""403031191"", ""34960068"", ""756512378"", ""439344935"", ""112002199"", ""172533515"", ""874887468"", ""76806031"", ""1374890515"", ""490012811"", ""495397696"", ""230909669"", ""467635602"", ""255268761"", ""335500613"", ""111317675"", ""259863959"", ""122956013"", ""415875920"", ""220077246"", ""378952385"", ""732910694"", ""57727353"", ""1240220082"", ""2848719522"", ""1166409398"", ""28509248"", ""26103987"", ""34672175"", ""608620371"", ""23135362"", ""170205776"", ""221561433"", ""1219593308"", ""2809357234"", ""86026819"", ""292978323"", ""290245939"", ""535745746"", ""36119780"", ""2233449528"", ""2263235551"", ""184023215"", ""151631833"", ""14218890"", ""1615786508"", ""284344429"", ""306862317"", ""32234696"", ""100150714"", ""29894737"", ""127716382"", ""854239526"", ""259795889"", ""103711554"", ""272188048"", ""16206664"", ""519199055"", ""2843838703"", ""23522112"", ""119441850"", ""90878372"", ""271202803"", ""310426895"", ""1906635450"", ""26919309"", ""315278240"", ""60426267"", ""249843334"", ""184323135"", ""1700155722"", ""401562657"", ""41465969"", ""339221485"", ""322244362"", ""16257625"", ""599037668"", ""331348128"", ""38076460"", ""75833183"", ""32660080"", ""154306129"", ""33208443"", ""2390092718"", ""15504380""]",26,10,36
132368086,2,124.0,-0.6863881349563599,6832167.0,1,0.5,"[""charliehebdo-all-rnr-threads"", ""ottawashooting-all-rnr-threads""]","[""19636948""]",1,1,2
854239526,8,118.375,-0.14541632682085037,6821888.0,3,0.125,"[""charliehebdo-all-rnr-threads"", ""ottawashooting-all-rnr-threads""]","[""19636948"", ""217872058"", ""156123647""]",1,7,8
38762773,2,124.0,-0.549514502286911,12691364.0,2,0.5,"[""charliehebdo-all-rnr-threads"", ""ferguson-all-rnr-threads""]","[""14090948"", ""5402612""]",1,1,2
37043257,4,62.5,-0.3016470968723297,6827178.0,3,0.75,"[""charliehebdo-all-rnr-threads"", ""ottawashooting-all-rnr-threads""]","[""19038934"", ""957502914"", ""8736882""]",3,1,4
1421458982,4,94.25,0.1308559775352478,12801877.0,3,0.0,"[""charliehebdo-all-rnr-threads"", ""ferguson-all-rnr-threads""]","[""926505505"", ""25049056"", ""101848151""]",0,4,4
135578944,2,84.0,0.1820753812789917,2199766.0,2,0.5,"[""charliehebdo-all-rnr-threads"", ""sydneysiege-all-rnr-threads""]","[""2434191967"", ""5402612""]",1,1,2
2413562079,3,98.33333333333333,-0.3995203773180644,2195516.0,2,0.6666666666666666,"[""charliehebdo-all-rnr-threads"", ""sydneysiege-all-rnr-threads""]","[""34713362"", ""5402612""]",2,1,3
1853914981,2,124.5,-0.7853059470653534,2197777.0,2,0.5,"[""charliehebdo-all-rnr-threads"", ""sydneysiege-all-rnr-threads""]","[""4970411"", ""51241574""]",1,1,2
16285681,5,93.6,-0.20682499408721924,12707701.0,2,0.0,"[""charliehebdo-all-rnr-threads"", ""ferguson-all-rnr-threads""]","[""15012486"", ""279390084""]",0,5,5
353353761,6,129.0,-0.3700627585252126,12705118.0,4,0.3333333333333333,"[""charliehebdo-all-rnr-threads"", ""ferguson-all-rnr-threads""]","[""15012486"", ""46822887"", ""279390084"", ""14090948""]",2,4,6
884202938,3,116.0,-0.6502772370974222,2227742.0,3,0.3333333333333333,"[""charliehebdo-all-rnr-threads"", ""sydneysiege-all-rnr-threads""]","[""379479080"", ""7702542"", ""14460241""]",1,2,3
34195205,2,138.0,-0.22739934921264648,2168045.0,1,0.0,"[""charliehebdo-all-rnr-threads"", ""sydneysiege-all-rnr-threads""]","[""428333""]",0,2,2
5527802,2,129.5,0.2021958827972412,12702585.0,2,0.5,"[""charliehebdo-all-rnr-threads"", ""ferguson-all-rnr-threads""]","[""34556109"", ""428333""]",1,1,2
47396544,3,77.66666666666667,-0.3197421630223592,6826720.0,3,0.0,"[""charliehebdo-all-rnr-threads"", ""ottawashooting-all-rnr-threads""]","[""2195241"", ""778057"", ""807095""]",0,3,3
15971518,2,98.5,-0.28362417221069336,12917214.0,2,0.0,"[""charliehebdo-all-rnr-threads"", ""ferguson-all-rnr-threads""]","[""954124423"", ""2195241""]",0,2,2
16995002,2,105.5,-0.5658823251724243,6819771.0,2,0.0,"[""charliehebdo-all-rnr-threads"", ""ottawashooting-all-rnr-threads""]","[""2195241"", ""107883101""]",0,2,2
203123011,28,97.5,-0.3629480940955026,6834811.0,259,0.7142857142857143,"[""charliehebdo-all-rnr-threads"", ""sydneysiege-all-rnr-threads"", ""gurlitt-all-rnr-threads"", ""prince-toronto-all-rnr-threads"", ""ottawashooting-all-rnr-threads""]","[""61757720"", ""3632161"", ""190624049"", ""2412595586"", ""36829889"", ""21850237"", ""1880980032"", ""354389363"", ""428324525"", ""88061731"", ""68841029"", ""1003494408"", ""1670443802"", ""1216077991"", ""2468044729"", ""23189508"", ""43552739"", ""2392310757"", ""56503668"", ""266904396"", ""414335352"", ""73329631"", ""23142690"", ""512680707"", ""99821535"", ""30028642"", ""2159537998"", ""200231908"", ""25521624"", ""144605181"", ""130845934"", ""2290535714"", ""1048468734"", ""303421529"", ""376527467"", ""341164773"", ""810739160"", ""503956899"", ""2700126332"", ""82881002"", ""233515884"", ""709870156"", ""74892988"", ""30669244"", ""231886865"", ""21110041"", ""273056946"", ""36275675"", ""1107336421"", ""231216058"", ""251272812"", ""441504325"", ""1220142182"", ""245907350"", ""2875558900"", ""221251650"", ""389561415"", ""1629091597"", ""825801150"", ""328088511"", ""82098291"", ""183832473"", ""229246026"", ""31354733"", ""489955041"", ""354973079"", ""292629799"", ""635507316"", ""1138018884"", ""284804728"", ""45562879"", ""20003589"", ""608786668"", ""20105825"", ""600635215"", ""16645396"", ""71160274"", ""46764038"", ""30956253"", ""51355872"", ""1320459469"", ""327103342"", ""1043778398"", ""221448231"", ""325539274"", ""344976463"", ""570210929"", ""565198962"", ""278080731"", ""417480700"", ""27442711"", ""2757990851"", ""34478789"", ""241554041"", ""922213610"", ""94231990"", ""405082296"", ""2537991553"", ""225113410"", ""217154647"", ""215814458"", ""26499221"", ""450243058"", ""46558416"", ""145855451"", ""52476512"", ""362764525"", ""52285560"", ""43219286"", ""32421992"", ""24045289"", ""607764831"", ""339847349"", ""1382793386"", ""32863430"", ""7623352"", ""2369605592"", ""23865089"", ""2442974962"", ""852999438"", ""22952125"", ""16385639"", ""398214539"", ""310575740"", ""1915178569"", ""2380888006"", ""85159003"", ""2651807532"", ""468854973"", ""602384018"", ""1252976186"", ""2301655718"", ""2441072361"", ""287183523"", ""233312111"", ""1305361531"", ""23152202"", ""27028658"", ""2825490802"", ""561565204"", ""155599665"", ""991544468"", ""532817383"", ""265023219"", ""1554263412"", ""189175486"", ""58975626"", ""1629656142"", ""831528542"", ""2417346006"", ""596336987"", ""535554692"", ""361961038"", ""20228338"", ""102238015"", ""28786871"", ""573709351"", ""79593832"", ""473354828"", ""424603469"", ""35517917"", ""869638356"", ""91829021"", ""168744158"", ""9040092"", ""25704939"", ""22809037"", ""262003922"", ""2431432212"", ""240468757"", ""893066750"", ""2819774368"", ""406716292"", ""2861365756"", ""17758398"", ""2859027206"", ""621930944"", ""764639689"", ""2453850531"", ""180369691"", ""333817484"", ""840859760"", ""1242295658"", ""109051829"", ""795020478"", ""2566265229"", ""23130850"", ""256196918"", ""105270632"", ""16014375"", ""2220134678"", ""48024414"", ""2863429554"", ""2653536275"", ""491043828"", ""161943530"", ""1315224110"", ""94476810"", ""2414949619"", ""40747060"", ""39658005"", ""25412397"", ""720392017"", ""77860728"", ""1625635405"", ""347946891"", ""238941944"", ""19111502"", ""34601263"", ""1005109987"", ""493487022"", ""15681714"", ""935623440"", ""2784322060"", ""393673656"", ""531775406"", ""1243880023"", ""16059828"", ""1260709248"", ""188608550"", ""571104945"", ""16206664"", ""488488813"", ""515516074"", ""633906111"", ""28817422"", ""2464623906"", ""2445448106"", ""275335412"", ""1522809265"", ""434988195"", ""22681305"", ""342313862"", ""374138169"", ""603574515"", ""2820930210"", ""24024005"", ""16704149"", ""1282017230"", ""1532701664"", ""36755911"", ""60426267"", ""154797103"", ""2556990331"", ""2538899928"", ""728394116"", ""1258326056"", ""561655209"", ""29490342"", ""402425839"", ""29750634"", ""88092567"", ""24267328"", ""583002992"", ""310495967"", ""272185225"", ""523653205"", ""198045282"", ""2288535629""]",20,8,28
3632161,2,128.0,-0.3634974956512451,12875142.0,2,0.0,"[""charliehebdo-all-rnr-threads"", ""ferguson-all-rnr-threads""]","[""18197912"", ""203123011""]",0,2,2
19655788,3,55.333333333333336,0.023107290267944336,12885466.0,3,0.0,"[""charliehebdo-all-rnr-threads"", ""ferguson-all-rnr-threads""]","[""271413771"", ""24138795"", ""22416658""]",0,3,3
362602281,9,110.33333333333333,-0.3226857715182834,13150949.0,3,0.0,"[""charliehebdo-all-rnr-threads"", ""ferguson-all-rnr-threads""]","[""271413771"", ""124227622"", ""154380211""]",0,9,9
27989993,3,119.33333333333333,-0.43331090609232586,12857506.0,3,0.0,"[""charliehebdo-all-rnr-threads"", ""ferguson-all-rnr-threads""]","[""271413771"", ""78665762"", ""898533348""]",0,3,3
275450877,5,126.6,-0.40512149333953856,2195327.0,3,0.2,"[""charliehebdo-all-rnr-threads"", ""sydneysiege-all-rnr-threads""]","[""373783051"", ""2836941830"", ""1379288282""]",1,4,5
66034438,2,97.0,-0.42460185289382935,6834982.0,2,0.5,"[""charliehebdo-all-rnr-threads"", ""ottawashooting-all-rnr-threads""]","[""8736882"", ""1379288282""]",1,1,2
518671857,19,112.57894736842105,-0.357151166388863,13119338.0,4,0.0,"[""charliehebdo-all-rnr-threads"", ""ferguson-all-rnr-threads""]","[""15907183"", ""124227622"", ""1367531"", ""16948493""]",0,19,19
321402315,4,64.25,0.5191131234169006,2175809.0,4,0.25,"[""charliehebdo-all-rnr-threads"", ""sydneysiege-all-rnr-threads""]","[""2768501"", ""1367531"", ""16973333"", ""16834659""]",1,3,4
1398673123,2,61.0,-0.17072772979736328,6827005.0,2,0.0,"[""charliehebdo-all-rnr-threads"", ""ottawashooting-all-rnr-threads""]","[""50004938"", ""2097571""]",0,2,2
2596628207,2,51.5,0.36046743392944336,6829412.0,2,0.5,"[""charliehebdo-all-rnr-threads"", ""ottawashooting-all-rnr-threads""]","[""2097571"", ""8736882""]",1,1,2
37796609,16,94.0,-0.2488233856856823,13184897.0,6,0.0625,"[""charliehebdo-all-rnr-threads"", ""ferguson-all-rnr-threads""]","[""14090948"", ""138168339"", ""325265073"", ""2286821737"", ""2725579568"", ""227837742""]",1,15,16
18627369,2,131.5,-0.751388281583786,13187972.0,2,0.0,"[""charliehebdo-all-rnr-threads"", ""ferguson-all-rnr-threads""]","[""759251"", ""46822887""]",0,2,2
218218274,2,63.5,0.046131789684295654,2208408.0,2,0.0,"[""charliehebdo-all-rnr-threads"", ""sydneysiege-all-rnr-threads""]","[""759251"", ""954124423""]",0,2,2
1948075638,4,103.75,-0.7692624181509018,2163249.0,2,0.0,"[""charliehebdo-all-rnr-threads"", ""sydneysiege-all-rnr-threads""]","[""1367531"", ""31540671""]",0,4,4
2788722909,2,26.5,-0.11435306072235107,2163086.0,2,0.0,"[""charliehebdo-all-rnr-threads"", ""sydneysiege-all-rnr-threads""]","[""87818409"", ""5402612""]",0,2,2
464002910,2,64.0,-0.029245316982269287,6832889.0,2,0.0,"[""charliehebdo-all-rnr-threads"", ""ottawashooting-all-rnr-threads""]","[""16076032"", ""149913262""]",0,2,2
1212459181,3,71.66666666666667,-0.08097676436106364,2221766.0,2,0.6666666666666666,"[""charliehebdo-all-rnr-threads"", ""sydneysiege-all-rnr-threads""]","[""17469289"", ""149913262""]",2,1,3
796740463,2,125.5,-0.2298174500465393,2196358.0,2,0.5,"[""charliehebdo-all-rnr-threads"", ""sydneysiege-all-rnr-threads""]","[""87818409"", ""76858507""]",1,1,2
2392744614,2,70.5,0.4220737814903259,2213830.0,2,0.0,"[""charliehebdo-all-rnr-threads"", ""sydneysiege-all-rnr-threads""]","[""60937837"", ""76858507""]",0,2,2
205024182,9,97.0,-0.5592682229148017,8814173.0,4,0.7777777777777778,"[""charliehebdo-all-rnr-threads"", ""germanwings-crash-all-rnr-threads"", ""sydneysiege-all-rnr-threads""]","[""30122242"", ""954124423"", ""718612494"", ""76858507""]",7,2,9
262062797,8,97.125,-0.18627600371837616,2224332.0,4,0.125,"[""charliehebdo-all-rnr-threads"", ""sydneysiege-all-rnr-threads""]","[""1652541"", ""14413869"", ""383685824"", ""428333""]",1,7,8
448510528,3,78.33333333333333,-0.3468061089515686,2207166.0,3,0.6666666666666666,"[""charliehebdo-all-rnr-threads"", ""sydneysiege-all-rnr-threads""]","[""126629610"", ""47722134"", ""2738397743""]",2,1,3
14515799,6,88.5,-0.14457575480143228,2221774.0,26,0.3333333333333333,"[""charliehebdo-all-rnr-threads"", ""sydneysiege-all-rnr-threads""]","[""377721914"", ""213698858"", ""15730804"", ""20125356"", ""15876503"", ""1232348810"", ""15374715"", ""29332376"", ""17266705"", ""16090559"", ""33566183"", ""218261839"", ""90059772"", ""47325702"", ""238852699"", ""14515799"", ""568627120"", ""170384986"", ""51112296"", ""11214"", ""155470516"", ""537191798"", ""216230774"", ""178856654"", ""7439352"", ""946440938""]",2,4,6
16072089,4,128.0,-0.3652358204126358,6832304.0,3,0.75,"[""charliehebdo-all-rnr-threads"", ""ottawashooting-all-rnr-threads"", ""sydneysiege-all-rnr-threads""]","[""19038934"", ""48956231"", ""868112707""]",3,1,4
2859958581,6,98.83333333333333,-0.40685372551282245,2216649.0,2,0.0,"[""charliehebdo-all-rnr-threads"", ""sydneysiege-all-rnr-threads""]","[""28785486"", ""868112707""]",0,6,6
202054350,3,127.0,-0.5998757680257162,6462052.0,3,0.6666666666666666,"[""charliehebdo-all-rnr-threads"", ""germanwings-crash-all-rnr-threads""]","[""51241574"", ""868112707"", ""5402612""]",2,1,3
142236260,3,120.33333333333333,-0.09390568733215332,6830200.0,2,0.0,"[""charliehebdo-all-rnr-threads"", ""ottawashooting-all-rnr-threads""]","[""868112707"", ""16469809""]",0,3,3
568564628,2,94.0,-0.09699869155883789,12712201.0,2,0.0,"[""charliehebdo-all-rnr-threads"", ""ferguson-all-rnr-threads""]","[""33391760"", ""7587032""]",0,2,2
255527829,2,137.0,0.12012094259262085,2200722.0,6,0.5,"[""charliehebdo-all-rnr-threads"", ""sydneysiege-all-rnr-threads""]","[""1408458926"", ""19228639"", ""38124709"", ""102082508"", ""14940354"", ""2793020689""]",1,1,2
168820035,2,111.0,-0.49185481667518616,2219404.0,2,0.5,"[""charliehebdo-all-rnr-threads"", ""sydneysiege-all-rnr-threads""]","[""2884771"", ""51241574""]",1,1,2
236842564,2,36.5,-0.6306199431419373,5509161.0,2,0.5,"[""sydneysiege-all-rnr-threads"", ""ebola-essien-all-rnr-threads""]","[""964926744"", ""409941587""]",1,1,2
167704836,2,97.0,-0.8439289927482605,14058491.0,2,1.0,"[""germanwings-crash-all-rnr-threads"", ""ebola-essien-all-rnr-threads""]","[""2280470022"", ""2330299633""]",2,0,2
94476810,14,73.2142857142857,-0.30160582065582275,6386057.0,10,0.7142857142857143,"[""ottawashooting-all-rnr-threads"", ""ferguson-all-rnr-threads""]","[""472778354"", ""1932737630"", ""8736882"", ""12848262"", ""285383650"", ""428333"", ""14090948"", ""7214972"", ""203123011"", ""5402612""]",10,4,14
467026225,15,93.13333333333334,-0.08296281894048055,19957031.0,12,0.4,"[""germanwings-crash-all-rnr-threads"", ""ferguson-all-rnr-threads""]","[""16935292"", ""230527949"", ""158561160"", ""26514376"", ""116625196"", ""24165761"", ""195271137"", ""20562637"", ""17561562"", ""7214972"", ""18643437"", ""17072206""]",6,9,15
24165761,43,117.20930232558139,-0.27843022207881135,19562488.0,303,0.3023255813953488,"[""germanwings-crash-all-rnr-threads"", ""ferguson-all-rnr-threads""]","[""2481153614"", ""1049586888"", ""467026225"", ""416550176"", ""71727006"", ""248306279"", ""32288293"", ""38339586"", ""429588160"", ""256352051"", ""80468807"", ""434682005"", ""21041737"", ""266089387"", ""386753261"", ""32608975"", ""1595149356"", ""355067816"", ""24165761"", ""541758289"", ""145143819"", ""502336319"", ""24224015"", ""14809234"", ""1327537765"", ""47769282"", ""18639029"", ""192896660"", ""94618485"", ""335644527"", ""474994893"", ""20633389"", ""244835896"", ""451211846"", ""46617218"", ""80895456"", ""409636454"", ""545420202"", ""2450904662"", ""1636685257"", ""242299173"", ""15267773"", ""4251731"", ""852305618"", ""51146915"", ""22251459"", ""52998658"", ""1043957966"", ""16493968"", ""553973787"", ""43378629"", ""15778923"", ""2603184067"", ""373033461"", ""15970073"", ""290871941"", ""301529177"", ""127566165"", ""25887520"", ""463852669"", ""204195052"", ""443564426"", ""228332540"", ""18965750"", ""343571392"", ""33294987"", ""156804981"", ""33513175"", ""313722052"", ""31555898"", ""52294796"", ""30762461"", ""252578331"", ""864246434"", ""165824753"", ""996247922"", ""64184644"", ""2752548731"", ""49449357"", ""19763467"", ""2262887718"", ""189042188"", ""322382035"", ""2408732223"", ""144560151"", ""517295675"", ""95711726"", ""787037258"", ""1046496480"", ""363221461"", ""25226989"", ""1418661990"", ""2235424550"", ""524826590"", ""2655428341"", ""174321295"", ""155743313"", ""23631058"", ""40120833"", ""115826302"", ""380746374"", ""105050227"", ""281765208"", ""613852418"", ""207589835"", ""334781576"", ""57419364"", ""1157026700"", ""1514384990"", ""228070052"", ""172564718"", ""182985036"", ""35081268"", ""178523942"", ""31492516"", ""537864488"", ""14156054"", ""65931246"", ""847842350"", ""2535125648"", ""180150418"", ""2999184193"", ""240334989"", ""22101273"", ""167046760"", ""18071491"", ""616487153"", ""603325752"", ""78141692"", ""318033614"", ""24500370"", ""2437432268"", ""85738930"", ""40510113"", ""89496588"", ""59849033"", ""225973025"", ""239468506"", ""148294757"", ""25205108"", ""17839699"", ""230559975"", ""594244296"", ""277170191"", ""510618861"", ""147698423"", ""19139294"", ""405907885"", ""21462959"", ""35976790"", ""341218338"", ""9906832"", ""11243562"", ""423030329"", ""2193454440"", ""768572234"", ""85475834"", ""45692925"", ""20371573"", ""28441804"", ""300022396"", ""127880271"", ""63216669"", ""193502956"", ""251275638"", ""16857062"", ""61934810"", ""354153453"", ""28921274"", ""33362069"", ""23595470"", ""574857684"", ""58688630"", ""1593847680"", ""253684109"", ""218277549"", ""20276783"", ""223529716"", ""173880712"", ""18706489"", ""2668504154"", ""245616757"", ""272482589"", ""27749633"", ""47670643"", ""15089443"", ""269611109"", ""178332153"", ""17718055"", ""18539636"", ""83039463"", ""23157920"", ""205309206"", ""2600422130"", ""467296247"", ""29779206"", ""85206476"", ""347658701"", ""415948705"", ""402355096"", ""235239752"", ""2285764364"", ""594886554"", ""29566188"", ""2246264102"", ""2424639619"", ""18076044"", ""89620180"", ""77149442"", ""321221521"", ""2307703730"", ""21117305"", ""19209645"", ""2659203561"", ""35742668"", ""270669135"", ""59346212"", ""25076611"", ""24426438"", ""22634280"", ""560769351"", ""524559281"", ""1026948386"", ""65508187"", ""17901210"", ""217118762"", ""310547809"", ""319750177"", ""64147321"", ""625972479"", ""219284591"", ""291870520"", ""817875133"", ""17581953"", ""24919031"", ""24924289"", ""16569663"", ""231113186"", ""1590205748"", ""455093636"", ""1079477755"", ""144011698"", ""51035332"", ""25122847"", ""2550739890"", ""587926686"", ""41384350"", ""2637017027"", ""19880027"", ""94894401"", ""1447854313"", ""2419324656"", ""328741255"", ""14372270"", ""21170747"", ""26339945"", ""16437620"", ""537472373"", ""21709722"", ""419139650"", ""2291536631"", ""54143755"", ""43524347"", ""235119199"", ""2369193094"", ""265188139"", ""28580555"", ""34758206"", ""325726862"", ""1518076123"", ""20119758"", ""329880006"", ""18389705"", ""1267260163"", ""15238891"", ""592508646"", ""44053666"", ""168723003"", ""21957401"", ""2400937064"", ""700117815"", ""67929450"", ""372586179"", ""284869173"", ""798151213"", ""981050484"", ""207740748"", ""82682487"", ""66302067"", ""17941979"", ""19088288"", ""41423901"", ""1496530303"", ""38496696"", ""322925467"", ""42880864"", ""1489276530"", ""66289119"", ""571796080"", ""1638674964"", ""31878193"", ""2190736884"", ""423569073""]",13,30,43
25122847,2,126.0,-0.2529226541519165,6356986.0,2,1.0,"[""ottawashooting-all-rnr-threads"", ""ferguson-all-rnr-threads""]","[""51241574"", ""24165761""]",2,0,2
537472373,3,130.33333333333334,-0.203696608543396,6358236.0,3,0.6666666666666666,"[""ottawashooting-all-rnr-threads"", ""ferguson-all-rnr-threads""]","[""292777349"", ""24165761"", ""1507338108""]",2,1,3
2373123864,10,74.8,-0.25337435603141784,6388442.0,6,0.3,"[""ottawashooting-all-rnr-threads"", ""ferguson-all-rnr-threads""]","[""75584076"", ""472778354"", ""15249499"", ""14722589"", ""537612240"", ""106272927""]",3,7,10
501522646,2,96.5,-0.011960923671722412,10971453.0,2,0.5,"[""sydneysiege-all-rnr-threads"", ""ferguson-all-rnr-threads""]","[""472778354"", ""153029181""]",1,1,2
536980961,4,105.25,-0.7246902585029602,10955748.0,3,0.5,"[""sydneysiege-all-rnr-threads"", ""ferguson-all-rnr-threads""]","[""2799960092"", ""1381926373"", ""16589206""]",2,2,4
231720660,3,102.66666666666667,-0.06344644228617351,11009613.0,2,0.6666666666666666,"[""sydneysiege-all-rnr-threads"", ""ferguson-all-rnr-threads""]","[""156093276"", ""20402945""]",2,1,3
57620511,2,130.0,-0.6232457160949707,6309054.0,2,0.5,"[""ottawashooting-all-rnr-threads"", ""ferguson-all-rnr-threads""]","[""21660529"", ""1291770157""]",1,1,2
571796080,2,57.5,-0.38904184103012085,19642566.0,2,1.0,"[""germanwings-crash-all-rnr-threads"", ""ferguson-all-rnr-threads""]","[""146332990"", ""24165761""]",2,0,2
594244296,6,74.16666666666667,-0.25683414936065674,10965903.0,3,0.8333333333333334,"[""sydneysiege-all-rnr-threads"", ""ferguson-all-rnr-threads""]","[""14173315"", ""24165761"", ""168843567""]",5,1,6
16499261,7,63.714285714285715,-0.06592317989894322,19523151.0,7,0.2857142857142857,"[""germanwings-crash-all-rnr-threads"", ""ottawashooting-all-rnr-threads"", ""ferguson-all-rnr-threads""]","[""230527949"", ""558251172"", ""8071902"", ""14437914"", ""11265832"", ""33092289"", ""23937894""]",2,5,7
377540405,5,73.0,0.18825962543487548,10658820.0,5,0.4,"[""sydneysiege-all-rnr-threads"", ""ferguson-all-rnr-threads""]","[""53503202"", ""18424289"", ""64643056"", ""770759270"", ""17072206""]",2,3,5
233227011,4,93.0,-0.2528543770313263,6104859.0,3,0.5,"[""ottawashooting-all-rnr-threads"", ""ferguson-all-rnr-threads""]","[""52299545"", ""635608354"", ""14090948""]",2,2,4
19808025,13,96.6923076923077,-0.13265351148752066,6359066.0,5,0.6923076923076923,"[""ottawashooting-all-rnr-threads"", ""ferguson-all-rnr-threads""]","[""304695261"", ""14700316"", ""52299545"", ""375721095"", ""14321959""]",9,4,13
511276619,2,101.5,-0.19876545667648315,10691137.0,2,1.0,"[""sydneysiege-all-rnr-threads"", ""ferguson-all-rnr-threads""]","[""15951232"", ""258627226""]",2,0,2
420351613,6,96.0,-0.29963187376658124,6070139.0,3,0.5,"[""ottawashooting-all-rnr-threads"", ""ferguson-all-rnr-threads""]","[""380118903"", ""225235528"", ""22990962""]",3,3,6
2227563385,2,91.5,-0.34891507029533386,10674910.0,2,0.5,"[""sydneysiege-all-rnr-threads"", ""ferguson-all-rnr-threads""]","[""35051304"", ""15754281""]",1,1,2
15421689,4,83.25,-0.258332222700119,19256379.0,4,0.75,"[""germanwings-crash-all-rnr-threads"", ""ferguson-all-rnr-threads""]","[""16343974"", ""15754281"", ""2295172961"", ""14722589""]",3,1,4
49489453,4,103.25,-0.4625733196735382,10704503.0,2,0.25,"[""sydneysiege-all-rnr-threads"", ""ferguson-all-rnr-threads""]","[""5402612"", ""14090948""]",1,3,4
64704431,15,123.2,-0.28213926951090496,10744783.0,5,0.13333333333333333,"[""sydneysiege-all-rnr-threads"", ""ferguson-all-rnr-threads""]","[""6273552"", ""245689692"", ""14090948"", ""1367531"", ""14321959""]",2,13,15
1554738476,10,110.9,-0.5225003600120545,10664523.0,4,0.2,"[""ottawashooting-all-rnr-threads"", ""sydneysiege-all-rnr-threads"", ""ferguson-all-rnr-threads""]","[""1716581"", ""18510860"", ""15727317"", ""15232098""]",2,8,10
926383879,6,114.83333333333333,-0.061458865801493325,18811733.0,4,0.3333333333333333,"[""sydneysiege-all-rnr-threads"", ""putinmissing-all-rnr-threads"", ""ferguson-all-rnr-threads""]","[""2467791"", ""26642006"", ""64643056"", ""14090948""]",2,4,6
28025132,3,91.66666666666667,-0.10832291841506958,10637816.0,3,0.6666666666666666,"[""sydneysiege-all-rnr-threads"", ""ferguson-all-rnr-threads""]","[""386815916"", ""292777349"", ""26642006""]",2,1,3
954124423,22,120.63636363636364,-0.32547927444631397,10723063.0,178,0.18181818181818182,"[""ottawashooting-all-rnr-threads"", ""sydneysiege-all-rnr-threads"", ""ferguson-all-rnr-threads""]","[""769025252"", ""2413570074"", ""1949581752"", ""1544724236"", ""2733290461"", ""931481438"", ""812215344"", ""704314353"", ""21899643"", ""406572303"", ""465869718"", ""191181271"", ""437032241"", ""175315245"", ""214248119"", ""15917046"", ""1287138295"", ""42266389"", ""2903158613"", ""2519248833"", ""714479834"", ""48961660"", ""755753"", ""1037823200"", ""203351858"", ""929047183"", ""76827698"", ""1615751540"", ""2377792170"", ""241220025"", ""155014623"", ""2817247473"", ""249792459"", ""551490129"", ""599669264"", ""170460968"", ""21839593"", ""2288952867"", ""42858240"", ""2586237344"", ""2453875235"", ""231181451"", ""2554278218"", ""125562479"", ""902814223"", ""2601118704"", ""94205731"", ""407785990"", ""183832473"", ""365163772"", ""198967695"", ""451361654"", ""259204800"", ""472539555"", ""345674259"", ""168079027"", ""580041801"", ""2327677776"", ""1177632823"", ""347291458"", ""19609504"", ""2820702651"", ""567716654"", ""623338911"", ""2548499490"", ""1188547537"", ""1786019359"", ""15971518"", ""1955527824"", ""52368836"", ""1413943087"", ""1655392543"", ""479975654"", ""16294014"", ""735218466"", ""1374607968"", ""2795244379"", ""40189359"", ""21965432"", ""364538685"", ""31288110"", ""9151952"", ""25514627"", ""299201978"", ""954124423"", ""18790732"", ""2886586060"", ""70640483"", ""96447622"", ""71362507"", ""1373836093"", ""369820501"", ""53522276"", ""38589890"", ""974967601"", ""53949049"", ""1634077976"", ""577858931"", ""433092233"", ""89110504"", ""2663403486"", ""485322000"", ""2746979823"", ""267959196"", ""2752192451"", ""2272141723"", ""1447161560"", ""2514570686"", ""949208503"", ""34874047"", ""36700664"", ""472155463"", ""801505615"", ""2214792078"", ""2872417164"", ""262604384"", ""7737022"", ""98764683"", ""218218274"", ""277501298"", ""1411444166"", ""898296218"", ""68956490"", ""251440033"", ""240076272"", ""204339253"", ""19415168"", ""1702513849"", ""26326842"", ""2728395787"", ""2315583427"", ""55507343"", ""1408969734"", ""83269201"", ""1576848104"", ""2419558070"", ""320027703"", ""27798388"", ""467891465"", ""48187277"", ""876387678"", ""1292562066"", ""2770582499"", ""1596575564"", ""2740521853"", ""2435296872"", ""2412564816"", ""22446355"", ""200599429"", ""459222454"", ""711209869"", ""1339382407"", ""151434202"", ""1011588685"", ""2677984489"", ""1016173116"", ""1242171468"", ""2558058282"", ""104890099"", ""1281299610"", ""1205107171"", ""28086543"", ""205024182"", ""1025614039"", ""594221885"", ""314755110"", ""274172634"", ""1247976301"", ""2625174307"", ""2452737751"", ""41572045"", ""45265619"", ""633482691"", ""2328752058"", ""352859537"", ""2835341775"", ""2193750641"", ""707242468""]",4,18,22
15917046,2,70.5,0.019392669200897217,19465824.0,2,1.0,"[""germanwings-crash-all-rnr-threads"", ""ferguson-all-rnr-threads""]","[""72882689"", ""954124423""]",2,0,2
20374262,4,110.0,-0.3860187381505966,6014564.0,20,0.75,"[""ottawashooting-all-rnr-threads"", ""ferguson-all-rnr-threads""]","[""16076032"", ""721623512"", ""1357424546"", ""1434070423"", ""181907408"", ""20374262"", ""41304041"", ""731006232"", ""1630276992"", ""2700017729"", ""88279736"", ""16296799"", ""387587226"", ""338005354"", ""2491244870"", ""865767043"", ""181581707"", ""41831995"", ""1477840074"", ""22348588""]",3,1,4
338005354,6,105.66666666666667,-0.14871363838513693,10664714.0,6,0.3333333333333333,"[""sydneysiege-all-rnr-threads"", ""ferguson-all-rnr-threads""]","[""23831448"", ""202934450"", ""15249499"", ""14090948"", ""18294906"", ""20374262""]",2,4,6
714272731,2,133.5,-0.1820019781589508,10542565.0,2,0.5,"[""sydneysiege-all-rnr-threads"", ""ferguson-all-rnr-threads""]","[""14173315"", ""3108351""]",1,1,2
464329417,19,70.36842105263158,-0.3444532971633108,10698775.0,13,0.5263157894736842,"[""sydneysiege-all-rnr-threads"", ""ferguson-all-rnr-threads""]","[""14173315"", ""193395018"", ""19881665"", ""325076723"", ""15727317"", ""15956067"", ""1291770157"", ""2173646835"", ""292777349"", ""235610395"", ""325265073"", ""1381926373"", ""366066427""]",10,9,19
183960617,3,130.66666666666666,-0.44251076380411786,10543530.0,3,0.3333333333333333,"[""sydneysiege-all-rnr-threads"", ""ferguson-all-rnr-threads""]","[""14173315"", ""16973333"", ""409941587""]",1,2,3
147618542,2,120.5,-0.45949018001556396,19099604.0,2,1.0,"[""germanwings-crash-all-rnr-threads"", ""ferguson-all-rnr-threads""]","[""5402612"", ""14090948""]",2,0,2
122027688,10,64.4,-0.3246740400791169,6040120.0,6,0.4,"[""ottawashooting-all-rnr-threads"", ""ferguson-all-rnr-threads""]","[""19636948"", ""26642006"", ""759251"", ""1507338108"", ""73716850"", ""100136358""]",4,6,10
348661583,9,84.55555555555556,-0.21748917632632786,6266361.0,6,0.1111111111111111,"[""ottawashooting-all-rnr-threads"", ""ferguson-all-rnr-threads""]","[""1716581"", ""61149653"", ""14090948"", ""2725579568"", ""15157939"", ""62510409""]",1,8,9
237011341,4,79.0,-0.47942905128002167,5891135.0,4,0.75,"[""ottawashooting-all-rnr-threads"", ""ferguson-all-rnr-threads""]","[""2725579568"", ""179732982"", ""42389136"", ""2467791""]",3,1,4
387116197,2,133.5,-0.42098572850227356,10505947.0,2,0.5,"[""sydneysiege-all-rnr-threads"", ""ferguson-all-rnr-threads""]","[""2725579568"", ""1093638847""]",1,1,2
54113109,2,62.5,-0.5256673097610474,10540626.0,2,1.0,"[""sydneysiege-all-rnr-threads"", ""ferguson-all-rnr-threads""]","[""2725579568"", ""292777349""]",2,0,2
1434392514,6,71.5,-0.2302140792210897,10540457.0,3,0.5,"[""sydneysiege-all-rnr-threads"", ""ferguson-all-rnr-threads""]","[""13393052"", ""2725579568"", ""292777349""]",3,3,6
80919423,8,82.375,-0.1888907179236412,6016042.0,6,0.375,"[""ottawashooting-all-rnr-threads"", ""ferguson-all-rnr-threads""]","[""14090948"", ""16076032"", ""183341278"", ""14681605"", ""33092289"", ""274831602""]",3,5,8
54372224,2,105.0,-0.07677659392356873,5904542.0,2,1.0,"[""ottawashooting-all-rnr-threads"", ""ferguson-all-rnr-threads""]","[""1367531"", ""17983365""]",2,0,2
63144098,16,140.31249999999997,-0.5623123720288277,5905003.0,32,0.9375,"[""ottawashooting-all-rnr-threads"", ""ferguson-all-rnr-threads""]","[""472629659"", ""25588490"", ""42657110"", ""16631024"", ""81387499"", ""402977147"", ""15864609"", ""310053009"", ""14731096"", ""281765208"", ""47554499"", ""26070572"", ""17545469"", ""519076313"", ""464308569"", ""18286742"", ""73333278"", ""259626002"", ""542947234"", ""32052180"", ""80748017"", ""21728303"", ""63144098"", ""513774875"", ""770423912"", ""1667861336"", ""21969052"", ""450175106"", ""2217173300"", ""18392987"", ""16260811"", ""2779835956""]",15,1,16
31493602,2,100.5,-0.15213388204574585,10499649.0,2,1.0,"[""sydneysiege-all-rnr-threads"", ""ferguson-all-rnr-threads""]","[""7309052"", ""256363817""]",2,0,2
15649636,15,110.66666666666667,-0.5935258110364278,11015649.0,10,0.26666666666666666,"[""sydneysiege-all-rnr-threads"", ""ferguson-all-rnr-threads""]","[""56539746"", ""1363520268"", ""111157878"", ""1291770157"", ""30699754"", ""159210283"", ""14849562"", ""7768402"", ""14090948"", ""15644999""]",4,11,15
2391992534,2,92.0,-0.5596608519554138,10540439.0,2,1.0,"[""sydneysiege-all-rnr-threads"", ""ferguson-all-rnr-threads""]","[""2725579568"", ""7587032""]",2,0,2
33128909,2,71.5,-0.5707947313785553,10493720.0,2,0.5,"[""sydneysiege-all-rnr-threads"", ""ferguson-all-rnr-threads""]","[""2725579568"", ""20512260""]",1,1,2
19881665,3,118.0,-0.268144170443217,5879206.0,26,1.0,"[""ottawashooting-all-rnr-threads"", ""ferguson-all-rnr-threads""]","[""139204419"", ""159307306"", ""213737341"", ""28010994"", ""139971759"", ""19922927"", ""267121955"", ""2814031933"", ""172788483"", ""274509093"", ""173514323"", ""80749580"", ""727624304"", ""1408964976"", ""19881665"", ""460083773"", ""562543082"", ""385009428"", ""280266544"", ""22960124"", ""755068274"", ""151893949"", ""21102920"", ""159324196"", ""464329417"", ""77677764""]",3,0,3
312149882,2,110.0,-0.28772109746932983,18247977.0,2,1.0,"[""putinmissing-all-rnr-threads"", ""ferguson-all-rnr-threads""]","[""171226960"", ""2331321349""]",2,0,2
22982919,8,87.75,0.04245413839817047,5886799.0,5,0.875,"[""ottawashooting-all-rnr-threads"", ""ferguson-all-rnr-threads""]","[""16116288"", ""34123611"", ""14090948"", ""1716581"", ""23937894""]",7,1,8
18931723,2,130.0,-0.46794116497039795,10531316.0,2,0.5,"[""sydneysiege-all-rnr-threads"", ""ferguson-all-rnr-threads""]","[""1020058453"", ""325076723""]",1,1,2
161185849,2,111.0,-0.5926527380943298,10506457.0,2,0.5,"[""sydneysiege-all-rnr-threads"", ""ferguson-all-rnr-threads""]","[""17741799"", ""325076723""]",1,1,2
1149698588,2,54.0,0.20979422330856323,10536386.0,2,0.5,"[""sydneysiege-all-rnr-threads"", ""ferguson-all-rnr-threads""]","[""491960101"", ""15727317""]",1,1,2
438042918,5,118.4,-0.480040454864502,10491278.0,3,0.8,"[""sydneysiege-all-rnr-threads"", ""ferguson-all-rnr-threads""]","[""972651"", ""16930489"", ""16675569""]",4,1,5
15220768,3,107.66666666666667,-0.2465058962504069,10493354.0,24,1.0,"[""sydneysiege-all-rnr-threads"", ""ferguson-all-rnr-threads""]","[""386295882"", ""149445814"", ""1459992518"", ""16068266"", ""2752298752"", ""390876177"", ""485832450"", ""728048323"", ""515047062"", ""1542193098"", ""16847735"", ""1471178664"", ""930776624"", ""15220768"", ""464308569"", ""1703908958"", ""956452369"", ""300325603"", ""999109980"", ""71530832"", ""36616650"", ""1175626836"", ""417649013"", ""21803786""]",3,0,3
310845198,2,138.0,-0.32978755235671997,5914368.0,2,0.5,"[""ottawashooting-all-rnr-threads"", ""ferguson-all-rnr-threads""]","[""12520212"", ""148116121""]",1,1,2
414123074,7,106.42857142857143,-0.331722549029759,5880161.0,2,0.8571428571428571,"[""ottawashooting-all-rnr-threads"", ""ferguson-all-rnr-threads""]","[""14173315"", ""28785486""]",6,1,7
329976431,17,116.41176470588235,-0.4494665335206425,19217816.0,2,1.0,"[""germanwings-crash-all-rnr-threads"", ""ferguson-all-rnr-threads""]","[""14173315"", ""7309052""]",17,0,17
448043662,10,99.9,-0.2838667035102844,6360944.0,10,0.2,"[""ottawashooting-all-rnr-threads"", ""ferguson-all-rnr-threads""]","[""325076723"", ""45632111"", ""386815916"", ""46562247"", ""64643056"", ""14090948"", ""14940354"", ""15932715"", ""279390084"", ""16948493""]",2,8,10
36487440,2,100.0,-0.2139958143234253,10502993.0,5,0.5,"[""sydneysiege-all-rnr-threads"", ""ferguson-all-rnr-threads""]","[""496560218"", ""342527913"", ""68036352"", ""18277208"", ""37881687""]",1,1,2
335989040,12,109.25,-0.3852887650330861,10931057.0,8,0.3333333333333333,"[""sydneysiege-all-rnr-threads"", ""ferguson-all-rnr-threads""]","[""24795163"", ""124227622"", ""183341278"", ""195271137"", ""14849562"", ""30357467"", ""16834659"", ""1947301""]",4,8,12
16116288,10,120.9,-0.3728529691696167,6057508.0,62,0.5,"[""ottawashooting-all-rnr-threads"", ""ferguson-all-rnr-threads""]","[""290197802"", ""244033117"", ""54111299"", ""1590030210"", ""35463616"", ""36245078"", ""1049586888"", ""22532025"", ""164577734"", ""15996661"", ""360363286"", ""69940000"", ""17004825"", ""16116288"", ""632384049"", ""1490861336"", ""390147741"", ""20595487"", ""22600982"", ""377636445"", ""2176271091"", ""298623412"", ""148908323"", ""422423631"", ""57567739"", ""15240581"", ""68036352"", ""720725023"", ""800748296"", ""47258222"", ""21793041"", ""27368386"", ""66591925"", ""29836529"", ""16954803"", ""80498163"", ""16742973"", ""1037823200"", ""22982919"", ""91129689"", ""937592917"", ""28432642"", ""464881483"", ""115845179"", ""451003296"", ""149899057"", ""32686128"", ""369785880"", ""312248392"", ""194180198"", ""29101624"", ""385195998"", ""18540336"", ""137604920"", ""789430788"", ""2293915237"", ""151110235"", ""1013967798"", ""13557782"", ""22634280"", ""155285081"", ""21055919""]",5,5,10
369785880,2,110.5,-0.4254531264305115,10504008.0,2,0.5,"[""sydneysiege-all-rnr-threads"", ""ferguson-all-rnr-threads""]","[""16116288"", ""5402612""]",1,1,2
15996661,11,104.0,-0.33950402519919654,5874048.0,103,0.45454545454545453,"[""ottawashooting-all-rnr-threads"", ""ferguson-all-rnr-threads""]","[""2434102818"", ""22816125"", ""15840592"", ""345178599"", ""65842968"", ""204660784"", ""1717016598"", ""16108144"", ""25783136"", ""419064940"", ""172788483"", ""15032724"", ""909434454"", ""290350396"", ""21218144"", ""423321195"", ""46180637"", ""19940700"", ""164753964"", ""23401995"", ""1395668034"", ""2300242908"", ""83678564"", ""1425980648"", ""89873752"", ""36030521"", ""83419103"", ""34676481"", ""115984673"", ""15996661"", ""2732777130"", ""68381433"", ""90293119"", ""363221461"", ""334927210"", ""51971488"", ""27145066"", ""241009723"", ""80039905"", ""367841153"", ""2742124039"", ""253696338"", ""415281888"", ""117083240"", ""79810128"", ""194180198"", ""35888237"", ""16649226"", ""28101457"", ""28161551"", ""26793112"", ""34297193"", ""16554704"", ""350533834"", ""23375372"", ""388365142"", ""300549289"", ""461080033"", ""57567739"", ""267959196"", ""60841112"", ""189352881"", ""830093588"", ""33947719"", ""18517790"", ""16668536"", ""1054178809"", ""350646003"", ""2627233757"", ""2541678318"", ""935922770"", ""140673612"", ""236051765"", ""1398275840"", ""954180344"", ""24329352"", ""4207961"", ""112551008"", ""19464711"", ""16116288"", ""68311871"", ""1573285621"", ""2724282976"", ""942122522"", ""115154803"", ""1289848416"", ""89245529"", ""2229309662"", ""68059145"", ""536415435"", ""259796910"", ""353984748"", ""242967923"", ""2470970083"", ""416009248"", ""2741417919"", ""344400627"", ""43439767"", ""544465827"", ""22800893"", ""107886768"", ""79481809"", ""23651451""]",5,6,11
419064940,4,116.5,0.012043774127960205,18312380.0,3,0.75,"[""ottawashooting-all-rnr-threads"", ""putinmissing-all-rnr-threads"", ""ferguson-all-rnr-threads""]","[""15996661"", ""2752307136"", ""363879015""]",3,1,4
2379135360,5,135.2,-0.4756248354911804,10560973.0,2,0.4,"[""sydneysiege-all-rnr-threads"", ""ferguson-all-rnr-threads""]","[""1231224926"", ""14090948""]",2,3,5
1010456808,7,63.0,-0.09547279562268939,10448403.0,2,1.0,"[""sydneysiege-all-rnr-threads"", ""ferguson-all-rnr-threads""]","[""51241574"", ""360129829""]",7,0,7
17300548,11,118.81818181818181,-0.0803640593181957,6042428.0,6,0.45454545454545453,"[""ottawashooting-all-rnr-threads"", ""ferguson-all-rnr-threads""]","[""8736882"", ""183341278"", ""360129829"", ""53503202"", ""19038934"", ""41479334""]",5,6,11
2412689935,5,130.2,-0.15928294658660888,5841540.0,2,0.8,"[""ottawashooting-all-rnr-threads"", ""ferguson-all-rnr-threads""]","[""16106522"", ""360129829""]",4,1,5
211280553,8,125.0,-0.09064368158578873,10715626.0,3,0.5,"[""ottawashooting-all-rnr-threads"", ""sydneysiege-all-rnr-threads"", ""ferguson-all-rnr-threads""]","[""18643437"", ""360129829"", ""5402612""]",4,4,8
174331939,38,110.15789473684211,-0.34193899443275055,10494904.0,2,0.9473684210526315,"[""sydneysiege-all-rnr-threads"", ""ferguson-all-rnr-threads""]","[""35051304"", ""195271137""]",36,2,38
16010285,2,112.5,-0.5983946025371552,10482777.0,2,1.0,"[""sydneysiege-all-rnr-threads"", ""ferguson-all-rnr-threads""]","[""16930489"", ""195271137""]",2,0,2
316161690,4,95.75,-0.34791260957717896,19388284.0,2,1.0,"[""germanwings-crash-all-rnr-threads"", ""ferguson-all-rnr-threads""]","[""17561562"", ""195271137""]",4,0,4
2233662300,14,108.21428571428571,-0.4143695192677634,5879798.0,5,1.0,"[""ottawashooting-all-rnr-threads"", ""ferguson-all-rnr-threads""]","[""635608354"", ""6433472"", ""17175457"", ""18999969"", ""1716581""]",14,0,14
15016500,2,133.0,-0.3267345428466797,10515682.0,2,1.0,"[""sydneysiege-all-rnr-threads"", ""ferguson-all-rnr-threads""]","[""14173315"", ""9609632""]",2,0,2
47052792,24,94.04166666666667,-0.2331956053773562,10520772.0,5,0.08333333333333333,"[""sydneysiege-all-rnr-threads"", ""ferguson-all-rnr-threads""]","[""14173315"", ""21467787"", ""119972954"", ""194732581"", ""21879831""]",2,22,24
137512422,4,108.0,-0.141734316945076,10493388.0,2,0.25,"[""sydneysiege-all-rnr-threads"", ""ferguson-all-rnr-threads""]","[""34210188"", ""2295172961""]",1,3,4
19009248,4,103.5,-0.4474171847105026,5894522.0,2,0.75,"[""ottawashooting-all-rnr-threads"", ""ferguson-all-rnr-threads""]","[""20772763"", ""51241574""]",3,1,4
388365142,2,88.5,-0.14546793699264526,5872510.0,2,0.5,"[""ottawashooting-all-rnr-threads"", ""ferguson-all-rnr-threads""]","[""20772763"", ""15996661""]",1,1,2
2573215164,4,120.75,-0.36424851417541504,10799351.0,2,0.25,"[""sydneysiege-all-rnr-threads"", ""ferguson-all-rnr-threads""]","[""20772763"", ""428333""]",1,3,4
92189292,2,66.0,-0.4984544515609741,10216694.0,2,0.5,"[""sydneysiege-all-rnr-threads"", ""ferguson-all-rnr-threads""]","[""20772763"", ""2799960092""]",1,1,2
903143731,9,94.0,-0.39848507112926906,10514429.0,4,0.7777777777777778,"[""ottawashooting-all-rnr-threads"", ""sydneysiege-all-rnr-threads"", ""ferguson-all-rnr-threads""]","[""14173315"", ""28785486"", ""1367531"", ""2836421""]",7,2,9
82682487,15,91.06666666666666,-0.20217997630437215,10976510.0,13,0.3333333333333333,"[""sydneysiege-all-rnr-threads"", ""ferguson-all-rnr-threads""]","[""14173315"", ""293227742"", ""24165761"", ""14722589"", ""2329395758"", ""386815916"", ""325265073"", ""14090948"", ""15012486"", ""325340909"", ""12004852"", ""16031927"", ""258627226""]",5,10,15
2222248950,20,113.8,-0.38380069434642794,5882802.0,2,0.1,"[""ottawashooting-all-rnr-threads"", ""ferguson-all-rnr-threads""]","[""293227742"", ""2467791""]",2,18,20
148066896,24,88.04166666666667,-0.17538915326197943,6097050.0,9,0.16666666666666666,"[""ottawashooting-all-rnr-threads"", ""ferguson-all-rnr-threads""]","[""15896580"", ""29995782"", ""22903265"", ""27172787"", ""14849562"", ""2467791"", ""14090948"", ""1716581"", ""17073225""]",4,20,24
632540961,7,97.85714285714286,-0.3356888805116926,10495026.0,3,0.7142857142857143,"[""sydneysiege-all-rnr-threads"", ""ferguson-all-rnr-threads""]","[""16992416"", ""15896580"", ""62510409""]",5,2,7
107886768,2,50.5,-0.270904004573822,5878256.0,2,0.5,"[""ottawashooting-all-rnr-threads"", ""ferguson-all-rnr-threads""]","[""15996661"", ""252794509""]",1,1,2
15840592,2,71.5,-0.44985970854759216,10544077.0,2,0.5,"[""sydneysiege-all-rnr-threads"", ""ferguson-all-rnr-threads""]","[""15996661"", ""292777349""]",1,1,2
813486180,2,59.0,-0.02412348985671997,19335005.0,2,1.0,"[""germanwings-crash-all-rnr-threads"", ""ferguson-all-rnr-threads""]","[""15754281"", ""29330030""]",2,0,2
28352458,2,138.5,-0.5514838993549347,5886801.0,2,1.0,"[""ottawashooting-all-rnr-threads"", ""ferguson-all-rnr-threads""]","[""6017542"", ""18643437""]",2,0,2
102271403,4,68.0,-0.46392664313316345,10753951.0,3,0.5,"[""sydneysiege-all-rnr-threads"", ""ferguson-all-rnr-threads""]","[""156464691"", ""1381926373"", ""18643437""]",2,2,4
2708897486,6,110.5,-0.3714740574359894,10718125.0,2,0.16666666666666666,"[""sydneysiege-all-rnr-threads"", ""ferguson-all-rnr-threads""]","[""312696314"", ""18643437""]",1,5,6
520882800,4,92.5,-0.18193334341049194,10507312.0,3,0.75,"[""sydneysiege-all-rnr-threads"", ""ferguson-all-rnr-threads""]","[""15907183"", ""2193946021"", ""18643437""]",3,1,4
118953812,6,94.0,-0.06656624873479207,10715506.0,5,0.6666666666666666,"[""sydneysiege-all-rnr-threads"", ""ferguson-all-rnr-threads""]","[""16145763"", ""34556109"", ""119972954"", ""43182702"", ""27754737""]",4,2,6
1485225582,24,124.375,-0.20181245356798172,10650879.0,8,0.041666666666666664,"[""sydneysiege-all-rnr-threads"", ""ferguson-all-rnr-threads""]","[""22021978"", ""27457454"", ""711348452"", ""282977213"", ""2163076560"", ""951837780"", ""119972954"", ""153029181""]",1,23,24
69329527,2,136.5,-0.3512769937515259,5871601.0,7,1.0,"[""ottawashooting-all-rnr-threads"", ""ferguson-all-rnr-threads""]","[""53826692"", ""22618913"", ""2796029406"", ""2607703608"", ""2282662302"", ""2822901832"", ""575851852""]",2,0,2
149751818,3,121.66666666666667,-0.17638508478800455,10676971.0,3,0.3333333333333333,"[""sydneysiege-all-rnr-threads"", ""ferguson-all-rnr-threads""]","[""135604500"", ""279390084"", ""19865053""]",1,2,3
41109216,2,59.0,0.08559340238571167,5875453.0,2,0.5,"[""ottawashooting-all-rnr-threads"", ""ferguson-all-rnr-threads""]","[""1652541"", ""15108530""]",1,1,2
1305332574,3,74.0,-0.38725902636845905,5874655.0,2,1.0,"[""ottawashooting-all-rnr-threads"", ""ferguson-all-rnr-threads""]","[""15012486"", ""414488432""]",3,0,3
1525868310,3,99.66666666666667,-0.1443483034769694,5888245.0,2,0.6666666666666666,"[""ottawashooting-all-rnr-threads"", ""ferguson-all-rnr-threads""]","[""34556109"", ""156123647""]",2,1,3
248318637,5,91.6,-0.34688018560409545,10678710.0,3,0.2,"[""sydneysiege-all-rnr-threads"", ""ferguson-all-rnr-threads""]","[""20772763"", ""489475164"", ""34556109""]",1,4,5
326345757,2,93.5,0.10422533750534058,10444672.0,2,1.0,"[""sydneysiege-all-rnr-threads"", ""ferguson-all-rnr-threads""]","[""15669672"", ""16031927""]",2,0,2
344911215,2,81.5,-0.001870572566986084,10427434.0,2,1.0,"[""sydneysiege-all-rnr-threads"", ""ferguson-all-rnr-threads""]","[""3108351"", ""42389136""]",2,0,2
403466148,14,90.42857142857143,0.03258321114948818,5889667.0,3,0.8571428571428571,"[""ottawashooting-all-rnr-threads"", ""ferguson-all-rnr-threads""]","[""16745015"", ""253186785"", ""7768402""]",12,2,14
7310842,3,115.0,-0.647813618183136,19076816.0,3,0.6666666666666666,"[""germanwings-crash-all-rnr-threads"", ""ferguson-all-rnr-threads""]","[""972651"", ""380648579"", ""64643056""]",2,1,3
262486400,3,34.333333333333336,-0.24724779526392618,5873082.0,3,0.6666666666666666,"[""ottawashooting-all-rnr-threads"", ""ferguson-all-rnr-threads""]","[""51241574"", ""64643056"", ""2467791""]",2,1,3
175742582,5,46.4,-0.237288761138916,6984021.0,4,0.8,"[""ottawashooting-all-rnr-threads"", ""prince-toronto-all-rnr-threads"", ""ferguson-all-rnr-threads""]","[""19636948"", ""1223101"", ""64643056"", ""17001435""]",4,1,5
2256985338,3,78.0,-0.2755478819211324,18138484.0,3,0.3333333333333333,"[""putinmissing-all-rnr-threads"", ""ferguson-all-rnr-threads""]","[""109065990"", ""635608354"", ""64643056""]",1,2,3
1177749511,2,47.5,-0.5140612721443176,10524641.0,2,0.5,"[""sydneysiege-all-rnr-threads"", ""ferguson-all-rnr-threads""]","[""2097571"", ""16145763""]",1,1,2
13049362,5,105.2,-0.3790809869766235,10714822.0,57,0.6,"[""sydneysiege-all-rnr-threads"", ""ferguson-all-rnr-threads""]","[""2228276070"", ""2407651056"", ""60661595"", ""2226057733"", ""13049362"", ""224112143"", ""1098716166"", ""421203844"", ""222167018"", ""2907782807"", ""287956388"", ""417551564"", ""2400916177"", ""61071233"", ""870389288"", ""2293657723"", ""503602590"", ""1206610038"", ""854229588"", ""23282632"", ""159264037"", ""244749090"", ""431171274"", ""493642020"", ""198670181"", ""312929802"", ""228165682"", ""582467151"", ""860954334"", ""2766014673"", ""484535292"", ""1311958838"", ""239633509"", ""2268114339"", ""1563948967"", ""981050484"", ""588106298"", ""598130082"", ""343138314"", ""210958508"", ""18404061"", ""177402276"", ""335451850"", ""168546840"", ""214331024"", ""466131506"", ""261485439"", ""239561303"", ""2495244805"", ""119993581"", ""22837900"", ""299143631"", ""486791524"", ""1378354428"", ""63251769"", ""607531095"", ""1429430894""]",3,2,5
5822902,36,110.5,-0.37822426358858746,10662152.0,5,0.1111111111111111,"[""sydneysiege-all-rnr-threads"", ""ferguson-all-rnr-threads""]","[""30849103"", ""4207961"", ""158426909"", ""14849562"", ""216299334""]",4,32,36
25877017,4,55.25,-0.3577980101108551,10627980.0,3,0.5,"[""sydneysiege-all-rnr-threads"", ""ferguson-all-rnr-threads""]","[""17004618"", ""158426909"", ""14849562""]",2,2,4
326957691,4,77.0,-0.2705589532852173,6024202.0,3,0.25,"[""ottawashooting-all-rnr-threads"", ""ferguson-all-rnr-threads""]","[""7768402"", ""25516222"", ""21879831""]",1,3,4
18134063,4,126.0,-0.48158660531044006,10611668.0,3,0.5,"[""sydneysiege-all-rnr-threads"", ""ferguson-all-rnr-threads""]","[""16469809"", ""21785215"", ""14722589""]",2,2,4
16208179,3,81.33333333333333,-0.1203527847925822,5872496.0,3,0.6666666666666666,"[""ottawashooting-all-rnr-threads"", ""ferguson-all-rnr-threads""]","[""29643550"", ""158426909"", ""2467791""]",2,1,3
54578210,4,64.25,-0.09976497292518616,19524003.0,4,0.25,"[""germanwings-crash-all-rnr-threads"", ""ferguson-all-rnr-threads""]","[""65698096"", ""227837742"", ""103394588"", ""14090948""]",1,3,4
37359097,2,124.0,-0.2968999743461609,19067116.0,2,1.0,"[""germanwings-crash-all-rnr-threads"", ""ferguson-all-rnr-threads""]","[""3108351"", ""103394588""]",2,0,2
71638316,10,49.9,-0.094116473197937,10729739.0,6,0.4,"[""ottawashooting-all-rnr-threads"", ""sydneysiege-all-rnr-threads"", ""ferguson-all-rnr-threads""]","[""73251272"", ""15384969"", ""297602297"", ""807095"", ""134963200"", ""83310721""]",4,6,10
1095548593,4,43.25,-0.2664286643266678,5863235.0,2,1.0,"[""ottawashooting-all-rnr-threads"", ""ferguson-all-rnr-threads""]","[""51241574"", ""16145763""]",4,0,4
2729426545,2,129.0,-0.33240240812301636,5869178.0,2,0.5,"[""ottawashooting-all-rnr-threads"", ""ferguson-all-rnr-threads""]","[""29643550"", ""2779835956""]",1,1,2
202053759,3,60.333333333333336,-0.4890302817026774,10482369.0,3,0.3333333333333333,"[""sydneysiege-all-rnr-threads"", ""ferguson-all-rnr-threads""]","[""29643550"", ""573788425"", ""2163076560""]",1,2,3
50020778,3,123.0,-0.10126952330271403,10490907.0,2,1.0,"[""sydneysiege-all-rnr-threads"", ""ferguson-all-rnr-threads""]","[""29643550"", ""146765658""]",3,0,3
203788113,2,129.5,-0.1405409574508667,10505640.0,2,1.0,"[""sydneysiege-all-rnr-threads"", ""ferguson-all-rnr-threads""]","[""1716581"", ""51241574""]",2,0,2
201295178,5,100.6,-0.4504129528999329,19068951.0,4,0.6,"[""germanwings-crash-all-rnr-threads"", ""ottawashooting-all-rnr-threads"", ""ferguson-all-rnr-threads""]","[""14717197"", ""384438102"", ""19636948"", ""20748745""]",3,2,5
250365695,47,122.55319148936171,-0.05220368821570213,10691512.0,5,0.02127659574468085,"[""sydneysiege-all-rnr-threads"", ""ferguson-all-rnr-threads""]","[""9609632"", ""38736974"", ""500275955"", ""18643437"", ""489336004""]",1,46,47
2313976729,2,45.5,-0.3320692181587219,5888404.0,2,0.5,"[""ottawashooting-all-rnr-threads"", ""ferguson-all-rnr-threads""]","[""46822887"", ""64643056""]",1,1,2
42577934,12,129.91666666666666,-0.4975852171579997,10741723.0,8,0.3333333333333333,"[""ottawashooting-all-rnr-threads"", ""sydneysiege-all-rnr-threads"", ""ferguson-all-rnr-threads""]","[""154380211"", ""230527949"", ""1161902875"", ""159210283"", ""292777349"", ""14090948"", ""375721095"", ""274831602""]",4,8,12
246458133,3,117.33333333333333,-0.6798726121584574,19068907.0,3,0.6666666666666666,"[""germanwings-crash-all-rnr-threads"", ""ferguson-all-rnr-threads""]","[""14717197"", ""2566535282"", ""14293310""]",2,1,3
280082481,6,70.0,-0.3461027940114339,10485103.0,4,0.16666666666666666,"[""ottawashooting-all-rnr-threads"", ""sydneysiege-all-rnr-threads"", ""ferguson-all-rnr-threads""]","[""54791458"", ""7401202"", ""14464766"", ""216299334""]",1,5,6
1571239068,6,66.0,-0.16371377309163412,10712558.0,3,0.3333333333333333,"[""sydneysiege-all-rnr-threads"", ""ferguson-all-rnr-threads""]","[""8197942"", ""166329578"", ""61149653""]",2,4,6
898728732,5,107.6,-0.43386393785476685,10485263.0,1,0.2,"[""sydneysiege-all-rnr-threads"", ""ferguson-all-rnr-threads""]","[""373783051""]",1,4,5
2463735408,5,95.0,-0.23353220224380494,10699619.0,5,0.4,"[""sydneysiege-all-rnr-threads"", ""ferguson-all-rnr-threads""]","[""363767963"", ""8197942"", ""14849562"", ""14090948"", ""62510409""]",2,3,5
2735507191,3,135.0,-0.616534948348999,5846181.0,3,0.3333333333333333,"[""ottawashooting-all-rnr-threads"", ""ferguson-all-rnr-threads""]","[""235610395"", ""2779835956"", ""62510409""]",1,2,3
1203031308,2,88.0,-0.48413243889808655,10455107.0,2,1.0,"[""sydneysiege-all-rnr-threads"", ""ferguson-all-rnr-threads""]","[""373783051"", ""16930489""]",2,0,2
1656966026,2,144.0,-0.10477268695831299,10484195.0,2,0.5,"[""sydneysiege-all-rnr-threads"", ""ferguson-all-rnr-threads""]","[""373783051"", ""175452918""]",1,1,2
891449460,5,97.4,-0.16896015405654907,10507264.0,3,0.6,"[""ottawashooting-all-rnr-threads"", ""sydneysiege-all-rnr-threads"", ""ferguson-all-rnr-threads""]","[""373783051"", ""16012783"", ""2467791""]",3,2,5
21965432,3,92.0,-0.5222692092259725,10592560.0,3,0.6666666666666666,"[""sydneysiege-all-rnr-threads"", ""ferguson-all-rnr-threads""]","[""347451363"", ""1367531"", ""954124423""]",2,1,3
1739650556,6,95.33333333333333,0.005342841148376465,10663174.0,6,0.3333333333333333,"[""sydneysiege-all-rnr-threads"", ""ferguson-all-rnr-threads""]","[""7702542"", ""109065990"", ""69773058"", ""28785486"", ""469194846"", ""10168082""]",2,4,6
41410702,3,113.66666666666667,-0.3792315522829692,5861785.0,2,1.0,"[""ottawashooting-all-rnr-threads"", ""ferguson-all-rnr-threads""]","[""14560097"", ""51241574""]",3,0,3
17665712,13,81.0,-0.02293271743334257,10509390.0,5,0.38461538461538464,"[""sydneysiege-all-rnr-threads"", ""ferguson-all-rnr-threads""]","[""21748597"", ""23293734"", ""89347280"", ""1056552596"", ""14560097""]",5,8,13
403647191,2,140.0,-0.47531184554100037,19276114.0,31,0.5,"[""germanwings-crash-all-rnr-threads"", ""ferguson-all-rnr-threads""]","[""985906658"", ""212944599"", ""134667688"", ""2415939985"", ""2158922936"", ""86796377"", ""2286266389"", ""1670939658"", ""2175102080"", ""1488969002"", ""1933064365"", ""254831099"", ""1280657702"", ""2430108250"", ""217044098"", ""2938592060"", ""1476204271"", ""536881225"", ""248192138"", ""33408119"", ""417857701"", ""377440844"", ""425494511"", ""269000185"", ""88238377"", ""62886110"", ""2415142326"", ""267906861"", ""1722647352"", ""19356796"", ""2319485120""]",1,1,2
2415142326,2,131.0,-0.10566961765289307,19073395.0,2,0.5,"[""germanwings-crash-all-rnr-threads"", ""ferguson-all-rnr-threads""]","[""403647191"", ""18909186""]",1,1,2
86796377,6,114.5,0.09193011124928792,19048662.0,3,0.8333333333333334,"[""germanwings-crash-all-rnr-threads"", ""sydneysiege-all-rnr-threads"", ""ferguson-all-rnr-threads""]","[""34713362"", ""403647191"", ""1310201424""]",5,1,6
981657048,2,129.0,-0.2103574275970459,5856428.0,2,0.5,"[""ottawashooting-all-rnr-threads"", ""ferguson-all-rnr-threads""]","[""68577152"", ""179732982""]",1,1,2
166270542,4,85.75,-0.4379791021347046,6092789.0,4,0.5,"[""ottawashooting-all-rnr-threads"", ""ferguson-all-rnr-threads""]","[""179732982"", ""2173646835"", ""14715424"", ""47916714""]",2,2,4
1421389548,2,62.5,-0.5163084268569946,10512510.0,2,0.5,"[""sydneysiege-all-rnr-threads"", ""ferguson-all-rnr-threads""]","[""98627870"", ""2193946021""]",1,1,2
1296110076,7,108.71428571428571,-0.47419382844652447,10449636.0,2,0.5714285714285714,"[""sydneysiege-all-rnr-threads"", ""ferguson-all-rnr-threads""]","[""225235528"", ""1367531""]",4,3,7
20204796,2,62.5,0.06359946727752686,6364932.0,2,0.5,"[""ottawashooting-all-rnr-threads"", ""ferguson-all-rnr-threads""]","[""6433472"", ""14090948""]",1,1,2
70215330,2,123.0,-0.21155452728271484,6371890.0,2,0.5,"[""ottawashooting-all-rnr-threads"", ""ferguson-all-rnr-threads""]","[""19636948"", ""1921517718""]",1,1,2
56744139,3,102.0,-0.30195919672648114,11023813.0,2,0.0,"[""sydneysiege-all-rnr-threads"", ""ferguson-all-rnr-threads""]","[""45715838"", ""16948493""]",0,3,3
325340909,10,113.2,-0.24970370531082153,11019967.0,59,0.0,"[""sydneysiege-all-rnr-threads"", ""ferguson-all-rnr-threads""]","[""44398051"", ""43413125"", ""24249547"", ""49725600"", ""1110022212"", ""224484865"", ""2472872684"", ""222057107"", ""322005490"", ""325258622"", ""2597989744"", ""331377273"", ""325340909"", ""237606548"", ""29605320"", ""167581897"", ""877671313"", ""363221461"", ""23341160"", ""52358246"", ""382182278"", ""1046389207"", ""116625196"", ""390696780"", ""448462411"", ""707843085"", ""28837388"", ""253227521"", ""1410661256"", ""249829414"", ""332808656"", ""253928041"", ""547002258"", ""17562569"", ""167022877"", ""235438349"", ""23041713"", ""2559563383"", ""249792459"", ""1170950174"", ""2272209843"", ""192028165"", ""1575301334"", ""82682487"", ""285560338"", ""142107317"", ""2542528231"", ""267422956"", ""235239752"", ""15388615"", ""19088288"", ""405123364"", ""358918792"", ""346038501"", ""254410154"", ""117452952"", ""537807795"", ""350533834"", ""75666178""]",0,10,10
325258622,2,134.5,-0.3590488135814667,11030445.0,2,0.0,"[""sydneysiege-all-rnr-threads"", ""ferguson-all-rnr-threads""]","[""325340909"", ""1020058453""]",0,2,2
224484865,5,124.4,-0.4973696231842041,10966246.0,4,0.0,"[""sydneysiege-all-rnr-threads"", ""ferguson-all-rnr-threads""]","[""325340909"", ""22021978"", ""325265073"", ""82048287""]",0,5,5
217118762,8,108.875,-0.27464868128299713,6377488.0,7,0.125,"[""ottawashooting-all-rnr-threads"", ""ferguson-all-rnr-threads""]","[""8839632"", ""12004852"", ""16055389"", ""24165761"", ""25110374"", ""237606548"", ""472230937""]",1,7,8
73329423,3,70.33333333333333,-0.05291477839152018,6281281.0,3,0.0,"[""ottawashooting-all-rnr-threads"", ""ferguson-all-rnr-threads""]","[""18197912"", ""30599768"", ""21328706""]",0,3,3
20207633,2,125.5,0.20527833700180054,6310217.0,2,0.5,"[""ottawashooting-all-rnr-threads"", ""ferguson-all-rnr-threads""]","[""106272927"", ""30599768""]",1,1,2
616487153,3,60.333333333333336,-0.5308340589205424,19774780.0,2,0.0,"[""germanwings-crash-all-rnr-threads"", ""ferguson-all-rnr-threads""]","[""24165761"", ""227837742""]",0,3,3
24919031,4,117.75,-0.2926050275564194,10967752.0,4,0.25,"[""sydneysiege-all-rnr-threads"", ""ferguson-all-rnr-threads""]","[""11265832"", ""292777349"", ""1360789357"", ""24165761""]",1,3,4
613852418,2,110.0,-0.27896273136138916,11004188.0,2,0.0,"[""sydneysiege-all-rnr-threads"", ""ferguson-all-rnr-threads""]","[""24165761"", ""489336004""]",0,2,2
94894401,3,68.0,-0.6107684771219889,6295504.0,2,0.6666666666666666,"[""ottawashooting-all-rnr-threads"", ""ferguson-all-rnr-threads""]","[""24165761"", ""64643056""]",2,1,3
326978607,3,91.66666666666667,-0.32589670022328693,10961290.0,2,0.0,"[""sydneysiege-all-rnr-threads"", ""ferguson-all-rnr-threads""]","[""16930489"", ""20351594""]",0,3,3
14809234,2,130.5,-0.5765740275382996,10998900.0,2,0.0,"[""sydneysiege-all-rnr-threads"", ""ferguson-all-rnr-threads""]","[""24165761"", ""27453886""]",0,2,2
1267260163,3,103.66666666666667,-0.3034671147664388,6384213.0,2,0.6666666666666666,"[""ottawashooting-all-rnr-threads"", ""ferguson-all-rnr-threads""]","[""16343974"", ""24165761""]",2,1,3
75630518,2,89.0,-0.20514395833015442,6361017.0,2,0.5,"[""ottawashooting-all-rnr-threads"", ""ferguson-all-rnr-threads""]","[""380648579"", ""14090948""]",1,1,2
118545821,2,114.5,-0.4551898241043091,10954796.0,2,0.5,"[""sydneysiege-all-rnr-threads"", ""ferguson-all-rnr-threads""]","[""258627226"", ""14090948""]",1,1,2
405561109,5,129.4,-0.25398304462432864,10962396.0,3,0.0,"[""sydneysiege-all-rnr-threads"", ""ferguson-all-rnr-threads""]","[""183341278"", ""292777349"", ""14090948""]",0,5,5
15978136,2,115.0,-0.8870360255241394,19569181.0,2,0.5,"[""germanwings-crash-all-rnr-threads"", ""ferguson-all-rnr-threads""]","[""51241574"", ""1360789357""]",1,1,2
543410216,5,98.2,-0.027486133575439452,6376810.0,3,0.4,"[""ottawashooting-all-rnr-threads"", ""ferguson-all-rnr-threads""]","[""34310801"", ""21344944"", ""534675241""]",2,3,5
132275243,3,110.0,0.03882018725077311,19558279.0,4,0.3333333333333333,"[""germanwings-crash-all-rnr-threads"", ""ferguson-all-rnr-threads""]","[""717692852"", ""402355096"", ""134196350"", ""132275243""]",1,2,3
32491529,3,84.33333333333333,-0.009978254636128744,18622283.0,3,0.3333333333333333,"[""putinmissing-all-rnr-threads"", ""ferguson-all-rnr-threads""]","[""183341278"", ""14460241"", ""14090948""]",1,2,3
149666064,5,106.0,-0.3853847622871399,6349935.0,2,0.2,"[""ottawashooting-all-rnr-threads"", ""ferguson-all-rnr-threads""]","[""28785486"", ""14090948""]",1,4,5
1355675563,4,69.75,-0.3803536146879196,6365526.0,2,0.0,"[""ottawashooting-all-rnr-threads"", ""ferguson-all-rnr-threads""]","[""17469289"", ""14090948""]",0,4,4
902817020,2,88.0,-0.5095530152320862,19508862.0,2,0.0,"[""germanwings-crash-all-rnr-threads"", ""ferguson-all-rnr-threads""]","[""902200087"", ""22650211""]",0,2,2
2488864572,2,88.5,-0.6601948142051697,6357221.0,2,0.5,"[""ottawashooting-all-rnr-threads"", ""ferguson-all-rnr-threads""]","[""65860206"", ""64643056""]",1,1,2
65187918,3,91.33333333333333,-0.5422665874163309,10960013.0,3,0.0,"[""sydneysiege-all-rnr-threads"", ""ferguson-all-rnr-threads""]","[""25178222"", ""65860206"", ""711348452""]",0,3,3
15384969,2,109.0,-0.37274616956710815,10981474.0,22,0.0,"[""sydneysiege-all-rnr-threads"", ""ferguson-all-rnr-threads""]","[""31243157"", ""2850779146"", ""2877422308"", ""2486471330"", ""828527846"", ""1947347659"", ""33270656"", ""2929042915"", ""23022488"", ""2378914268"", ""2621261169"", ""74650000"", ""2897505267"", ""15480674"", ""311340378"", ""117333709"", ""2329666664"", ""14957784"", ""2835994142"", ""71638316"", ""2468946175"", ""2410945122""]",0,2,2
1687941666,8,79.25,0.13696721196174622,10986751.0,6,0.625,"[""sydneysiege-all-rnr-threads"", ""ferguson-all-rnr-threads""]","[""14173315"", ""171802941"", ""25110374"", ""543202426"", ""16675569"", ""15250661""]",5,3,8
1595149356,4,104.5,-0.15657666325569153,10961905.0,4,0.25,"[""sydneysiege-all-rnr-threads"", ""ferguson-all-rnr-threads""]","[""1367531"", ""774393817"", ""24165761"", ""19222164""]",1,3,4
1328400649,2,105.5,-0.1533660888671875,18633237.0,3,0.0,"[""putinmissing-all-rnr-threads"", ""ferguson-all-rnr-threads""]","[""53503202"", ""919069508"", ""749348659""]",0,2,2
2414457033,7,102.14285714285714,-0.4102384958948408,6339975.0,4,0.2857142857142857,"[""ottawashooting-all-rnr-threads"", ""ferguson-all-rnr-threads""]","[""225235528"", ""279390084"", ""1291770157"", ""742143""]",2,5,7
36631460,16,125.1875,-0.4894348382949828,10661105.0,3,0.0625,"[""sydneysiege-all-rnr-threads"", ""ferguson-all-rnr-threads""]","[""2836941830"", ""14267557"", ""14849562""]",1,15,16
59612303,3,94.33333333333333,-0.4563809037208557,10890971.0,3,0.3333333333333333,"[""sydneysiege-all-rnr-threads"", ""ferguson-all-rnr-threads""]","[""28785486"", ""15896580"", ""14090948""]",1,2,3
408194759,9,138.0,0.0029322968588935006,19763199.0,7,0.2222222222222222,"[""germanwings-crash-all-rnr-threads"", ""ottawashooting-all-rnr-threads"", ""ferguson-all-rnr-threads""]","[""1002161534"", ""12811952"", ""384438102"", ""28785486"", ""14849562"", ""14090948"", ""227837742""]",2,7,9
114115853,10,120.3,-0.16425683498382568,10888590.0,8,0.9,"[""ottawashooting-all-rnr-threads"", ""sydneysiege-all-rnr-threads"", ""ferguson-all-rnr-threads""]","[""14404725"", ""9609632"", ""2884771"", ""292777349"", ""18999969"", ""64643056"", ""22993014"", ""2768501""]",9,1,10
16569663,2,92.0,-0.19738459587097168,10944454.0,2,0.5,"[""sydneysiege-all-rnr-threads"", ""ferguson-all-rnr-threads""]","[""35466620"", ""24165761""]",1,1,2
2209778173,3,107.66666666666667,-0.05359351634979248,6330383.0,2,0.0,"[""ottawashooting-all-rnr-threads"", ""ferguson-all-rnr-threads""]","[""38156420"", ""14090948""]",0,3,3
69403710,3,67.66666666666667,-0.44956650336583454,19858843.0,2,0.6666666666666666,"[""germanwings-crash-all-rnr-threads"", ""ferguson-all-rnr-threads""]","[""279390084"", ""112874216""]",2,1,3
297106603,3,91.0,-0.4748426079750061,10930845.0,3,0.6666666666666666,"[""sydneysiege-all-rnr-threads"", ""ferguson-all-rnr-threads""]","[""51241574"", ""279390084"", ""1532402708""]",2,1,3
120843046,2,72.5,-0.40312886238098145,6208696.0,2,0.0,"[""ottawashooting-all-rnr-threads"", ""ferguson-all-rnr-threads""]","[""135604500"", ""252794509""]",0,2,2
33167405,3,85.66666666666667,0.62154487768809,9111024.0,2,0.3333333333333333,"[""gurlitt-all-rnr-threads"", ""ferguson-all-rnr-threads""]","[""28918980"", ""5513002""]",1,2,3
202883615,3,65.66666666666667,-0.13306927680969238,10951960.0,3,0.0,"[""sydneysiege-all-rnr-threads"", ""ferguson-all-rnr-threads""]","[""183341278"", ""39682124"", ""14090948""]",0,3,3
20719498,5,63.4,-0.3561252236366272,10913361.0,5,0.2,"[""sydneysiege-all-rnr-threads"", ""ferguson-all-rnr-threads""]","[""14090948"", ""2467791"", ""113038982"", ""237606548"", ""17068692""]",1,4,5
459581217,9,103.44444444444444,-0.35660678810543484,10908255.0,2,0.8888888888888888,"[""sydneysiege-all-rnr-threads"", ""ferguson-all-rnr-threads""]","[""972651"", ""15446551""]",8,1,9
2306993465,2,106.5,-0.4375600814819336,10879927.0,2,0.5,"[""sydneysiege-all-rnr-threads"", ""ferguson-all-rnr-threads""]","[""1700366010"", ""20402945""]",1,1,2
1054178809,5,89.8,-0.010544657707214355,10902351.0,3,0.2,"[""ottawashooting-all-rnr-threads"", ""sydneysiege-all-rnr-threads"", ""ferguson-all-rnr-threads""]","[""17919393"", ""15996661"", ""14722589""]",1,4,5
250435493,2,96.5,-0.23745641112327576,10899318.0,2,0.0,"[""sydneysiege-all-rnr-threads"", ""ferguson-all-rnr-threads""]","[""153029181"", ""14722589""]",0,2,2
2401371607,2,95.5,-0.48197197914123535,10929600.0,2,0.0,"[""sydneysiege-all-rnr-threads"", ""ferguson-all-rnr-threads""]","[""16973333"", ""51330975""]",0,2,2
119598568,2,139.0,-0.2517353296279907,10943571.0,2,0.0,"[""sydneysiege-all-rnr-threads"", ""ferguson-all-rnr-threads""]","[""224135257"", ""283235743""]",0,2,2
15576378,3,67.33333333333333,-0.030424217383066814,6287932.0,2,0.0,"[""ottawashooting-all-rnr-threads"", ""ferguson-all-rnr-threads""]","[""14216661"", ""14090948""]",0,3,3
44799544,3,111.66666666666667,-0.2289999524752299,6289602.0,2,0.3333333333333333,"[""ottawashooting-all-rnr-threads"", ""ferguson-all-rnr-threads""]","[""289998339"", ""14090948""]",1,2,3
224494638,2,138.0,0.13084626197814941,10753172.0,2,0.0,"[""sydneysiege-all-rnr-threads"", ""ferguson-all-rnr-threads""]","[""48132847"", ""16973333""]",0,2,2
539573373,30,109.56666666666666,-0.03706369002660116,6126479.0,6,0.03333333333333333,"[""ottawashooting-all-rnr-threads"", ""ferguson-all-rnr-threads""]","[""15727317"", ""8839632"", ""183341278"", ""364423298"", ""42389136"", ""166710918""]",1,29,30
869049313,8,111.875,-0.5086982324719429,10726001.0,6,0.0,"[""sydneysiege-all-rnr-threads"", ""ferguson-all-rnr-threads""]","[""202934450"", ""53044031"", ""364423298"", ""14849562"", ""755113"", ""14321959""]",0,8,8
2884771,7,106.71428571428571,-0.3631651656968253,19440020.0,43,0.2857142857142857,"[""germanwings-crash-all-rnr-threads"", ""sydneysiege-all-rnr-threads"", ""ferguson-all-rnr-threads""]","[""137730692"", ""73770059"", ""70709294"", ""2884771"", ""1953293646"", ""2392272516"", ""298729426"", ""537670884"", ""272074959"", ""2157467431"", ""82217826"", ""114115853"", ""1606784557"", ""15126924"", ""119557737"", ""22603238"", ""257097574"", ""211351856"", ""465833678"", ""326454163"", ""23781293"", ""1053271752"", ""80498163"", ""462304488"", ""62591883"", ""240555684"", ""588759992"", ""520245212"", ""35429494"", ""166845078"", ""326331226"", ""2862601911"", ""55036035"", ""96440634"", ""35099964"", ""225018629"", ""168820035"", ""23246082"", ""1738679586"", ""16737566"", ""2342999576"", ""2214510864"", ""99819737""]",2,5,7
1738679586,2,72.5,-0.3085002899169922,6097829.0,2,0.5,"[""ottawashooting-all-rnr-threads"", ""ferguson-all-rnr-threads""]","[""2884771"", ""8839632""]",1,1,2
16560657,5,93.8,-0.08124916553497315,6098402.0,48,0.0,"[""ottawashooting-all-rnr-threads"", ""ferguson-all-rnr-threads""]","[""319305675"", ""2613170367"", ""711521229"", ""201405241"", ""1138178221"", ""232614555"", ""432397403"", ""902528816"", ""260924526"", ""66701727"", ""456098579"", ""31208684"", ""216396124"", ""69813963"", ""46600366"", ""156182984"", ""98278774"", ""159966921"", ""238369233"", ""129365439"", ""16474276"", ""80363885"", ""43024716"", ""76168830"", ""2678484852"", ""16560657"", ""16776986"", ""31440198"", ""23523876"", ""628776007"", ""377440844"", ""15025385"", ""16529856"", ""1085149063"", ""1677503100"", ""2783698283"", ""43377023"", ""23622065"", ""22445631"", ""999906110"", ""1715584164"", ""237093219"", ""58058688"", ""312930637"", ""44369257"", ""124361261"", ""68402909"", ""384062792""]",0,5,5
273510876,4,111.5,-0.5328949093818665,10751032.0,2,0.0,"[""sydneysiege-all-rnr-threads"", ""ferguson-all-rnr-threads""]","[""16725276"", ""16164636""]",0,4,4
982953108,5,123.2,0.008151817321777343,6105531.0,2,0.0,"[""ottawashooting-all-rnr-threads"", ""ferguson-all-rnr-threads""]","[""18839785"", ""16164636""]",0,5,5
65551087,4,110.25,-0.21873220801353455,10707864.0,4,0.25,"[""sydneysiege-all-rnr-threads"", ""ferguson-all-rnr-threads""]","[""1020058453"", ""14849562"", ""7768402"", ""14090948""]",1,3,4
53987594,4,94.25,-0.44299930334091187,10714630.0,2,0.75,"[""sydneysiege-all-rnr-threads"", ""ferguson-all-rnr-threads""]","[""279390084"", ""5402612""]",3,1,4
16490787,3,117.33333333333333,-0.5113126039505005,6100540.0,3,0.0,"[""ottawashooting-all-rnr-threads"", ""ferguson-all-rnr-threads""]","[""1381926373"", ""279390084"", ""289998339""]",0,3,3
27754737,6,132.66666666666666,-0.050235201915105186,19529260.0,49,0.0,"[""germanwings-crash-all-rnr-threads"", ""ferguson-all-rnr-threads""]","[""14800312"", ""37640394"", ""118953812"", ""796941355"", ""30523252"", ""492952633"", ""99407203"", ""27754737"", ""2155029518"", ""366299823"", ""46096328"", ""258864105"", ""1488378090"", ""409122325"", ""2396314147"", ""1729575907"", ""139239983"", ""277670569"", ""14872192"", ""263526249"", ""16633799"", ""832209374"", ""27566930"", ""273737173"", ""263222582"", ""52026049"", ""36752364"", ""184591588"", ""63502107"", ""1308892632"", ""5839642"", ""125652699"", ""48206307"", ""2462390516"", ""1442398507"", ""166001916"", ""153981496"", ""290720646"", ""17076398"", ""393771226"", ""2695884114"", ""792670236"", ""172976494"", ""15792333"", ""58617658"", ""304612640"", ""2670028345"", ""47311134"", ""992042707""]",0,6,6
433092233,2,58.0,0.09669113159179688,10706151.0,2,0.0,"[""sydneysiege-all-rnr-threads"", ""ferguson-all-rnr-threads""]","[""954124423"", ""374712154""]",0,2,2
267959196,7,86.71428571428571,-0.18921562603541783,10760762.0,5,0.2857142857142857,"[""ottawashooting-all-rnr-threads"", ""sydneysiege-all-rnr-threads"", ""ferguson-all-rnr-threads""]","[""954124423"", ""15996661"", ""272172091"", ""13393052"", ""16834659""]",2,5,7
301189264,3,104.0,-0.5257224639256796,5919039.0,3,0.6666666666666666,"[""ottawashooting-all-rnr-threads"", ""ferguson-all-rnr-threads""]","[""19038934"", ""69004966"", ""18999969""]",2,1,3
15765108,2,38.0,-0.04192143678665161,5932111.0,2,0.5,"[""ottawashooting-all-rnr-threads"", ""ferguson-all-rnr-threads""]","[""19038934"", ""69004966""]",1,1,2
225260541,3,124.33333333333333,-0.3573870062828064,6102076.0,3,0.0,"[""ottawashooting-all-rnr-threads"", ""ferguson-all-rnr-threads""]","[""1947301"", ""19077044"", ""14090948""]",0,3,3
200918966,5,85.4,0.14492154121398926,10707797.0,4,0.0,"[""sydneysiege-all-rnr-threads"", ""ferguson-all-rnr-threads""]","[""1381926373"", ""497534338"", ""17073325"", ""14090948""]",0,5,5
1043529588,2,86.5,-0.245635986328125,10703790.0,2,0.5,"[""sydneysiege-all-rnr-threads"", ""ferguson-all-rnr-threads""]","[""15012486"", ""1291770157""]",1,1,2
52503887,9,88.11111111111111,-0.3300245801607768,6099015.0,5,0.1111111111111111,"[""ottawashooting-all-rnr-threads"", ""ferguson-all-rnr-threads""]","[""148116121"", ""180887271"", ""1668303476"", ""45632111"", ""325747234""]",1,8,9
286723230,3,66.0,-0.1565084457397461,6099835.0,3,0.3333333333333333,"[""ottawashooting-all-rnr-threads"", ""ferguson-all-rnr-threads""]","[""15994109"", ""17068692"", ""82120358""]",1,2,3
474054440,3,106.33333333333333,-0.19408826033274332,10678006.0,2,0.0,"[""sydneysiege-all-rnr-threads"", ""ferguson-all-rnr-threads""]","[""18643437"", ""17068692""]",0,3,3
5142931,2,133.5,-0.2729455828666687,6007538.0,2,0.5,"[""ottawashooting-all-rnr-threads"", ""ferguson-all-rnr-threads""]","[""368565886"", ""274831602""]",1,1,2
15803977,12,131.33333333333331,-0.40861745178699493,10713489.0,5,0.4166666666666667,"[""sydneysiege-all-rnr-threads"", ""ferguson-all-rnr-threads""]","[""9295502"", ""18435601"", ""64643056"", ""14715424"", ""1609475190""]",5,7,12
27122356,2,41.5,-0.21062088012695312,10703745.0,2,0.5,"[""sydneysiege-all-rnr-threads"", ""ferguson-all-rnr-threads""]","[""292777349"", ""31069618""]",1,1,2
363365584,6,89.33333333333333,-0.16907812158266702,10662905.0,3,0.16666666666666666,"[""sydneysiege-all-rnr-threads"", ""ferguson-all-rnr-threads""]","[""15250661"", ""78586909"", ""1750973664""]",1,5,6
1596223609,3,100.0,0.3207935889561971,6052535.0,3,0.3333333333333333,"[""ottawashooting-all-rnr-threads"", ""ferguson-all-rnr-threads""]","[""46303458"", ""183341278"", ""8736882""]",1,2,3
2230388154,6,62.333333333333336,-0.06969794631004333,10729144.0,2,0.6666666666666666,"[""sydneysiege-all-rnr-threads"", ""ferguson-all-rnr-threads""]","[""49591803"", ""66533920""]",4,2,6
2415492990,2,70.0,0.21522986888885498,10702248.0,2,0.5,"[""sydneysiege-all-rnr-threads"", ""ferguson-all-rnr-threads""]","[""205242337"", ""14090948""]",1,1,2
1085149063,17,29.647058823529413,-0.10271324830896714,10713558.0,12,0.8823529411764706,"[""sydneysiege-all-rnr-threads"", ""ferguson-all-rnr-threads""]","[""14173315"", ""87818409"", ""16560657"", ""51241574"", ""2097571"", ""807095"", ""6017542"", ""759251"", ""742143"", ""428333"", ""1367531"", ""5402612""]",15,2,17
2278261981,2,87.0,0.1979772448539734,10746688.0,2,0.5,"[""sydneysiege-all-rnr-threads"", ""ferguson-all-rnr-threads""]","[""16661744"", ""428333""]",1,1,2
363879015,2,107.5,0.20307278633117676,5935286.0,18,0.5,"[""ottawashooting-all-rnr-threads"", ""ferguson-all-rnr-threads""]","[""1373841438"", ""96698038"", ""1148760084"", ""58959283"", ""545330311"", ""780315337"", ""2392000572"", ""2450466770"", ""419064940"", ""87558021"", ""521761797"", ""1651567980"", ""1291770157"", ""16156728"", ""619567968"", ""473519962"", ""97639418"", ""17250775""]",1,1,2
250761217,7,132.57142857142858,-0.39316615888050627,10735854.0,4,0.0,"[""sydneysiege-all-rnr-threads"", ""ferguson-all-rnr-threads""]","[""2464867495"", ""244452760"", ""6017542"", ""387027891""]",0,7,7
555532124,8,84.75,-0.018211103975772858,10631322.0,5,0.125,"[""sydneysiege-all-rnr-threads"", ""ferguson-all-rnr-threads""]","[""423662810"", ""114032121"", ""18643437"", ""26567591"", ""14321959""]",1,7,8
60684098,2,44.5,-0.2666069269180298,10719972.0,2,0.0,"[""sydneysiege-all-rnr-threads"", ""ferguson-all-rnr-threads""]","[""3108351"", ""245689692""]",0,2,2
445307763,4,120.25,-0.4660487771034241,6061058.0,2,0.75,"[""ottawashooting-all-rnr-threads"", ""ferguson-all-rnr-threads""]","[""5402612"", ""245689692""]",3,1,4
2479159384,6,123.66666666666667,-0.2757264971733093,6081098.0,3,0.0,"[""ottawashooting-all-rnr-threads"", ""ferguson-all-rnr-threads""]","[""2779835956"", ""5513002"", ""245689692""]",0,6,6
247104369,5,117.8,-0.05083185434341431,6036203.0,5,0.2,"[""ottawashooting-all-rnr-threads"", ""ferguson-all-rnr-threads""]","[""201308621"", ""584797578"", ""292777349"", ""7768402"", ""24138795""]",1,4,5
2608956567,5,98.4,0.09035496711730957,6058981.0,3,0.4,"[""ottawashooting-all-rnr-threads"", ""ferguson-all-rnr-threads""]","[""183341278"", ""2097571"", ""13829772""]",2,3,5
28024611,4,118.25,-0.4263938367366791,5976563.0,4,0.5,"[""ottawashooting-all-rnr-threads"", ""ferguson-all-rnr-threads""]","[""65698096"", ""292777349"", ""249339016"", ""14940354""]",2,2,4
1488378090,2,41.5,-0.154119610786438,10683384.0,2,0.5,"[""sydneysiege-all-rnr-threads"", ""ferguson-all-rnr-threads""]","[""27754737"", ""5402612""]",1,1,2
575842881,2,120.5,-0.44196200370788574,10718815.0,2,0.5,"[""sydneysiege-all-rnr-threads"", ""ferguson-all-rnr-threads""]","[""190427235"", ""42407972""]",1,1,2
271646568,2,79.0,0.12984639406204224,6071076.0,2,0.0,"[""ottawashooting-all-rnr-threads"", ""ferguson-all-rnr-threads""]","[""20748745"", ""5513002""]",0,2,2
15559808,6,136.66666666666666,-0.49810368816057843,10670644.0,4,0.0,"[""sydneysiege-all-rnr-threads"", ""ferguson-all-rnr-threads""]","[""15907183"", ""15667291"", ""2097571"", ""386815916""]",0,6,6
567193275,2,128.5,0.03239011764526367,10662635.0,2,0.0,"[""sydneysiege-all-rnr-threads"", ""ferguson-all-rnr-threads""]","[""18560045"", ""238575113""]",0,2,2
155602260,8,116.375,-0.4820040315389633,6050794.0,2,0.125,"[""ottawashooting-all-rnr-threads"", ""ferguson-all-rnr-threads""]","[""18643437"", ""109065990""]",1,7,8
22217443,2,89.0,-0.22967153787612915,10684641.0,2,0.5,"[""sydneysiege-all-rnr-threads"", ""ferguson-all-rnr-threads""]","[""14849562"", ""5402612""]",1,1,2
350895279,2,78.5,-0.19871842861175537,19476125.0,2,0.0,"[""germanwings-crash-all-rnr-threads"", ""ferguson-all-rnr-threads""]","[""14437914"", ""14849562""]",0,2,2
2593197311,2,35.5,0.15479987859725952,5951143.0,2,0.5,"[""ottawashooting-all-rnr-threads"", ""ferguson-all-rnr-threads""]","[""7587032"", ""317384131""]",1,1,2
93194555,6,92.33333333333333,-0.18369874358177185,6047603.0,3,0.16666666666666666,"[""ottawashooting-all-rnr-threads"", ""ferguson-all-rnr-threads""]","[""13393052"", ""8736882"", ""22416658""]",1,5,6
1676698225,6,52.333333333333336,-0.3769918978214264,6062214.0,2,0.3333333333333333,"[""ottawashooting-all-rnr-threads"", ""ferguson-all-rnr-threads""]","[""14675395"", ""264268489""]",2,4,6
73774016,6,63.666666666666664,0.09313591321309407,10696738.0,6,0.3333333333333333,"[""ottawashooting-all-rnr-threads"", ""sydneysiege-all-rnr-threads"", ""ferguson-all-rnr-threads""]","[""45715838"", ""254873869"", ""46213956"", ""37881687"", ""14849562"", ""258627226""]",2,4,6
1228514706,2,78.0,0.09738636016845703,10628320.0,2,0.5,"[""sydneysiege-all-rnr-threads"", ""ferguson-all-rnr-threads""]","[""64643056"", ""7768402""]",1,1,2
567575673,3,97.33333333333333,0.1840658187866211,18255755.0,2,0.3333333333333333,"[""putinmissing-all-rnr-threads"", ""ferguson-all-rnr-threads""]","[""243318995"", ""7768402""]",1,2,3
1442580457,9,77.88888888888889,-0.22070246272616917,10653741.0,3,0.7777777777777778,"[""ottawashooting-all-rnr-threads"", ""sydneysiege-all-rnr-threads"", ""ferguson-all-rnr-threads""]","[""423662810"", ""292777349"", ""279390084""]",7,2,9
115217320,3,81.66666666666667,-0.47293901443481445,6052604.0,3,0.0,"[""ottawashooting-all-rnr-threads"", ""ferguson-all-rnr-threads""]","[""109065990"", ""65957957"", ""279390084""]",0,3,3
625610952,9,52.333333333333336,-0.5197963648372226,10648776.0,2,0.2222222222222222,"[""sydneysiege-all-rnr-threads"", ""ferguson-all-rnr-threads""]","[""21866939"", ""1609475190""]",2,7,9
46746701,2,129.0,-0.40094244480133057,10673224.0,2,0.5,"[""sydneysiege-all-rnr-threads"", ""ferguson-all-rnr-threads""]","[""15164565"", ""64643056""]",1,1,2
2339132688,14,64.42857142857143,-0.09807256715638298,6024858.0,3,0.9285714285714286,"[""ottawashooting-all-rnr-threads"", ""ferguson-all-rnr-threads""]","[""19038934"", ""42389136"", ""214007688""]",13,1,14
1903011067,8,87.5,-0.24434366077184677,10637373.0,8,0.25,"[""sydneysiege-all-rnr-threads"", ""ferguson-all-rnr-threads""]","[""1269181292"", ""711348452"", ""22138134"", ""42389136"", ""37881687"", ""33092289"", ""11741632"", ""14401607""]",2,6,8
1702513849,12,103.58333333333333,-0.1436321089665095,10646508.0,3,0.75,"[""sydneysiege-all-rnr-threads"", ""ferguson-all-rnr-threads""]","[""43182702"", ""954124423"", ""9609632""]",9,3,12
522452889,6,119.16666666666667,-0.05738214651743571,6162541.0,5,0.16666666666666666,"[""ottawashooting-all-rnr-threads"", ""ferguson-all-rnr-threads""]","[""42896073"", ""19038934"", ""14090948"", ""13393052"", ""257291338""]",1,5,6
377207363,2,91.5,0.45308494567871094,5950539.0,2,0.0,"[""ottawashooting-all-rnr-threads"", ""ferguson-all-rnr-threads""]","[""101848151"", ""16076032""]",0,2,2
20494730,5,78.2,-0.27433425188064575,19340137.0,4,0.6,"[""germanwings-crash-all-rnr-threads"", ""ferguson-all-rnr-threads""]","[""66726759"", ""740769140"", ""20494730"", ""14849562""]",3,2,5
300916291,3,120.0,-0.2525651852289836,10631913.0,3,0.3333333333333333,"[""sydneysiege-all-rnr-threads"", ""ferguson-all-rnr-threads""]","[""343800462"", ""292777349"", ""7768402""]",1,2,3
18220818,2,77.5,0.221146821975708,6016704.0,2,0.0,"[""ottawashooting-all-rnr-threads"", ""ferguson-all-rnr-threads""]","[""148116121"", ""159210283""]",0,2,2
172469352,5,101.2,-0.3079639196395874,6006948.0,2,0.0,"[""ottawashooting-all-rnr-threads"", ""ferguson-all-rnr-threads""]","[""19038934"", ""159210283""]",0,5,5
1677503100,2,56.5,-0.22306013107299805,6032231.0,2,0.0,"[""ottawashooting-all-rnr-threads"", ""ferguson-all-rnr-threads""]","[""16560657"", ""23831448""]",0,2,2
283958013,3,102.66666666666667,-0.13235588868459067,10656809.0,2,0.0,"[""sydneysiege-all-rnr-threads"", ""ferguson-all-rnr-threads""]","[""28785486"", ""18294906""]",0,3,3
143067985,2,102.0,-0.3406115472316742,10639440.0,2,0.0,"[""sydneysiege-all-rnr-threads"", ""ferguson-all-rnr-threads""]","[""14940354"", ""65045121""]",0,2,2
43553304,2,70.0,0.6334545016288757,19232401.0,2,0.0,"[""germanwings-crash-all-rnr-threads"", ""ferguson-all-rnr-threads""]","[""14606079"", ""134196350""]",0,2,2
22707692,3,126.33333333333333,-0.26291149854660034,10418441.0,3,0.6666666666666666,"[""sydneysiege-all-rnr-threads"", ""ferguson-all-rnr-threads""]","[""14173315"", ""14606079"", ""64643056""]",2,1,3
17581602,7,61.57142857142857,-0.36537718772888184,10632378.0,5,0.2857142857142857,"[""ottawashooting-all-rnr-threads"", ""sydneysiege-all-rnr-threads"", ""ferguson-all-rnr-threads""]","[""17073325"", ""264268489"", ""28785486"", ""64643056"", ""211105315""]",2,5,7
395335393,4,59.25,-0.14842864871025085,6039338.0,4,0.25,"[""ottawashooting-all-rnr-threads"", ""ferguson-all-rnr-threads""]","[""14940354"", ""15012486"", ""21344944"", ""742143""]",1,3,4
314243234,2,103.5,-0.6407703757286072,18394323.0,1,0.5,"[""putinmissing-all-rnr-threads"", ""ferguson-all-rnr-threads""]","[""14090948""]",1,1,2
705564782,2,58.5,-0.017687082290649414,10627794.0,2,0.5,"[""sydneysiege-all-rnr-threads"", ""ferguson-all-rnr-threads""]","[""53503202"", ""18510860""]",1,1,2
2322996398,2,31.5,-0.0999988317489624,10631880.0,2,0.0,"[""sydneysiege-all-rnr-threads"", ""ferguson-all-rnr-threads""]","[""27964284"", ""133081159""]",0,2,2
1396855940,6,130.66666666666666,-0.31308017174402875,19399772.0,2,0.0,"[""germanwings-crash-all-rnr-threads"", ""ferguson-all-rnr-threads""]","[""14700316"", ""227837742""]",0,6,6
75146395,4,98.5,-0.2628266513347626,10549375.0,2,0.75,"[""sydneysiege-all-rnr-threads"", ""ferguson-all-rnr-threads""]","[""21866939"", ""14700316""]",3,1,4
1302169776,7,94.71428571428571,-0.28427490166255404,10665467.0,7,0.0,"[""sydneysiege-all-rnr-threads"", ""ferguson-all-rnr-threads""]","[""238575113"", ""55113967"", ""183341278"", ""25777812"", ""386815916"", ""14700316"", ""14090948""]",0,7,7
228491611,3,103.0,-0.1190963586171468,6017286.0,2,0.6666666666666666,"[""ottawashooting-all-rnr-threads"", ""ferguson-all-rnr-threads""]","[""6017542"", ""15249499""]",2,1,3
933322141,9,103.33333333333333,-0.3848230772548252,10624326.0,2,0.8888888888888888,"[""sydneysiege-all-rnr-threads"", ""ferguson-all-rnr-threads""]","[""74014041"", ""63502107""]",8,1,9
293445832,4,82.25,-0.43721067905426025,6006856.0,3,0.25,"[""ottawashooting-all-rnr-threads"", ""ferguson-all-rnr-threads""]","[""17537467"", ""63502107"", ""12848262""]",1,3,4
17915515,2,80.5,0.14095598459243774,10674314.0,2,0.0,"[""sydneysiege-all-rnr-threads"", ""ferguson-all-rnr-threads""]","[""3108351"", ""33092289""]",0,2,2
324086895,2,93.0,-0.41774046421051025,6049203.0,2,0.5,"[""ottawashooting-all-rnr-threads"", ""ferguson-all-rnr-threads""]","[""19038934"", ""33092289""]",1,1,2
825801150,3,113.33333333333333,-0.0284427007039388,10686888.0,3,0.3333333333333333,"[""sydneysiege-all-rnr-threads"", ""ferguson-all-rnr-threads""]","[""11265832"", ""203123011"", ""51241574""]",1,2,3
22063600,2,106.5,-0.44779881834983826,6048265.0,19,0.0,"[""ottawashooting-all-rnr-threads"", ""ferguson-all-rnr-threads""]","[""96104822"", ""171611273"", ""874561026"", ""865584434"", ""131045393"", ""21041737"", ""120210725"", ""24350019"", ""124953604"", ""14108985"", ""14697166"", ""495525135"", ""876998491"", ""165335229"", ""812185596"", ""2229646347"", ""180770812"", ""346586015"", ""1305420560""]",0,2,2
515047062,2,112.0,0.0911334753036499,10618656.0,2,0.5,"[""sydneysiege-all-rnr-threads"", ""ferguson-all-rnr-threads""]","[""26567591"", ""15220768""]",1,1,2
46003732,4,90.75,-0.3806220293045044,10650850.0,3,0.25,"[""sydneysiege-all-rnr-threads"", ""ferguson-all-rnr-threads""]","[""16589206"", ""20043786"", ""7768402""]",1,3,4
146728493,2,123.5,-0.22596943378448486,19242310.0,2,0.0,"[""germanwings-crash-all-rnr-threads"", ""ferguson-all-rnr-threads""]","[""2280470022"", ""244452760""]",0,2,2
333376270,7,108.14285714285714,-0.046146103313991,10633664.0,2,0.8571428571428571,"[""sydneysiege-all-rnr-threads"", ""ferguson-all-rnr-threads""]","[""244452760"", ""428333""]",6,1,7
26499221,3,80.66666666666667,-0.20155149698257446,6020531.0,2,0.3333333333333333,"[""ottawashooting-all-rnr-threads"", ""ferguson-all-rnr-threads""]","[""1716581"", ""203123011""]",1,2,3
14707322,7,76.57142857142857,-0.3150223323277065,10628942.0,3,0.14285714285714285,"[""sydneysiege-all-rnr-threads"", ""ferguson-all-rnr-threads""]","[""15012486"", ""14849562"", ""214622133""]",1,6,7
19801206,3,62.333333333333336,-0.5254907608032227,7142420.0,2,0.6666666666666666,"[""prince-toronto-all-rnr-threads"", ""ferguson-all-rnr-threads""]","[""1716581"", ""83715203""]",2,1,3
604243082,3,89.33333333333333,-0.620406985282898,10628976.0,3,0.3333333333333333,"[""sydneysiege-all-rnr-threads"", ""ferguson-all-rnr-threads""]","[""412682869"", ""18643437"", ""279390084""]",1,2,3
24772220,4,116.25,-0.2795769274234772,6020040.0,2,0.0,"[""ottawashooting-all-rnr-threads"", ""ferguson-all-rnr-threads""]","[""279390084"", ""149913262""]",0,4,4
14228645,2,65.5,-0.0026797056198120117,10672673.0,2,0.0,"[""sydneysiege-all-rnr-threads"", ""ferguson-all-rnr-threads""]","[""33092289"", ""16725276""]",0,2,2
92659714,3,50.0,-0.25309570630391437,6031294.0,3,0.0,"[""ottawashooting-all-rnr-threads"", ""ferguson-all-rnr-threads""]","[""183341278"", ""386815916"", ""18622869""]",0,3,3
588631255,2,114.5,-0.443874329328537,10643952.0,2,0.0,"[""sydneysiege-all-rnr-threads"", ""ferguson-all-rnr-threads""]","[""183341278"", ""37881687""]",0,2,2
26342862,3,106.0,-0.2583169142405192,10630431.0,2,0.0,"[""sydneysiege-all-rnr-threads"", ""ferguson-all-rnr-threads""]","[""281754653"", ""14550221""]",0,3,3
1954624465,2,75.0,0.1736663579940796,10631663.0,2,0.0,"[""sydneysiege-all-rnr-threads"", ""ferguson-all-rnr-threads""]","[""16930489"", ""26559241""]",0,2,2
2511739878,2,127.0,-0.4116760492324829,10655919.0,2,0.0,"[""sydneysiege-all-rnr-threads"", ""ferguson-all-rnr-threads""]","[""64643056"", ""1291770157""]",0,2,2
23342652,2,76.0,0.5420934557914734,6050101.0,2,0.0,"[""ottawashooting-all-rnr-threads"", ""ferguson-all-rnr-threads""]","[""318835344"", ""97327765""]",0,2,2
1883661948,2,82.5,-0.21634793281555176,10862410.0,2,0.5,"[""sydneysiege-all-rnr-threads"", ""ferguson-all-rnr-threads""]","[""1367531"", ""97327765""]",1,1,2
853484738,2,51.0,0.04415625333786011,10682281.0,2,0.5,"[""sydneysiege-all-rnr-threads"", ""ferguson-all-rnr-threads""]","[""1960878613"", ""97327765""]",1,1,2
1166392885,3,37.0,-0.031206250190734863,10648778.0,2,0.3333333333333333,"[""sydneysiege-all-rnr-threads"", ""ferguson-all-rnr-threads""]","[""51241574"", ""97327765""]",1,2,3
2235299638,2,94.0,-0.6312012374401093,19233277.0,2,0.0,"[""germanwings-crash-all-rnr-threads"", ""ferguson-all-rnr-threads""]","[""64643056"", ""97327765""]",0,2,2
402744581,7,105.0,-0.3452555962971279,19446091.0,5,0.0,"[""germanwings-crash-all-rnr-threads"", ""ottawashooting-all-rnr-threads"", ""ferguson-all-rnr-threads""]","[""2193946021"", ""14090948"", ""759251"", ""302071347"", ""17001435""]",0,7,7
346822246,3,95.0,-0.3595057924588521,6038260.0,2,0.0,"[""ottawashooting-all-rnr-threads"", ""ferguson-all-rnr-threads""]","[""22903265"", ""18999969""]",0,3,3
22607317,4,93.0,-0.2964528352022171,10650711.0,3,0.0,"[""ottawashooting-all-rnr-threads"", ""sydneysiege-all-rnr-threads"", ""ferguson-all-rnr-threads""]","[""22903265"", ""54489465"", ""39364684""]",0,4,4
303328043,2,106.0,-0.26109957695007324,10629389.0,2,0.5,"[""sydneysiege-all-rnr-threads"", ""ferguson-all-rnr-threads""]","[""423662810"", ""1398275840""]",1,1,2
2723456510,4,91.75,-0.4237469732761383,10530990.0,3,0.25,"[""sydneysiege-all-rnr-threads"", ""ferguson-all-rnr-threads""]","[""341908197"", ""16725276"", ""109234928""]",1,3,4
52818091,2,73.0,-0.08046448230743408,10640918.0,2,0.0,"[""sydneysiege-all-rnr-threads"", ""ferguson-all-rnr-threads""]","[""14098166"", ""279390084""]",0,2,2
49430686,12,66.16666666666667,-0.0523497611284256,18342608.0,6,0.75,"[""putinmissing-all-rnr-threads"", ""ferguson-all-rnr-threads""]","[""52003080"", ""1020910656"", ""49430686"", ""2827853416"", ""14090948"", ""17045133""]",9,3,12
145855451,3,71.66666666666667,-0.3275002638498942,5955945.0,3,0.6666666666666666,"[""ottawashooting-all-rnr-threads"", ""ferguson-all-rnr-threads""]","[""1652541"", ""203123011"", ""14090948""]",2,1,3
102282810,3,90.33333333333333,-0.0741419792175293,5949208.0,3,0.0,"[""ottawashooting-all-rnr-threads"", ""ferguson-all-rnr-threads""]","[""21328706"", ""121483664"", ""14090948""]",0,3,3
100597465,3,120.66666666666667,-0.2718043327331543,5832258.0,2,0.3333333333333333,"[""ottawashooting-all-rnr-threads"", ""ferguson-all-rnr-threads""]","[""8071902"", ""42958829""]",1,2,3
29769901,2,135.0,-0.14904549717903137,5938131.0,2,0.0,"[""ottawashooting-all-rnr-threads"", ""ferguson-all-rnr-threads""]","[""2467791"", ""2097571""]",0,2,2
14154272,3,94.33333333333333,0.13917799790700278,5927072.0,2,0.0,"[""ottawashooting-all-rnr-threads"", ""ferguson-all-rnr-threads""]","[""1306563709"", ""203835503""]",0,3,3
1087371074,2,109.5,-0.28917786478996277,10540009.0,2,0.0,"[""sydneysiege-all-rnr-threads"", ""ferguson-all-rnr-threads""]","[""495464885"", ""204832963""]",0,2,2
388043109,2,134.5,0.032073915004730225,5916793.0,2,0.0,"[""ottawashooting-all-rnr-threads"", ""ferguson-all-rnr-threads""]","[""6433472"", ""1291770157""]",0,2,2
2247959851,2,100.0,-0.41534432768821716,5930025.0,2,0.0,"[""ottawashooting-all-rnr-threads"", ""ferguson-all-rnr-threads""]","[""2725579568"", ""1367531""]",0,2,2
284620348,9,104.77777777777777,-0.18099121252695718,10552926.0,9,0.0,"[""sydneysiege-all-rnr-threads"", ""ferguson-all-rnr-threads""]","[""284620348"", ""307275983"", ""2694170550"", ""2782041548"", ""29887789"", ""379481082"", ""163632348"", ""2843858606"", ""8000812""]",0,9,9
111166826,4,119.0,-0.09836617112159729,19200637.0,3,0.5,"[""germanwings-crash-all-rnr-threads"", ""ferguson-all-rnr-threads""]","[""403932208"", ""379481082"", ""26574283""]",2,2,4
938489083,5,123.0,0.0994337558746338,10530171.0,5,0.2,"[""sydneysiege-all-rnr-threads"", ""ferguson-all-rnr-threads""]","[""377163508"", ""20197308"", ""200583835"", ""205242337"", ""16834659""]",1,4,5
622969430,13,92.61538461538461,-0.2518727366740887,10559857.0,4,0.3076923076923077,"[""sydneysiege-all-rnr-threads"", ""ferguson-all-rnr-threads""]","[""14173315"", ""34210188"", ""64643056"", ""322572436""]",4,9,13
615570587,2,82.0,-0.41666507720947266,10511873.0,2,0.0,"[""sydneysiege-all-rnr-threads"", ""ferguson-all-rnr-threads""]","[""85913912"", ""230859523""]",0,2,2
1023417762,4,92.0,-0.4072025418281555,9981282.0,3,0.25,"[""sydneysiege-all-rnr-threads"", ""ferguson-all-rnr-threads""]","[""28785486"", ""20402945"", ""61149653""]",1,3,4
2306857765,2,97.5,-0.7329066395759583,8723859.0,2,0.5,"[""gurlitt-all-rnr-threads"", ""ferguson-all-rnr-threads""]","[""3108351"", ""64643056""]",1,1,2
751972855,11,116.9090909090909,-0.5551733049479398,10724625.0,2,0.0,"[""sydneysiege-all-rnr-threads"", ""ferguson-all-rnr-threads""]","[""64643056"", ""36412963""]",0,11,11
17718055,2,85.5,-0.14438021183013916,5883748.0,2,0.5,"[""ottawashooting-all-rnr-threads"", ""ferguson-all-rnr-threads""]","[""42896073"", ""24165761""]",1,1,2
716813053,8,126.75,-0.27321943640708923,19327800.0,2,0.25,"[""germanwings-crash-all-rnr-threads"", ""ferguson-all-rnr-threads""]","[""74144130"", ""21638203""]",2,6,8
851711263,2,86.5,0.15823113918304443,5856161.0,2,0.0,"[""ottawashooting-all-rnr-threads"", ""ferguson-all-rnr-threads""]","[""21638203"", ""88574375""]",0,2,2
1072387866,4,114.75,-0.25944384932518005,10408372.0,4,0.75,"[""sydneysiege-all-rnr-threads"", ""ferguson-all-rnr-threads""]","[""35466620"", ""1630896181"", ""21638203"", ""7587032""]",3,1,4
236770150,4,96.25,-0.11422300338745117,5902493.0,2,0.0,"[""ottawashooting-all-rnr-threads"", ""ferguson-all-rnr-threads""]","[""14216661"", ""15458694""]",0,4,4
89873752,5,95.2,-0.2061658501625061,5880643.0,2,0.0,"[""ottawashooting-all-rnr-threads"", ""ferguson-all-rnr-threads""]","[""15996661"", ""15458694""]",0,5,5
44272969,15,103.66666666666667,-0.37764018376668296,10527414.0,3,0.8666666666666667,"[""ottawashooting-all-rnr-threads"", ""sydneysiege-all-rnr-threads"", ""ferguson-all-rnr-threads""]","[""14173315"", ""1367531"", ""9411482""]",13,2,15
17671696,2,53.5,-0.7911134660243988,7013780.0,2,0.5,"[""prince-toronto-all-rnr-threads"", ""ferguson-all-rnr-threads""]","[""37255058"", ""23018678""]",1,1,2
449936336,2,118.5,-0.13172906637191772,10491819.0,2,0.5,"[""sydneysiege-all-rnr-threads"", ""ferguson-all-rnr-threads""]","[""37255058"", ""380648579""]",1,1,2
396893560,2,140.0,0.46631914377212524,10547575.0,2,0.5,"[""sydneysiege-all-rnr-threads"", ""ferguson-all-rnr-threads""]","[""28785486"", ""338099403""]",1,1,2
2559432516,2,63.0,0.07237571477890015,5888385.0,2,0.5,"[""ottawashooting-all-rnr-threads"", ""ferguson-all-rnr-threads""]","[""635608354"", ""25110374""]",1,1,2
240279011,7,129.42857142857142,-0.3512183598109654,19088591.0,6,0.42857142857142855,"[""germanwings-crash-all-rnr-threads"", ""ferguson-all-rnr-threads""]","[""14173315"", ""51241574"", ""134196350"", ""14511951"", ""2280470022"", ""58913244""]",3,4,7
176315353,2,81.5,0.36165308952331543,5766146.0,2,0.5,"[""ottawashooting-all-rnr-threads"", ""ferguson-all-rnr-threads""]","[""2097571"", ""319777415""]",1,1,2
403932208,3,133.66666666666666,-0.22800580660502115,10546201.0,11,0.3333333333333333,"[""sydneysiege-all-rnr-threads"", ""ferguson-all-rnr-threads""]","[""403932208"", ""99135533"", ""291477944"", ""1911478922"", ""2473006260"", ""51241574"", ""111166826"", ""2399018406"", ""2591307782"", ""319777415"", ""15830612""]",1,2,3
625802134,2,127.5,-0.5351787805557251,10553828.0,2,0.5,"[""sydneysiege-all-rnr-threads"", ""ferguson-all-rnr-threads""]","[""18510860"", ""428333""]",1,1,2
15992943,4,133.25,-0.7725621312856674,5874760.0,3,0.5,"[""ottawashooting-all-rnr-threads"", ""ferguson-all-rnr-threads""]","[""19038934"", ""21106414"", ""15644999""]",2,2,4
1094506542,2,39.0,-0.39825594425201416,18223596.0,2,0.5,"[""putinmissing-all-rnr-threads"", ""ferguson-all-rnr-threads""]","[""33235771"", ""988324790""]",1,1,2
450991824,4,59.5,0.20687516033649445,5897331.0,4,0.25,"[""ottawashooting-all-rnr-threads"", ""ferguson-all-rnr-threads""]","[""1367531"", ""2467791"", ""2097571"", ""7768402""]",1,3,4
17685870,2,46.5,0.021183878183364868,10493523.0,2,0.0,"[""sydneysiege-all-rnr-threads"", ""ferguson-all-rnr-threads""]","[""40962194"", ""282695161""]",0,2,2
2684175109,2,103.0,-0.15350723266601562,10467588.0,2,0.5,"[""sydneysiege-all-rnr-threads"", ""ferguson-all-rnr-threads""]","[""282695161"", ""742143""]",1,1,2
423168084,2,74.5,-0.08044451475143433,19190671.0,2,0.0,"[""germanwings-crash-all-rnr-threads"", ""ferguson-all-rnr-threads""]","[""182251918"", ""282695161""]",0,2,2
870389288,4,102.0,-0.043747782707214355,10489963.0,2,0.75,"[""sydneysiege-all-rnr-threads"", ""ferguson-all-rnr-threads""]","[""13049362"", ""759251""]",3,1,4
69670513,2,113.5,-0.1299518346786499,10543562.0,2,0.5,"[""sydneysiege-all-rnr-threads"", ""ferguson-all-rnr-threads""]","[""759251"", ""428333""]",1,1,2
1304556728,3,124.33333333333333,0.10368494192759196,10488436.0,2,0.0,"[""sydneysiege-all-rnr-threads"", ""ferguson-all-rnr-threads""]","[""35051304"", ""195271137""]",0,3,3
181109231,5,119.8,-0.1719559907913208,10509953.0,2,0.2,"[""sydneysiege-all-rnr-threads"", ""ferguson-all-rnr-threads""]","[""7587032"", ""195271137""]",1,4,5
31118126,2,114.5,0.09738528728485107,10480778.0,2,0.5,"[""sydneysiege-all-rnr-threads"", ""ferguson-all-rnr-threads""]","[""375721095"", ""195271137""]",1,1,2
28787718,2,58.5,0.7147705554962158,5873438.0,2,0.5,"[""ottawashooting-all-rnr-threads"", ""ferguson-all-rnr-threads""]","[""635608354"", ""7768402""]",1,1,2
785949679,2,126.0,-0.14535373449325562,18177030.0,2,0.5,"[""putinmissing-all-rnr-threads"", ""ferguson-all-rnr-threads""]","[""225235528"", ""11707152""]",1,1,2
240706344,2,55.0,0.17077600955963135,5878350.0,2,0.0,"[""ottawashooting-all-rnr-threads"", ""ferguson-all-rnr-threads""]","[""225235528"", ""15020865""]",0,2,2
61548337,2,91.0,-0.5576573610305786,19025945.0,2,0.0,"[""germanwings-crash-all-rnr-threads"", ""ferguson-all-rnr-threads""]","[""618300542"", ""16343974""]",0,2,2
594766932,2,32.5,-0.5612905025482178,10484545.0,2,0.5,"[""sydneysiege-all-rnr-threads"", ""ferguson-all-rnr-threads""]","[""20843894"", ""423662810""]",1,1,2
15992923,2,96.0,-0.30908000469207764,5870132.0,2,0.5,"[""ottawashooting-all-rnr-threads"", ""ferguson-all-rnr-threads""]","[""20843894"", ""19038934""]",1,1,2
16108144,3,114.33333333333333,-0.654479960600535,5865329.0,2,0.0,"[""ottawashooting-all-rnr-threads"", ""ferguson-all-rnr-threads""]","[""1716581"", ""15996661""]",0,3,3
1713036884,3,100.66666666666667,-0.40120595693588257,10503459.0,2,0.0,"[""sydneysiege-all-rnr-threads"", ""ferguson-all-rnr-threads""]","[""28785486"", ""18510860""]",0,3,3
1038174848,2,74.5,-0.5578178763389587,5899487.0,2,0.5,"[""ottawashooting-all-rnr-threads"", ""ferguson-all-rnr-threads""]","[""73406718"", ""17537467""]",1,1,2
1590592436,2,131.0,-0.6333304941654205,10446726.0,1,0.5,"[""sydneysiege-all-rnr-threads"", ""ferguson-all-rnr-threads""]","[""972651""]",1,1,2
8037402,2,32.5,-0.22912704944610596,10486932.0,2,0.5,"[""sydneysiege-all-rnr-threads"", ""ferguson-all-rnr-threads""]","[""972651"", ""216299334""]",1,1,2
2399900268,22,118.68181818181819,-0.2703129026022824,10552331.0,2,0.0,"[""sydneysiege-all-rnr-threads"", ""ferguson-all-rnr-threads""]","[""489475164"", ""216299334""]",0,22,22
294543106,20,116.1,-0.27287071049213407,10542500.0,3,0.0,"[""sydneysiege-all-rnr-threads"", ""ferguson-all-rnr-threads""]","[""19806962"", ""16725276"", ""216299334""]",0,20,20
2181655057,2,33.0,-0.2620255947113037,10499473.0,2,0.5,"[""sydneysiege-all-rnr-threads"", ""ferguson-all-rnr-threads""]","[""1381926373"", ""742143""]",1,1,2
590543757,3,101.0,-0.5125411947568258,5870696.0,2,0.3333333333333333,"[""ottawashooting-all-rnr-threads"", ""ferguson-all-rnr-threads""]","[""51241574"", ""2836421""]",1,2,3
1072596854,7,90.71428571428571,-0.25048203127724783,10492014.0,3,0.0,"[""sydneysiege-all-rnr-threads"", ""ferguson-all-rnr-threads""]","[""82048287"", ""2836421"", ""16992416""]",0,7,7
43182702,4,128.0,-0.4215128421783447,10533744.0,39,0.0,"[""sydneysiege-all-rnr-threads"", ""ferguson-all-rnr-threads""]","[""573692319"", ""42808009"", ""159447476"", ""159584057"", ""238666005"", ""32144913"", ""118953812"", ""4599041"", ""405726861"", ""29908821"", ""16534096"", ""191181271"", ""455724651"", ""2740229870"", ""1345704325"", ""889356049"", ""30117361"", ""194160226"", ""919389188"", ""2253885114"", ""135049803"", ""761380526"", ""1134734004"", ""1917605214"", ""40189359"", ""493812236"", ""314755110"", ""1252826672"", ""90888044"", ""861712795"", ""2302407630"", ""1012421348"", ""1702513849"", ""25690056"", ""43182702"", ""2841787673"", ""259956008"", ""190902226"", ""1702439910""]",0,4,4
238666005,2,91.5,0.1320783495903015,10371567.0,2,0.0,"[""sydneysiege-all-rnr-threads"", ""ferguson-all-rnr-threads""]","[""379479080"", ""43182702""]",0,2,2
241982231,18,121.11111111111111,-0.33858495619561935,10634326.0,2,0.4444444444444444,"[""sydneysiege-all-rnr-threads"", ""ferguson-all-rnr-threads""]","[""1652541"", ""742143""]",8,10,18
72204671,5,76.4,-0.2192145347595215,5887674.0,3,0.2,"[""ottawashooting-all-rnr-threads"", ""ferguson-all-rnr-threads""]","[""27966935"", ""18510860"", ""8736882""]",1,4,5
194509846,6,120.33333333333333,-0.15851136048634848,10483374.0,2,0.16666666666666666,"[""sydneysiege-all-rnr-threads"", ""ferguson-all-rnr-threads""]","[""27966935"", ""42407972""]",1,5,6
550250082,3,80.33333333333333,-0.19759764273961386,5865112.0,2,0.6666666666666666,"[""ottawashooting-all-rnr-threads"", ""ferguson-all-rnr-threads""]","[""195271137"", ""1932737630""]",2,1,3
541279160,3,74.0,0.2515020767847697,18160674.0,3,0.6666666666666666,"[""ottawashooting-all-rnr-threads"", ""putinmissing-all-rnr-threads"", ""ferguson-all-rnr-threads""]","[""55268034"", ""14138785"", ""195271137""]",2,1,3
18244206,3,86.66666666666667,-0.3338609536488851,8029403.0,3,0.3333333333333333,"[""ottawashooting-all-rnr-threads"", ""sydneysiege-all-rnr-threads"", ""ferguson-all-rnr-threads""]","[""214007688"", ""37881687"", ""33519870""]",1,2,3
169626752,2,33.0,-0.14745348691940308,10501949.0,2,0.5,"[""sydneysiege-all-rnr-threads"", ""ferguson-all-rnr-threads""]","[""27966935"", ""7587032""]",1,1,2
309705204,2,80.5,-0.3765547275543213,5856922.0,2,0.0,"[""ottawashooting-all-rnr-threads"", ""ferguson-all-rnr-threads""]","[""27966935"", ""164075542""]",0,2,2
634874281,3,95.0,-0.26974252859751385,5874332.0,3,0.0,"[""ottawashooting-all-rnr-threads"", ""ferguson-all-rnr-threads""]","[""27966935"", ""325747234"", ""523885252""]",0,3,3
400360169,9,74.77777777777777,-0.26691793070899117,10504965.0,6,0.7777777777777778,"[""sydneysiege-all-rnr-threads"", ""ferguson-all-rnr-threads""]","[""27966935"", ""1467733123"", ""28785486"", ""292777349"", ""393469195"", ""64643056""]",7,2,9
37381980,6,57.666666666666664,-0.02909056345621745,10470895.0,4,0.16666666666666666,"[""sydneysiege-all-rnr-threads"", ""ferguson-all-rnr-threads""]","[""97474887"", ""2799960092"", ""15896580"", ""15774048""]",1,5,6
1899332185,2,58.5,-0.11007630825042725,10534601.0,1,0.0,"[""sydneysiege-all-rnr-threads"", ""ferguson-all-rnr-threads""]","[""211105315""]",0,2,2
95097330,4,117.0,-0.23389680683612823,10473383.0,2,0.25,"[""sydneysiege-all-rnr-threads"", ""ferguson-all-rnr-threads""]","[""28785486"", ""1947301""]",1,3,4
50371114,2,71.0,0.46154487133026123,8360371.0,2,0.5,"[""gurlitt-all-rnr-threads"", ""ferguson-all-rnr-threads""]","[""53429839"", ""1070801347""]",1,1,2
2370914096,3,58.333333333333336,-0.03242655595143636,5799577.0,3,0.6666666666666666,"[""ottawashooting-all-rnr-threads"", ""ferguson-all-rnr-threads""]","[""109065990"", ""7587032"", ""2097571""]",2,1,3
194672143,2,96.5,-0.33106836676597595,5887667.0,2,0.5,"[""ottawashooting-all-rnr-threads"", ""ferguson-all-rnr-threads""]","[""19038934"", ""1381926373""]",1,1,2
15907183,9,137.88888888888889,-0.23713144328859118,10501733.0,90,0.0,"[""sydneysiege-all-rnr-threads"", ""ferguson-all-rnr-threads""]","[""15907183"", ""956528191"", ""1604980554"", ""2272504368"", ""22585606"", ""2478132654"", ""229278838"", ""176044176"", ""24524990"", ""531803450"", ""1437193112"", ""35233895"", ""2529538538"", ""2469490478"", ""1920600823"", ""1343380237"", ""113763802"", ""2542283058"", ""388060545"", ""216542945"", ""88976610"", ""472537040"", ""376469540"", ""49243929"", ""2899344613"", ""28766498"", ""989211318"", ""284838899"", ""17026240"", ""88536247"", ""18293301"", ""22777090"", ""168940132"", ""386081713"", ""2735705952"", ""277670569"", ""15609443"", ""28136569"", ""2688704764"", ""15559808"", ""17393059"", ""221196123"", ""253257813"", ""518671857"", ""204235535"", ""2542667881"", ""38729497"", ""10247552"", ""267214242"", ""29621377"", ""277232185"", ""1928298457"", ""192359034"", ""266963111"", ""2586058800"", ""401942588"", ""2582683020"", ""77809363"", ""2894499034"", ""510778776"", ""277545406"", ""469053875"", ""15599232"", ""41181758"", ""1465546519"", ""265050604"", ""2925094346"", ""29167563"", ""511066785"", ""2513587394"", ""295910014"", ""64489182"", ""16876198"", ""382848514"", ""2309469320"", ""84446316"", ""41455256"", ""1665620256"", ""2699926301"", ""348585085"", ""1865939191"", ""520882800"", ""2236455109"", ""21739008"", ""38017472"", ""913675490"", ""6668882"", ""302854990"", ""37340424"", ""2324657450""]",0,9,9
26793112,2,107.0,-0.36516499519348145,5860872.0,2,0.0,"[""ottawashooting-all-rnr-threads"", ""ferguson-all-rnr-threads""]","[""15996661"", ""117155939""]",0,2,2
25181713,7,134.28571428571428,-0.23913231917790004,5854209.0,4,0.14285714285714285,"[""ottawashooting-all-rnr-threads"", ""ferguson-all-rnr-threads""]","[""26898420"", ""4207961"", ""14173315"", ""22968158""]",1,6,7
23103000,2,40.5,-0.290893018245697,5855202.0,2,0.5,"[""ottawashooting-all-rnr-threads"", ""ferguson-all-rnr-threads""]","[""972651"", ""1652541""]",1,1,2
305318105,2,105.0,-0.6363893151283264,10466741.0,2,0.0,"[""sydneysiege-all-rnr-threads"", ""ferguson-all-rnr-threads""]","[""13393052"", ""65045121""]",0,2,2
48155944,4,137.0,-0.3764631450176239,10358214.0,4,0.75,"[""sydneysiege-all-rnr-threads"", ""ferguson-all-rnr-threads""]","[""13393052"", ""6017542"", ""1960878613"", ""5402612""]",3,1,4
24655516,2,105.0,-0.652663916349411,19075590.0,2,0.0,"[""germanwings-crash-all-rnr-threads"", ""ferguson-all-rnr-threads""]","[""13393052"", ""182251918""]",0,2,2
218325978,12,77.0,-0.17676370839277902,10477086.0,3,0.0,"[""sydneysiege-all-rnr-threads"", ""ferguson-all-rnr-threads""]","[""21344944"", ""1507338108"", ""110827653""]",0,12,12
35429494,2,52.0,-0.002167344093322754,10628063.0,2,0.0,"[""sydneysiege-all-rnr-threads"", ""ferguson-all-rnr-threads""]","[""2884771"", ""16725276""]",0,2,2
344938512,4,85.25,-0.49118730425834656,6035971.0,2,0.5,"[""ottawashooting-all-rnr-threads"", ""ferguson-all-rnr-threads""]","[""26792275"", ""18999969""]",2,2,4
325275379,2,117.0,-0.08207696676254272,10537130.0,2,0.0,"[""sydneysiege-all-rnr-threads"", ""ferguson-all-rnr-threads""]","[""26792275"", ""489475164""]",0,2,2
22110387,2,90.5,-0.327926903963089,10463586.0,2,0.5,"[""sydneysiege-all-rnr-threads"", ""ferguson-all-rnr-threads""]","[""102287424"", ""5402612""]",1,1,2
270763468,4,86.5,0.057225435972213745,10501193.0,3,0.0,"[""sydneysiege-all-rnr-threads"", ""ferguson-all-rnr-threads""]","[""776528756"", ""23293734"", ""2748882114""]",0,4,4
297602297,2,136.5,-0.8316724300384521,5879275.0,13,0.0,"[""ottawashooting-all-rnr-threads"", ""ferguson-all-rnr-threads""]","[""813682543"", ""1935359538"", ""1722647563"", ""1419186452"", ""2605417912"", ""54681581"", ""850302560"", ""244766880"", ""10252962"", ""71638316"", ""2430108250"", ""820317835"", ""2533882537""]",0,2,2
850302560,3,96.0,-0.43591614564259845,10415133.0,14,0.0,"[""sydneysiege-all-rnr-threads"", ""ferguson-all-rnr-threads""]","[""1124720773"", ""382674817"", ""370274402"", ""297602297"", ""277961983"", ""92539332"", ""1399495441"", ""850302560"", ""2502895924"", ""2874025879"", ""110850757"", ""1343753077"", ""11643982"", ""17336423""]",0,3,3
542291870,3,103.66666666666667,-0.704480250676473,5839762.0,2,0.0,"[""ottawashooting-all-rnr-threads"", ""ferguson-all-rnr-threads""]","[""23937894"", ""40293464""]",0,3,3
23916763,2,77.5,0.33558422327041626,10482567.0,2,0.5,"[""sydneysiege-all-rnr-threads"", ""ferguson-all-rnr-threads""]","[""2271035214"", ""15492359""]",1,1,2
1345498502,4,109.5,-0.26480476558208466,10476376.0,4,0.25,"[""ottawashooting-all-rnr-threads"", ""sydneysiege-all-rnr-threads"", ""ferguson-all-rnr-threads""]","[""5402612"", ""1367531"", ""14715424"", ""14090948""]",1,3,4
1498797607,2,86.5,-0.19498497247695923,10463990.0,2,0.5,"[""sydneysiege-all-rnr-threads"", ""ferguson-all-rnr-threads""]","[""380648579"", ""7768402""]",1,1,2
536223591,3,27.666666666666668,-0.25566643476486206,10514149.0,2,0.3333333333333333,"[""sydneysiege-all-rnr-threads"", ""ferguson-all-rnr-threads""]","[""16589206"", ""64643056""]",1,2,3
299201978,3,62.666666666666664,-0.2669691840807597,5884468.0,2,0.6666666666666666,"[""ottawashooting-all-rnr-threads"", ""ferguson-all-rnr-threads""]","[""954124423"", ""41747410""]",2,1,3
2546977356,4,90.75,-0.5663291960954666,10513303.0,4,0.5,"[""ottawashooting-all-rnr-threads"", ""sydneysiege-all-rnr-threads"", ""ferguson-all-rnr-threads""]","[""22993014"", ""292777349"", ""107883101"", ""41747410""]",2,2,4
752495724,3,77.0,-0.10905782381693523,10503684.0,2,0.0,"[""sydneysiege-all-rnr-threads"", ""ferguson-all-rnr-threads""]","[""1020058453"", ""41747410""]",0,3,3
44482963,2,136.0,-0.7956070303916931,10475690.0,2,0.0,"[""sydneysiege-all-rnr-threads"", ""ferguson-all-rnr-threads""]","[""21879831"", ""2163076560""]",0,2,2
921188299,3,139.66666666666666,-0.33154932657877606,10513570.0,2,0.0,"[""sydneysiege-all-rnr-threads"", ""ferguson-all-rnr-threads""]","[""25180828"", ""21879831""]",0,3,3
146408874,4,93.25,-0.33858512341976166,5924026.0,2,0.0,"[""ottawashooting-all-rnr-threads"", ""ferguson-all-rnr-threads""]","[""43261344"", ""20748745""]",0,4,4
1915421762,2,57.5,0.051566481590270996,10458611.0,2,0.0,"[""sydneysiege-all-rnr-threads"", ""ferguson-all-rnr-threads""]","[""2799960092"", ""16553638""]",0,2,2
1097027300,2,139.5,-0.26063019037246704,10457843.0,2,0.0,"[""sydneysiege-all-rnr-threads"", ""ferguson-all-rnr-threads""]","[""16553638"", ""35051304""]",0,2,2
19222164,4,121.5,-0.03792327642440796,10459324.0,50,0.0,"[""ottawashooting-all-rnr-threads"", ""sydneysiege-all-rnr-threads"", ""ferguson-all-rnr-threads""]","[""425242890"", ""59679268"", ""294849140"", ""37045982"", ""29096493"", ""2388012242"", ""49175101"", ""344794990"", ""1260682932"", ""113637226"", ""31393803"", ""189042188"", ""2734496022"", ""2610265334"", ""2349329459"", ""1433640258"", ""232307823"", ""1595149356"", ""2183639838"", ""175062171"", ""19222164"", ""48153070"", ""909028752"", ""1554192631"", ""18932426"", ""19996351"", ""37347545"", ""360931789"", ""188981866"", ""312091084"", ""79219229"", ""544207613"", ""21161356"", ""2768261769"", ""545320130"", ""323054082"", ""242503872"", ""263474444"", ""2473038217"", ""2457337352"", ""30953302"", ""478168630"", ""289239834"", ""147874955"", ""69137170"", ""69821125"", ""2147871637"", ""2400960854"", ""55075272"", ""830232180""]",0,4,4
282062693,2,50.0,-0.09884965419769287,8553652.0,2,0.5,"[""germanwings-crash-all-rnr-threads"", ""sydneysiege-all-rnr-threads""]","[""16198940"", ""26738483""]",1,1,2
19833480,2,125.0,-0.2599528431892395,8568379.0,2,1.0,"[""germanwings-crash-all-rnr-threads"", ""sydneysiege-all-rnr-threads""]","[""2280470022"", ""428333""]",2,0,2
1672452854,3,119.33333333333333,-0.2111472487449646,8552728.0,3,0.3333333333333333,"[""germanwings-crash-all-rnr-threads"", ""sydneysiege-all-rnr-threads""]","[""258703448"", ""22240612"", ""2768501""]",1,2,3
308130306,2,132.0,-0.6041615903377533,763629.0,2,1.0,"[""germanwings-crash-all-rnr-threads"", ""putinmissing-all-rnr-threads""]","[""90275200"", ""95747671""]",2,0,2
25777812,9,127.88888888888889,-0.33012093438042533,8601223.0,99,0.8888888888888888,"[""germanwings-crash-all-rnr-threads"", ""sydneysiege-all-rnr-threads""]","[""54489465"", ""32274369"", ""280784084"", ""19903328"", ""54494842"", ""23880636"", ""48627031"", ""1732723165"", ""99646859"", ""1446258750"", ""19107722"", ""436173744"", ""403088107"", ""464335709"", ""532018404"", ""78567484"", ""459140505"", ""281401059"", ""1164518323"", ""22211688"", ""20126427"", ""98259196"", ""166957076"", ""40242195"", ""18670606"", ""52990482"", ""24622604"", ""491786805"", ""77417989"", ""68151144"", ""621219247"", ""560120722"", ""23498244"", ""1364701332"", ""23113181"", ""19706257"", ""426406874"", ""27901778"", ""1418377147"", ""465315567"", ""243882040"", ""296725731"", ""176340196"", ""26959381"", ""318667162"", ""507125834"", ""1079450924"", ""1271150924"", ""126592284"", ""538730331"", ""1738099368"", ""398484888"", ""2255785158"", ""79805152"", ""177880099"", ""49954397"", ""1333041186"", ""1536797588"", ""168602253"", ""76714507"", ""25049784"", ""1302169776"", ""2383141"", ""159805340"", ""238128770"", ""589904761"", ""55794552"", ""274279734"", ""2520482240"", ""1214267450"", ""193274672"", ""1700851644"", ""22328593"", ""80878908"", ""248426265"", ""1547780274"", ""18071890"", ""505532685"", ""15652582"", ""1866480170"", ""566312439"", ""376676805"", ""17590516"", ""1038235795"", ""19836591"", ""2253140732"", ""62667816"", ""40355593"", ""32334783"", ""24269293"", ""35413034"", ""57638185"", ""23875241"", ""455510973"", ""1555465945"", ""443220853"", ""62789243"", ""2415809562"", ""166529542""]",8,1,9
22328593,7,81.42857142857143,-0.2034685526575361,8595773.0,4,0.8571428571428571,"[""germanwings-crash-all-rnr-threads"", ""sydneysiege-all-rnr-threads""]","[""24502450"", ""171802941"", ""15250661"", ""25777812""]",6,1,7
92512340,2,143.0,-0.31017524003982544,8542287.0,2,0.5,"[""germanwings-crash-all-rnr-threads"", ""sydneysiege-all-rnr-threads""]","[""16734909"", ""294379576""]",1,1,2
6575472,8,99.125,-0.2002822607755661,8549749.0,3,0.375,"[""germanwings-crash-all-rnr-threads"", ""sydneysiege-all-rnr-threads""]","[""134196350"", ""564457556"", ""7587032""]",3,5,8
48612569,2,130.5,-0.5742536783218384,13202320.0,2,1.0,"[""germanwings-crash-all-rnr-threads"", ""ottawashooting-all-rnr-threads""]","[""134196350"", ""5402612""]",2,0,2
244134922,9,71.55555555555556,-0.22198634015189278,13205582.0,2,0.7777777777777778,"[""germanwings-crash-all-rnr-threads"", ""ottawashooting-all-rnr-threads""]","[""6017542"", ""134196350""]",7,2,9
132512167,4,98.75,-0.3675871789455414,13181607.0,2,1.0,"[""germanwings-crash-all-rnr-threads"", ""ottawashooting-all-rnr-threads""]","[""51241574"", ""134196350""]",4,0,4
198123914,2,61.5,-0.29393187165260315,8762478.0,2,0.5,"[""germanwings-crash-all-rnr-threads"", ""sydneysiege-all-rnr-threads""]","[""134196350"", ""7587032""]",1,1,2
18970657,3,113.33333333333333,-0.6095384558041891,8683904.0,3,1.0,"[""germanwings-crash-all-rnr-threads"", ""sydneysiege-all-rnr-threads""]","[""14173315"", ""51241574"", ""9609632""]",3,0,3
124302756,4,106.0,-0.31658197939395905,13202112.0,3,0.75,"[""germanwings-crash-all-rnr-threads"", ""ottawashooting-all-rnr-threads"", ""sydneysiege-all-rnr-threads""]","[""14173315"", ""23937894"", ""7401202""]",3,1,4
490002042,2,30.5,-0.7448796629905701,8574499.0,2,0.5,"[""germanwings-crash-all-rnr-threads"", ""sydneysiege-all-rnr-threads""]","[""14173315"", ""269167743""]",1,1,2
26133679,2,98.0,-0.7432235479354858,8571550.0,2,1.0,"[""germanwings-crash-all-rnr-threads"", ""sydneysiege-all-rnr-threads""]","[""6017542"", ""16834659""]",2,0,2
2331161887,2,88.5,-0.7406110167503357,13210831.0,1,1.0,"[""germanwings-crash-all-rnr-threads"", ""ottawashooting-all-rnr-threads""]","[""6017542""]",2,0,2
16834659,21,116.9047619047619,-0.47977960109710693,8599623.0,154,0.9047619047619048,"[""germanwings-crash-all-rnr-threads"", ""sydneysiege-all-rnr-threads""]","[""110872598"", ""43493268"", ""467325023"", ""155548524"", ""106074367"", ""33857678"", ""26133679"", ""340418813"", ""278489965"", ""15875423"", ""94065115"", ""413748278"", ""15144505"", ""2383360362"", ""2380248444"", ""64884827"", ""1285570952"", ""2836010474"", ""71194194"", ""705123059"", ""795927228"", ""244444991"", ""194921207"", ""771030420"", ""158775651"", ""1258567082"", ""13524002"", ""1343325901"", ""405387006"", ""14639480"", ""2223008040"", ""165133058"", ""269587028"", ""180694158"", ""61755415"", ""382533386"", ""2302407630"", ""16491845"", ""149096517"", ""2545851438"", ""88547503"", ""2728857555"", ""94293090"", ""2264503075"", ""2901126156"", ""20778273"", ""225282844"", ""1859586222"", ""296310272"", ""103972238"", ""2351613186"", ""846939530"", ""87660136"", ""397171757"", ""2202168720"", ""2782041548"", ""2663033660"", ""316389691"", ""2540967745"", ""194119275"", ""45789783"", ""930789798"", ""19898890"", ""85713457"", ""2191145408"", ""15220918"", ""473048213"", ""161240952"", ""456179845"", ""917788214"", ""152829461"", ""2909873316"", ""1708912243"", ""229994594"", ""316405268"", ""1325438424"", ""62899824"", ""212473438"", ""2363227027"", ""43759072"", ""1540048362"", ""25958881"", ""64687016"", ""25300494"", ""1508109590"", ""1365890029"", ""315024285"", ""353342403"", ""1324491786"", ""2864140683"", ""69032114"", ""335989040"", ""1271235698"", ""387698604"", ""350745937"", ""754288945"", ""528926377"", ""2273282888"", ""81990798"", ""267959196"", ""938489083"", ""1291930495"", ""600819202"", ""33332251"", ""2844361126"", ""592269707"", ""583122991"", ""132220923"", ""17954780"", ""821330863"", ""562486448"", ""2734020596"", ""2786512625"", ""2356127598"", ""114466080"", ""999907196"", ""100542141"", ""14543582"", ""43016053"", ""1712159514"", ""1226405322"", ""524805687"", ""30777209"", ""57625784"", ""158199012"", ""321402315"", ""420176985"", ""253615698"", ""2851915686"", ""759735811"", ""177430889"", ""753358988"", ""300271336"", ""2790663349"", ""328474622"", ""591121486"", ""1038235795"", ""28558856"", ""1315921093"", ""2747371108"", ""951710294"", ""401710943"", ""395042420"", ""77739297"", ""588726199"", ""615253131"", ""233885425"", ""322572436"", ""198797290"", ""1340649080"", ""24091187"", ""1567434811"", ""2566291015"", ""1394701628""]",19,2,21
36621824,3,72.0,0.2164882024129232,8565185.0,2,0.3333333333333333,"[""germanwings-crash-all-rnr-threads"", ""sydneysiege-all-rnr-threads""]","[""2097571"", ""64643056""]",1,2,3
102238015,5,128.8,-0.45124819278717043,13194314.0,4,0.8,"[""germanwings-crash-all-rnr-threads"", ""ottawashooting-all-rnr-threads"", ""sydneysiege-all-rnr-threads""]","[""3108351"", ""16343974"", ""203123011"", ""17469289""]",4,1,5
17895820,2,126.5,-0.6785403490066528,953054.0,1,1.0,"[""germanwings-crash-all-rnr-threads"", ""putinmissing-all-rnr-threads""]","[""2148809806""]",2,0,2
38400130,8,119.875,-0.5705981999635696,8815422.0,9,0.5,"[""germanwings-crash-all-rnr-threads"", ""sydneysiege-all-rnr-threads""]","[""2933635100"", ""2783538092"", ""600621117"", ""1480216946"", ""594611438"", ""875131664"", ""16931079"", ""717681763"", ""181425925""]",4,4,8
159911529,2,107.5,-0.10234856605529785,13173326.0,2,1.0,"[""germanwings-crash-all-rnr-threads"", ""ottawashooting-all-rnr-threads""]","[""635608354"", ""89457976""]",2,0,2
139631790,31,106.64516129032258,-0.36788289393148116,8761052.0,3,0.8387096774193549,"[""germanwings-crash-all-rnr-threads"", ""sydneysiege-all-rnr-threads""]","[""2280470022"", ""134196350"", ""153029181""]",26,5,31
190224295,4,119.25,-0.31551817059516907,948203.0,6,1.0,"[""germanwings-crash-all-rnr-threads"", ""putinmissing-all-rnr-threads""]","[""190224295"", ""405452883"", ""64643056"", ""2523528433"", ""193903481"", ""236872671""]",4,0,4
15817213,3,133.66666666666666,-0.5521890123685201,8591550.0,3,1.0,"[""germanwings-crash-all-rnr-threads"", ""sydneysiege-all-rnr-threads""]","[""20639175"", ""129673790"", ""134196350""]",3,0,3
289242244,2,52.0,0.2746303677558899,8537562.0,2,1.0,"[""germanwings-crash-all-rnr-threads"", ""sydneysiege-all-rnr-threads""]","[""22993014"", ""171802941""]",2,0,2
1388688583,2,50.0,-0.2919232249259949,8586365.0,1,0.5,"[""germanwings-crash-all-rnr-threads"", ""sydneysiege-all-rnr-threads""]","[""28785486""]",1,1,2
2282954094,2,18.5,0.139784038066864,8539082.0,2,1.0,"[""germanwings-crash-all-rnr-threads"", ""sydneysiege-all-rnr-threads""]","[""28785486"", ""292777349""]",2,0,2
58913244,9,89.11111111111111,-0.18807470798492432,8610739.0,14,0.8888888888888888,"[""germanwings-crash-all-rnr-threads"", ""sydneysiege-all-rnr-threads""]","[""117746126"", ""425297281"", ""240279011"", ""128819708"", ""11640112"", ""352198967"", ""29191525"", ""27589515"", ""20983376"", ""292777349"", ""58913244"", ""15997281"", ""100936791"", ""247323151""]",8,1,9
113140158,2,114.5,-0.640036404132843,8577622.0,1,1.0,"[""germanwings-crash-all-rnr-threads"", ""sydneysiege-all-rnr-threads""]","[""428333""]",2,0,2
426740892,2,112.0,-0.34137237071990967,13200380.0,2,1.0,"[""germanwings-crash-all-rnr-threads"", ""ottawashooting-all-rnr-threads""]","[""21866939"", ""428333""]",2,0,2
295510001,7,124.85714285714286,-0.3179247038705008,13200453.0,6,0.5714285714285714,"[""germanwings-crash-all-rnr-threads"", ""ottawashooting-all-rnr-threads"", ""sydneysiege-all-rnr-threads""]","[""21866939"", ""14138785"", ""14511951"", ""134196350"", ""64643056"", ""2768501""]",4,3,7
55186601,4,117.75,-0.5345613211393356,8582943.0,12,0.5,"[""germanwings-crash-all-rnr-threads"", ""sydneysiege-all-rnr-threads""]","[""26187263"", ""133776482"", ""2313132087"", ""2601118704"", ""94205731"", ""31146305"", ""25941064"", ""17436585"", ""1931711646"", ""2437066352"", ""145729940"", ""29981164""]",2,2,4
2313132087,8,81.125,-0.2953045219182968,13335531.0,6,0.625,"[""germanwings-crash-all-rnr-threads"", ""ottawashooting-all-rnr-threads"", ""sydneysiege-all-rnr-threads""]","[""33946296"", ""55186601"", ""5943072"", ""56223278"", ""227837742"", ""428333""]",5,3,8
2758534719,3,121.33333333333333,-0.5320955117543539,10372908.0,1,1.0,"[""germanwings-crash-all-rnr-threads"", ""gurlitt-all-rnr-threads""]","[""5402612""]",3,0,3
60482694,2,99.0,-0.2433217465877533,8646873.0,2,0.5,"[""germanwings-crash-all-rnr-threads"", ""sydneysiege-all-rnr-threads""]","[""759251"", ""5402612""]",1,1,2
820986276,2,27.0,0.27595454454421997,8568381.0,2,0.5,"[""germanwings-crash-all-rnr-threads"", ""sydneysiege-all-rnr-threads""]","[""1652541"", ""105485791""]",1,1,2
240649814,3,118.33333333333333,-0.38340407609939575,8565763.0,16,0.6666666666666666,"[""germanwings-crash-all-rnr-threads"", ""sydneysiege-all-rnr-threads""]","[""1310344602"", ""1140157634"", ""188590689"", ""65390378"", ""189448831"", ""2274733698"", ""92729849"", ""54190869"", ""221599037"", ""309209889"", ""2150448842"", ""2486871323"", ""61755415"", ""2599061982"", ""948025009"", ""96958492""]",2,1,3
226440623,2,130.0,-0.22089654207229614,8557978.0,2,0.5,"[""germanwings-crash-all-rnr-threads"", ""sydneysiege-all-rnr-threads""]","[""972651"", ""254873869""]",1,1,2
147202533,5,136.6,-0.5254977703094482,13215288.0,5,0.6,"[""germanwings-crash-all-rnr-threads"", ""ottawashooting-all-rnr-threads""]","[""44685373"", ""22192440"", ""7587032"", ""107883101"", ""5402612""]",3,2,5
846871074,4,94.5,0.25496645271778107,8590856.0,2,1.0,"[""germanwings-crash-all-rnr-threads"", ""sydneysiege-all-rnr-threads""]","[""15012486"", ""5402612""]",4,0,4
617434038,2,71.5,-0.2851108908653259,13208096.0,2,1.0,"[""germanwings-crash-all-rnr-threads"", ""ottawashooting-all-rnr-threads""]","[""6017542"", ""51241574""]",2,0,2
125570941,5,110.4,-0.2592494010925293,8584409.0,5,0.8,"[""germanwings-crash-all-rnr-threads"", ""sydneysiege-all-rnr-threads""]","[""96501145"", ""1855737487"", ""326140439"", ""759251"", ""428333""]",4,1,5
17408916,6,105.33333333333333,-0.3792463143666585,13211796.0,4,0.6666666666666666,"[""germanwings-crash-all-rnr-threads"", ""ottawashooting-all-rnr-threads"", ""sydneysiege-all-rnr-threads""]","[""17919393"", ""380648579"", ""16343974"", ""778057""]",4,2,6
83421448,5,73.4,-0.2914482831954956,8604296.0,4,1.0,"[""germanwings-crash-all-rnr-threads"", ""sydneysiege-all-rnr-threads""]","[""156464691"", ""87416722"", ""428333"", ""49460512""]",5,0,5
2779940700,5,97.0,-0.5615815639495849,8595789.0,2,0.2,"[""germanwings-crash-all-rnr-threads"", ""sydneysiege-all-rnr-threads""]","[""87416722"", ""7587032""]",1,4,5
16509444,2,62.0,-0.5346535742282867,8652937.0,2,1.0,"[""germanwings-crash-all-rnr-threads"", ""sydneysiege-all-rnr-threads""]","[""16589206"", ""7309052""]",2,0,2
2264940392,7,61.857142857142854,-0.21059716599328177,12214937.0,5,1.0,"[""germanwings-crash-all-rnr-threads"", ""prince-toronto-all-rnr-threads""]","[""17659340"", ""19636948"", ""146332990"", ""23018678"", ""12993222""]",7,0,7
477224996,2,81.5,-0.12654268741607666,8679856.0,2,0.5,"[""germanwings-crash-all-rnr-threads"", ""sydneysiege-all-rnr-threads""]","[""1375289149"", ""22799750""]",1,1,2
12848262,9,125.88888888888889,-0.550967726442549,13341495.0,82,0.7777777777777778,"[""germanwings-crash-all-rnr-threads"", ""ottawashooting-all-rnr-threads"", ""prince-toronto-all-rnr-threads""]","[""67001126"", ""861193664"", ""887887338"", ""21422925"", ""275660445"", ""578500686"", ""115253470"", ""1488704528"", ""42088772"", ""223594233"", ""2730000799"", ""2567146231"", ""2400408805"", ""1259808110"", ""2157882292"", ""380543505"", ""138000783"", ""430880741"", ""1426277125"", ""17086831"", ""1039985856"", ""465566694"", ""2805410179"", ""17325647"", ""25866428"", ""2174030340"", ""291328216"", ""1646067944"", ""153197996"", ""2184191511"", ""1852665702"", ""449974639"", ""247129845"", ""25121024"", ""1348354008"", ""2834512322"", ""887859290"", ""190717185"", ""19404782"", ""168642674"", ""34817591"", ""21625747"", ""408489956"", ""839178782"", ""10034082"", ""1965369920"", ""247528533"", ""156287314"", ""340233416"", ""1140892218"", ""1889861756"", ""152091530"", ""1729770470"", ""999907196"", ""22968164"", ""456977632"", ""482257509"", ""891509504"", ""2188635618"", ""346949390"", ""1554492715"", ""94476810"", ""703308994"", ""22251439"", ""412584500"", ""360693589"", ""16087107"", ""1018796281"", ""14638660"", ""245915466"", ""532352922"", ""293445832"", ""2200271330"", ""2287848585"", ""123005566"", ""2780735418"", ""346733298"", ""2790570579"", ""207455866"", ""3074089481"", ""2270414820"", ""24067493""]",7,2,9
17325647,5,101.8,-0.157873797416687,13325745.0,4,0.8,"[""germanwings-crash-all-rnr-threads"", ""ottawashooting-all-rnr-threads"", ""sydneysiege-all-rnr-threads""]","[""6017542"", ""12848262"", ""6433472"", ""216586703""]",4,1,5
123303878,2,67.0,-0.17242538928985596,8708730.0,2,1.0,"[""germanwings-crash-all-rnr-threads"", ""sydneysiege-all-rnr-threads""]","[""759251"", ""227837742""]",2,0,2
23857263,6,124.66666666666667,-0.37251441677411395,13343755.0,5,0.8333333333333334,"[""germanwings-crash-all-rnr-threads"", ""ottawashooting-all-rnr-threads"", ""prince-toronto-all-rnr-threads""]","[""19636948"", ""526528241"", ""19038934"", ""12993222"", ""227837742""]",5,1,6
597244003,2,124.0,-0.44878971576690674,13319266.0,2,0.5,"[""germanwings-crash-all-rnr-threads"", ""ottawashooting-all-rnr-threads""]","[""22993014"", ""51241574""]",1,1,2
38392608,4,62.75,-0.13331153988838196,8718994.0,4,0.5,"[""germanwings-crash-all-rnr-threads"", ""sydneysiege-all-rnr-threads""]","[""1399909376"", ""428333"", ""15108702"", ""15234546""]",2,2,4
165923992,2,111.5,-0.055635273456573486,13369023.0,2,0.5,"[""germanwings-crash-all-rnr-threads"", ""ottawashooting-all-rnr-threads""]","[""18965790"", ""15234546""]",1,1,2
1329199266,8,64.375,-0.4391886964440346,8771839.0,6,0.625,"[""germanwings-crash-all-rnr-threads"", ""sydneysiege-all-rnr-threads""]","[""1359226843"", ""16973333"", ""9609632"", ""2097571"", ""3108351"", ""742143""]",5,3,8
179294405,2,129.5,-0.7606063783168793,8726512.0,2,1.0,"[""germanwings-crash-all-rnr-threads"", ""sydneysiege-all-rnr-threads""]","[""7587032"", ""2097571""]",2,0,2
285048452,2,100.5,-0.6314784586429596,8714155.0,2,1.0,"[""germanwings-crash-all-rnr-threads"", ""sydneysiege-all-rnr-threads""]","[""6017542"", ""87416722""]",2,0,2
32444081,2,102.0,-0.5548095107078552,13358861.0,2,1.0,"[""germanwings-crash-all-rnr-threads"", ""ottawashooting-all-rnr-threads""]","[""87416722"", ""5402612""]",2,0,2
775646406,4,125.5,-0.779741495847702,13429478.0,3,0.75,"[""germanwings-crash-all-rnr-threads"", ""ottawashooting-all-rnr-threads""]","[""19038934"", ""255187660"", ""20748745""]",3,1,4
80870096,2,121.5,-0.45805996656417847,13395108.0,2,1.0,"[""germanwings-crash-all-rnr-threads"", ""ottawashooting-all-rnr-threads""]","[""16887175"", ""428333""]",2,0,2
573692319,3,64.0,-0.4397347370783488,8735464.0,3,0.3333333333333333,"[""germanwings-crash-all-rnr-threads"", ""sydneysiege-all-rnr-threads""]","[""1367531"", ""43182702"", ""7587032""]",1,2,3
392886711,4,93.5,-0.3163844048976898,13425102.0,2,1.0,"[""germanwings-crash-all-rnr-threads"", ""ottawashooting-all-rnr-threads""]","[""940368062"", ""292777349""]",4,0,4
261608494,2,76.5,-0.6200200021266937,8797215.0,2,0.5,"[""germanwings-crash-all-rnr-threads"", ""sydneysiege-all-rnr-threads""]","[""44835347"", ""2163076560""]",1,1,2
162304163,7,115.85714285714286,-0.5574142592293876,8813586.0,74,0.5714285714285714,"[""germanwings-crash-all-rnr-threads"", ""sydneysiege-all-rnr-threads""]","[""279026259"", ""101292351"", ""166206766"", ""43801865"", ""85330589"", ""443288053"", ""138463234"", ""433329636"", ""1927524000"", ""46052566"", ""2511071191"", ""137748956"", ""2403256826"", ""1285310293"", ""1574358608"", ""294203824"", ""29029483"", ""30657692"", ""1388717472"", ""208881442"", ""90895888"", ""311297585"", ""175372810"", ""111278519"", ""30122242"", ""876116665"", ""137353459"", ""251605982"", ""1948384758"", ""286220129"", ""99034397"", ""53581322"", ""2758107898"", ""2675168874"", ""945399138"", ""2261325276"", ""1667055776"", ""2570798579"", ""2573051322"", ""33395455"", ""118961714"", ""313283125"", ""162784593"", ""1471931208"", ""1236665377"", ""109167913"", ""215173555"", ""51310666"", ""2904656365"", ""77431511"", ""2295743029"", ""110351137"", ""2240365320"", ""2843019210"", ""41798085"", ""74129739"", ""2259880764"", ""2734879242"", ""162304163"", ""2438291115"", ""63697141"", ""163015412"", ""2889979706"", ""737076433"", ""170057636"", ""2823169618"", ""345901028"", ""356350458"", ""349499674"", ""44943378"", ""2896679250"", ""145523686"", ""1686700296"", ""3037749678""]",4,3,7
63697141,2,122.5,-0.3633045256137848,8810443.0,1,0.5,"[""germanwings-crash-all-rnr-threads"", ""sydneysiege-all-rnr-threads""]","[""162304163""]",1,1,2
175372810,3,96.0,-0.18593172232309976,8811387.0,3,0.3333333333333333,"[""germanwings-crash-all-rnr-threads"", ""sydneysiege-all-rnr-threads""]","[""18839785"", ""268676434"", ""162304163""]",1,2,3
111278519,2,76.0,-0.2969636619091034,8815677.0,1,1.0,"[""germanwings-crash-all-rnr-threads"", ""sydneysiege-all-rnr-threads""]","[""162304163""]",2,0,2
51310666,3,65.66666666666667,-0.4532209038734436,13411249.0,2,0.3333333333333333,"[""germanwings-crash-all-rnr-threads"", ""ottawashooting-all-rnr-threads"", ""sydneysiege-all-rnr-threads""]","[""148653311"", ""162304163""]",1,2,3
2777537827,2,73.5,-0.737529456615448,8809521.0,2,1.0,"[""germanwings-crash-all-rnr-threads"", ""sydneysiege-all-rnr-threads""]","[""1263002017"", ""64643056""]",2,0,2
345071560,2,43.0,0.4084869623184204,8826842.0,2,1.0,"[""germanwings-crash-all-rnr-threads"", ""sydneysiege-all-rnr-threads""]","[""14940354"", ""1263002017""]",2,0,2
18524109,12,118.33333333333333,-0.3781859378019969,13485040.0,8,0.75,"[""germanwings-crash-all-rnr-threads"", ""ottawashooting-all-rnr-threads""]","[""16076032"", ""112562263"", ""141084952"", ""19211550"", ""19038934"", ""87416722"", ""17561562"", ""525634151""]",9,3,12
64233540,2,81.0,-0.08697301149368286,13441418.0,2,1.0,"[""germanwings-crash-all-rnr-threads"", ""ottawashooting-all-rnr-threads""]","[""51241574"", ""288283415""]",2,0,2
2792217104,2,89.5,-0.13372361660003662,8814137.0,2,0.5,"[""germanwings-crash-all-rnr-threads"", ""sydneysiege-all-rnr-threads""]","[""35051304"", ""525634151""]",1,1,2
495397696,2,91.0,0.22774863243103027,13440522.0,2,1.0,"[""germanwings-crash-all-rnr-threads"", ""ottawashooting-all-rnr-threads""]","[""19636948"", ""525634151""]",2,0,2
211365709,4,98.5,-0.3907856345176697,8664096.0,3,0.5,"[""germanwings-crash-all-rnr-threads"", ""sydneysiege-all-rnr-threads""]","[""14437914"", ""525634151"", ""153029181""]",2,2,4
17561562,5,125.4,-0.5956650137901306,1059503.0,38,0.8,"[""germanwings-crash-all-rnr-threads"", ""putinmissing-all-rnr-threads""]","[""324266450"", ""2615727072"", ""467026225"", ""538455539"", ""395700090"", ""1569701208"", ""1350989725"", ""18524109"", ""32189808"", ""316161690"", ""405036807"", ""1306245326"", ""2814080594"", ""46586980"", ""2877281933"", ""799407224"", ""1340614891"", ""17918375"", ""50178137"", ""603549409"", ""930776510"", ""479521250"", ""17561562"", ""628903113"", ""1727830092"", ""842685444"", ""185421080"", ""47464066"", ""46556971"", ""246464087"", ""30993714"", ""102131799"", ""902814223"", ""22226671"", ""45151571"", ""3015981726"", ""125896734"", ""293333930""]",4,1,5
405036807,2,133.0,-0.7488828301429749,13437891.0,2,1.0,"[""germanwings-crash-all-rnr-threads"", ""ottawashooting-all-rnr-threads""]","[""1367531"", ""17561562""]",2,0,2
930776510,2,77.5,-0.38207894563674927,13418485.0,2,0.5,"[""germanwings-crash-all-rnr-threads"", ""ottawashooting-all-rnr-threads""]","[""19038934"", ""17561562""]",1,1,2
22226671,7,107.57142857142857,-0.25257245131901335,13412841.0,3,0.14285714285714285,"[""germanwings-crash-all-rnr-threads"", ""ottawashooting-all-rnr-threads""]","[""20295763"", ""96104822"", ""17561562""]",1,6,7
1206161593,7,73.85714285714286,-0.41661251442773,8906666.0,4,0.8571428571428571,"[""germanwings-crash-all-rnr-threads"", ""putinmissing-all-rnr-threads"", ""sydneysiege-all-rnr-threads""]","[""28785486"", ""2941152158"", ""64643056"", ""36309919""]",6,1,7
183114110,8,112.25,-0.5584981963038445,8732022.0,2,0.125,"[""germanwings-crash-all-rnr-threads"", ""sydneysiege-all-rnr-threads""]","[""74144130"", ""374712154""]",1,7,8
824915659,7,105.42857142857143,-0.2716034139905657,13423513.0,7,0.2857142857142857,"[""germanwings-crash-all-rnr-threads"", ""ottawashooting-all-rnr-threads"", ""sydneysiege-all-rnr-threads""]","[""246130881"", ""14293310"", ""148653311"", ""30122242"", ""1960878613"", ""1626294277"", ""5402612""]",2,5,7
198359255,2,135.5,-0.3798257112503052,8812982.0,2,1.0,"[""germanwings-crash-all-rnr-threads"", ""sydneysiege-all-rnr-threads""]","[""30122242"", ""268662889""]",2,0,2
359015191,7,78.28571428571429,-0.25123503378459383,13596417.0,6,0.7142857142857143,"[""germanwings-crash-all-rnr-threads"", ""ottawashooting-all-rnr-threads"", ""sydneysiege-all-rnr-threads""]","[""7587032"", ""51241574"", ""54489465"", ""15754281"", ""1367531"", ""5402612""]",5,2,7
2482271094,2,99.0,-0.6851239800453186,8791933.0,2,1.0,"[""germanwings-crash-all-rnr-threads"", ""sydneysiege-all-rnr-threads""]","[""2280470022"", ""1652541""]",2,0,2
2285933645,4,107.0,-0.27130773663520813,8820289.0,2,0.25,"[""germanwings-crash-all-rnr-threads"", ""sydneysiege-all-rnr-threads""]","[""2280470022"", ""246130881""]",1,3,4
2818826268,5,137.0,-0.4530705213546753,8842139.0,5,0.8,"[""germanwings-crash-all-rnr-threads"", ""sydneysiege-all-rnr-threads""]","[""3108351"", ""2799960092"", ""15754281"", ""742143"", ""20402945""]",4,1,5
16062207,2,116.5,-0.24116230010986328,8853171.0,2,1.0,"[""germanwings-crash-all-rnr-threads"", ""sydneysiege-all-rnr-threads""]","[""15754281"", ""74014041""]",2,0,2
796916900,2,52.0,-0.3149973750114441,8893274.0,2,0.5,"[""germanwings-crash-all-rnr-threads"", ""sydneysiege-all-rnr-threads""]","[""611346290"", ""1462833583""]",1,1,2
30351538,2,97.0,-0.5171976089477539,13442137.0,2,1.0,"[""germanwings-crash-all-rnr-threads"", ""ottawashooting-all-rnr-threads""]","[""143695063"", ""22129280""]",2,0,2
170597868,5,130.4,-0.11826978921890259,13467774.0,2,1.0,"[""germanwings-crash-all-rnr-threads"", ""ottawashooting-all-rnr-threads""]","[""143695063"", ""23937894""]",5,0,5
66843801,2,84.5,-0.3376017212867737,8958509.0,2,1.0,"[""germanwings-crash-all-rnr-threads"", ""sydneysiege-all-rnr-threads""]","[""143695063"", ""5402612""]",2,0,2
2270414820,2,131.0,-0.4571109414100647,13445362.0,2,1.0,"[""germanwings-crash-all-rnr-threads"", ""ottawashooting-all-rnr-threads""]","[""3022045469"", ""12848262""]",2,0,2
2861968850,3,65.33333333333333,-0.42334820826848346,8856215.0,2,1.0,"[""germanwings-crash-all-rnr-threads"", ""sydneysiege-all-rnr-threads""]","[""3022045469"", ""292777349""]",3,0,3
18892635,3,136.66666666666666,-0.506661613782247,8823155.0,3,0.3333333333333333,"[""germanwings-crash-all-rnr-threads"", ""sydneysiege-all-rnr-threads""]","[""51241574"", ""36116351"", ""2097571""]",1,2,3
1177632823,4,137.75,-0.3953585773706436,13448735.0,3,0.25,"[""germanwings-crash-all-rnr-threads"", ""ottawashooting-all-rnr-threads"", ""sydneysiege-all-rnr-threads""]","[""24293233"", ""954124423"", ""358347117""]",1,3,4
27413161,8,79.625,-0.1953052058815956,8911849.0,4,0.625,"[""germanwings-crash-all-rnr-threads"", ""sydneysiege-all-rnr-threads""]","[""14173315"", ""16973333"", ""24293233"", ""2768501""]",5,3,8
119788492,3,109.66666666666667,-0.6147995193799337,13485617.0,3,0.6666666666666666,"[""germanwings-crash-all-rnr-threads"", ""ottawashooting-all-rnr-threads"", ""sydneysiege-all-rnr-threads""]","[""24293233"", ""20748745"", ""7587032""]",2,1,3
1040962352,4,75.25,-0.37953224778175354,8592647.0,3,0.25,"[""germanwings-crash-all-rnr-threads"", ""sydneysiege-all-rnr-threads""]","[""292777349"", ""92771309"", ""818212956""]",1,3,4
19009612,3,134.0,-0.19092349211374918,8567998.0,3,0.6666666666666666,"[""germanwings-crash-all-rnr-threads"", ""sydneysiege-all-rnr-threads""]","[""5402612"", ""2799960092"", ""428333""]",2,1,3
92940347,2,130.0,-0.6797706186771393,8535792.0,1,0.5,"[""germanwings-crash-all-rnr-threads"", ""sydneysiege-all-rnr-threads""]","[""2097571""]",1,1,2
51815697,2,92.5,-0.49325862526893616,13184281.0,1,0.5,"[""germanwings-crash-all-rnr-threads"", ""ottawashooting-all-rnr-threads""]","[""5402612""]",1,1,2
325375034,3,16.0,0.5085129340489706,13191919.0,3,0.3333333333333333,"[""germanwings-crash-all-rnr-threads"", ""ottawashooting-all-rnr-threads"", ""sydneysiege-all-rnr-threads""]","[""20402945"", ""51241574"", ""22968158""]",1,2,3
157506702,3,108.0,-0.42477182547251385,8541409.0,1,0.3333333333333333,"[""germanwings-crash-all-rnr-threads"", ""sydneysiege-all-rnr-threads""]","[""51241574""]",1,2,3
2571860615,2,79.0,0.061168015003204346,8725821.0,2,0.5,"[""germanwings-crash-all-rnr-threads"", ""sydneysiege-all-rnr-threads""]","[""51241574"", ""15513604""]",1,1,2
22594051,2,95.5,-0.7191185653209686,8541365.0,11,0.5,"[""germanwings-crash-all-rnr-threads"", ""sydneysiege-all-rnr-threads""]","[""1611879048"", ""16691210"", ""307194736"", ""1184544398"", ""14394227"", ""33746923"", ""20956994"", ""581702752"", ""61755415"", ""2917328135"", ""635042082""]",1,1,2
200725558,2,77.0,0.06484174728393555,8577805.0,2,0.0,"[""germanwings-crash-all-rnr-threads"", ""sydneysiege-all-rnr-threads""]","[""2799960092"", ""742143""]",0,2,2
388896551,4,121.75,-0.09059672057628632,8585182.0,3,0.0,"[""germanwings-crash-all-rnr-threads"", ""sydneysiege-all-rnr-threads""]","[""2566535282"", ""17387561"", ""64643056""]",0,4,4
780992342,3,128.0,-0.5273901621500651,13200227.0,3,0.0,"[""germanwings-crash-all-rnr-threads"", ""ottawashooting-all-rnr-threads"", ""sydneysiege-all-rnr-threads""]","[""17134268"", ""742143"", ""5402612""]",0,3,3
301309392,2,115.0,-0.7609780430793762,8538763.0,16,0.0,"[""germanwings-crash-all-rnr-threads"", ""sydneysiege-all-rnr-threads""]","[""39987298"", ""3076515406"", ""64410569"", ""409039885"", ""313483181"", ""34594988"", ""333509973"", ""2849522222"", ""2540949067"", ""40077371"", ""765642079"", ""32366017"", ""288332685"", ""254432684"", ""145238504"", ""284463220""]",0,2,2
6134882,2,91.5,-0.40776944160461426,10370739.0,1,0.5,"[""germanwings-crash-all-rnr-threads"", ""gurlitt-all-rnr-threads""]","[""99796388""]",1,1,2
78272041,4,105.75,-0.04855148494243622,8588868.0,3,0.0,"[""germanwings-crash-all-rnr-threads"", ""sydneysiege-all-rnr-threads""]","[""18725815"", ""22650211"", ""238575113""]",0,4,4
562486448,3,134.33333333333334,-0.1810614069302877,8584226.0,2,0.6666666666666666,"[""germanwings-crash-all-rnr-threads"", ""sydneysiege-all-rnr-threads""]","[""6017542"", ""16834659""]",2,1,3
508316850,3,137.0,-0.09043635924657185,8591203.0,3,0.3333333333333333,"[""germanwings-crash-all-rnr-threads"", ""sydneysiege-all-rnr-threads""]","[""35466620"", ""3006168515"", ""5402612""]",1,2,3
2691332454,2,57.0,-0.6952421069145203,8560152.0,2,0.0,"[""germanwings-crash-all-rnr-threads"", ""sydneysiege-all-rnr-threads""]","[""1375289149"", ""2768501""]",0,2,2
2401355906,3,137.0,-0.3730015556017558,8556582.0,2,0.0,"[""germanwings-crash-all-rnr-threads"", ""sydneysiege-all-rnr-threads""]","[""1375289149"", ""447410369""]",0,3,3
2314092451,2,59.0,-0.13371726870536804,8548376.0,2,0.0,"[""germanwings-crash-all-rnr-threads"", ""sydneysiege-all-rnr-threads""]","[""759251"", ""14260960""]",0,2,2
280242927,5,87.8,-0.39793946743011477,8596193.0,4,0.4,"[""germanwings-crash-all-rnr-threads"", ""sydneysiege-all-rnr-threads""]","[""23041630"", ""16675569"", ""7587032"", ""21548431""]",2,3,5
164897733,2,102.0,-0.6736263334751129,8554451.0,2,0.0,"[""germanwings-crash-all-rnr-threads"", ""sydneysiege-all-rnr-threads""]","[""2280470022"", ""1068121346""]",0,2,2
125944392,2,111.5,-0.08374905586242676,8548548.0,6,0.0,"[""germanwings-crash-all-rnr-threads"", ""sydneysiege-all-rnr-threads""]","[""2330911112"", ""1080276308"", ""2785202708"", ""58765247"", ""217033716"", ""1484774424""]",0,2,2
16469809,4,112.5,0.1252949833869934,13205621.0,53,0.0,"[""germanwings-crash-all-rnr-threads"", ""ottawashooting-all-rnr-threads"", ""sydneysiege-all-rnr-threads""]","[""18134063"", ""36927988"", ""535422067"", ""66054233"", ""232367421"", ""11621822"", ""57332943"", ""30013010"", ""2506762918"", ""14780356"", ""25303349"", ""395065007"", ""1281371282"", ""2821078376"", ""28902856"", ""2909575890"", ""2241310171"", ""1256370990"", ""336736196"", ""52778651"", ""2821577173"", ""64672157"", ""23036010"", ""778057"", ""404460410"", ""135920825"", ""47127416"", ""22403315"", ""279756555"", ""19875325"", ""36469971"", ""308743028"", ""145639160"", ""22135559"", ""47202691"", ""73257329"", ""16549857"", ""115710058"", ""262662868"", ""23537487"", ""2906487165"", ""142236260"", ""362375494"", ""39809139"", ""23721448"", ""16693964"", ""2776586882"", ""279950087"", ""24398700"", ""227712159"", ""16469809"", ""26192100"", ""8475532""]",0,4,4
2536796111,5,35.8,0.24417773485183716,8544075.0,4,0.2,"[""germanwings-crash-all-rnr-threads"", ""sydneysiege-all-rnr-threads""]","[""18424289"", ""759251"", ""1367531"", ""51241574""]",1,4,5
1516705844,2,110.5,-0.0763365626335144,13198341.0,2,0.0,"[""germanwings-crash-all-rnr-threads"", ""ottawashooting-all-rnr-threads""]","[""759251"", ""148116121""]",0,2,2
384438102,5,125.6,-0.10561113357543946,13209881.0,41,0.6,"[""germanwings-crash-all-rnr-threads"", ""ottawashooting-all-rnr-threads"", ""sydneysiege-all-rnr-threads""]","[""23562333"", ""93781106"", ""48610056"", ""38745244"", ""211998385"", ""27956792"", ""178191648"", ""38788916"", ""120091931"", ""2795245697"", ""1137979866"", ""886909039"", ""849342841"", ""168377979"", ""2803849820"", ""252753770"", ""2821577173"", ""22422706"", ""2888321602"", ""45486801"", ""2459019415"", ""22865856"", ""2856927247"", ""51636276"", ""499656413"", ""1223090863"", ""201295178"", ""408194759"", ""2688052579"", ""2611076161"", ""188401426"", ""1494424579"", ""1979093557"", ""58341062"", ""2390188116"", ""1556849240"", ""11462742"", ""33520167"", ""21566066"", ""3066319711"", ""525795906""]",3,2,5
22389207,2,129.0,-0.028509020805358887,13206858.0,2,0.0,"[""germanwings-crash-all-rnr-threads"", ""ottawashooting-all-rnr-threads""]","[""2280470022"", ""148116121""]",0,2,2
2305228178,2,133.5,-0.75700244307518,13151167.0,2,0.5,"[""germanwings-crash-all-rnr-threads"", ""ottawashooting-all-rnr-threads""]","[""1652541"", ""7587032""]",1,1,2
503613785,2,80.0,-0.42055392265319824,8580819.0,2,0.5,"[""germanwings-crash-all-rnr-threads"", ""sydneysiege-all-rnr-threads""]","[""14293310"", ""15108702""]",1,1,2
77957493,3,113.33333333333333,-0.17175028721491495,13207870.0,2,0.6666666666666666,"[""germanwings-crash-all-rnr-threads"", ""ottawashooting-all-rnr-threads""]","[""759251"", ""1310201424""]",2,1,3
18839785,3,107.0,-0.39389342069625854,13206178.0,52,0.0,"[""germanwings-crash-all-rnr-threads"", ""ottawashooting-all-rnr-threads"", ""sydneysiege-all-rnr-threads""]","[""149196537"", ""982953108"", ""1264268972"", ""271950370"", ""558644263"", ""1274690550"", ""75237705"", ""417205244"", ""30416955"", ""217828344"", ""258032705"", ""1891344427"", ""212588933"", ""52336338"", ""2892169192"", ""47300062"", ""129181096"", ""138483646"", ""59074366"", ""2177703954"", ""406871979"", ""2560288593"", ""3082174516"", ""101164760"", ""45570628"", ""175372810"", ""2917779663"", ""976957999"", ""144777914"", ""3008157331"", ""784941084"", ""96771717"", ""79802631"", ""2732054725"", ""628489259"", ""52344823"", ""142995792"", ""605640136"", ""1008666679"", ""75952047"", ""1719698352"", ""2350496557"", ""551886609"", ""113987829"", ""112255377"", ""490172340"", ""120030860"", ""182314735"", ""479459331"", ""196988110"", ""114119234"", ""132886361""]",0,3,3
17436585,36,89.02777777777777,-0.5478170994255279,8596800.0,11,0.4166666666666667,"[""germanwings-crash-all-rnr-threads"", ""sydneysiege-all-rnr-threads""]","[""14173315"", ""423662810"", ""55186601"", ""7587032"", ""3108351"", ""28785486"", ""15754281"", ""742143"", ""64643056"", ""489336004"", ""5402612""]",15,21,36
182251918,6,95.83333333333333,-0.3000986377398173,8726816.0,31,0.3333333333333333,"[""germanwings-crash-all-rnr-threads"", ""sydneysiege-all-rnr-threads""]","[""2830225240"", ""2769476752"", ""54742770"", ""100418160"", ""310884882"", ""53229950"", ""148756631"", ""39279839"", ""16540169"", ""126359064"", ""32012957"", ""26156936"", ""270726710"", ""182251918"", ""139768199"", ""1149091800"", ""20654278"", ""19072339"", ""26084779"", ""632392229"", ""347673715"", ""16504112"", ""834997832"", ""24655516"", ""2740020247"", ""93310294"", ""423168084"", ""864927037"", ""1212988922"", ""343012467"", ""1950204932""]",2,4,6
16504112,4,46.5,0.023002982139587402,13319140.0,2,0.25,"[""germanwings-crash-all-rnr-threads"", ""ottawashooting-all-rnr-threads""]","[""182251918"", ""17983365""]",1,3,4
129964269,3,129.33333333333334,-0.35605496168136597,8796857.0,5,0.3333333333333333,"[""germanwings-crash-all-rnr-threads"", ""sydneysiege-all-rnr-threads""]","[""3068138332"", ""18596522"", ""2304047108"", ""261529036"", ""2451614138""]",1,2,3
1476204271,6,104.0,-0.3297058443228404,8932512.0,4,0.3333333333333333,"[""germanwings-crash-all-rnr-threads"", ""sydneysiege-all-rnr-threads""]","[""403647191"", ""49591803"", ""52327900"", ""8197942""]",2,4,6
31816832,2,70.5,-0.42743363976478577,8773032.0,2,0.0,"[""germanwings-crash-all-rnr-threads"", ""sydneysiege-all-rnr-threads""]","[""14173315"", ""392773603""]",0,2,2
2795274284,2,64.5,0.32130205631256104,8791692.0,2,0.0,"[""germanwings-crash-all-rnr-threads"", ""sydneysiege-all-rnr-threads""]","[""55911799"", ""99211591""]",0,2,2
312291066,2,127.0,0.10628777742385864,13415583.0,2,0.5,"[""germanwings-crash-all-rnr-threads"", ""ottawashooting-all-rnr-threads""]","[""19038934"", ""14677919""]",1,1,2
16664681,2,121.5,-0.21135926246643066,8823301.0,12,0.5,"[""germanwings-crash-all-rnr-threads"", ""sydneysiege-all-rnr-threads""]","[""86457463"", ""549757392"", ""2743621676"", ""185472553"", ""1574277745"", ""2834121230"", ""1047778988"", ""106651328"", ""210408678"", ""2214510864"", ""618407853"", ""23990555""]",1,1,2
86141342,2,123.0,-0.4274151623249054,8821795.0,11,0.0,"[""germanwings-crash-all-rnr-threads"", ""sydneysiege-all-rnr-threads""]","[""2402349354"", ""1496722939"", ""326957730"", ""138927988"", ""36305576"", ""1038954511"", ""2896040005"", ""218284934"", ""74923166"", ""1330906501"", ""3041819821""]",0,2,2
47582275,3,113.0,-0.26999205350875854,1828849.0,3,0.6666666666666666,"[""sydneysiege-all-rnr-threads"", ""gurlitt-all-rnr-threads""]","[""7587032"", ""13496142"", ""5402612""]",2,1,3
26248921,2,76.0,-0.22797608375549316,4614469.0,2,1.0,"[""ottawashooting-all-rnr-threads"", ""sydneysiege-all-rnr-threads""]","[""42896073"", ""9609632""]",2,0,2
8736882,28,116.57142857142857,-0.23855982507978166,1147450.0,303,0.75,"[""ottawashooting-all-rnr-threads"", ""prince-toronto-all-rnr-threads""]","[""589749291"", ""492391926"", ""355881905"", ""29382277"", ""18168840"", ""539285912"", ""1024416474"", ""200131940"", ""26271503"", ""137532637"", ""74783402"", ""26681154"", ""2340704077"", ""17300548"", ""782380586"", ""2530231530"", ""282311693"", ""295451046"", ""419202838"", ""904304714"", ""434356583"", ""108451537"", ""489609031"", ""250338868"", ""72753700"", ""245854696"", ""2369749214"", ""54187750"", ""378793620"", ""49536219"", ""1271512166"", ""65675381"", ""85146182"", ""1674143862"", ""750430579"", ""498116251"", ""211279806"", ""2400408805"", ""2290473844"", ""37155876"", ""1604870690"", ""221355278"", ""1360062656"", ""33274411"", ""36433167"", ""388533708"", ""28193644"", ""582322302"", ""1954308373"", ""180439912"", ""16632498"", ""165681100"", ""25474671"", ""965006155"", ""113860170"", ""274098175"", ""18145383"", ""1239973814"", ""36362160"", ""2383606800"", ""1118211596"", ""1237336591"", ""2238386702"", ""787504434"", ""93359723"", ""184990558"", ""62216912"", ""604838152"", ""313129574"", ""111774146"", ""32622476"", ""2432522299"", ""21347335"", ""201131101"", ""593329368"", ""1125291961"", ""1242969978"", ""56459602"", ""1571766372"", ""430749539"", ""135576133"", ""72204671"", ""564761837"", ""297463081"", ""248805537"", ""362468942"", ""407132151"", ""16645396"", ""297882624"", ""73668436"", ""15259394"", ""2596628207"", ""1652173441"", ""368480353"", ""204262657"", ""15823471"", ""402680886"", ""66034438"", ""1450187184"", ""50426761"", ""134240162"", ""160398040"", ""195915833"", ""171025236"", ""351781571"", ""2319451561"", ""138999399"", ""48304732"", ""2241058057"", ""1206279740"", ""539839489"", ""2347505749"", ""358145106"", ""2810444973"", ""20282233"", ""40032409"", ""2241310448"", ""503280219"", ""445979458"", ""131629525"", ""21653606"", ""169939175"", ""24785521"", ""124877794"", ""866981359"", ""44963227"", ""142929095"", ""421510046"", ""31124500"", ""60453148"", ""80384548"", ""23446740"", ""983016968"", ""2347646462"", ""177439122"", ""25339267"", ""40274232"", ""369029151"", ""1198798310"", ""1010344255"", ""79198828"", ""19952601"", ""2261645749"", ""522580748"", ""48045229"", ""360065533"", ""2754052301"", ""2471649080"", ""556985783"", ""398404674"", ""441028083"", ""585903763"", ""368392804"", ""146126002"", ""23245572"", ""2398593854"", ""750623802"", ""2408016120"", ""276357161"", ""58566981"", ""860537298"", ""167477645"", ""2816999719"", ""308361932"", ""1025567762"", ""1169035220"", ""25076865"", ""287488831"", ""1488536312"", ""227564112"", ""1633311770"", ""6870462"", ""240506490"", ""477394039"", ""1617689252"", ""6872652"", ""451479165"", ""621335481"", ""288523651"", ""985507718"", ""97519068"", ""2169028045"", ""43369293"", ""137540879"", ""2162983369"", ""347913941"", ""49333762"", ""34419059"", ""403010943"", ""70197140"", ""14975117"", ""2833227409"", ""606841632"", ""149021748"", ""546249014"", ""862370796"", ""132602552"", ""558224845"", ""17728007"", ""28360460"", ""21800713"", ""531378178"", ""126685021"", ""1498971"", ""518186814"", ""825876614"", ""419789923"", ""283517156"", ""29273650"", ""318517116"", ""477701937"", ""2723303783"", ""93194555"", ""75315301"", ""19543128"", ""213731463"", ""2796029406"", ""579066455"", ""23646964"", ""135989775"", ""600993846"", ""999907196"", ""184637613"", ""1534295472"", ""147167437"", ""954430236"", ""370407086"", ""2768705528"", ""800787145"", ""155960966"", ""2180742758"", ""181308812"", ""212540215"", ""182080346"", ""27843193"", ""18360180"", ""371484459"", ""1705956127"", ""456803009"", ""2837244053"", ""14106427"", ""86026819"", ""488734600"", ""114559812"", ""94476810"", ""1101881678"", ""1135182312"", ""262439911"", ""21724151"", ""1596223609"", ""377141989"", ""31025868"", ""22878080"", ""58258515"", ""172170292"", ""37043257"", ""21301094"", ""972762792"", ""462432709"", ""49017636"", ""2730439402"", ""331026320"", ""77755525"", ""339400727"", ""241252188"", ""1027818966"", ""2290447610"", ""14438255"", ""87545372"", ""289685952"", ""767840768"", ""20297625"", ""182503524"", ""322064312"", ""915065514"", ""42304448"", ""1416885949"", ""18732993"", ""480623325"", ""591101848"", ""136300871"", ""1668485292"", ""2429961212"", ""2273197344"", ""187521297"", ""19679903"", ""476617549"", ""89770815"", ""312693640"", ""75833183"", ""18991451"", ""1115999816"", ""2695084196"", ""488546287"", ""244209009"", ""1282328996"", ""11462742"", ""2370972427"", ""49504819"", ""247655077"", ""50014086"", ""782688668"", ""2393744315""]",21,7,28
1852665702,28,121.57142857142857,-0.3137407068695341,4672069.0,10,0.4642857142857143,"[""ottawashooting-all-rnr-threads"", ""sydneysiege-all-rnr-threads""]","[""81122301"", ""27831488"", ""1652541"", ""19038934"", ""12848262"", ""759251"", ""2467791"", ""18999969"", ""21106414"", ""428333""]",13,15,28
24215395,3,110.66666666666667,0.098319411277771,4620599.0,9,0.3333333333333333,"[""ottawashooting-all-rnr-threads"", ""sydneysiege-all-rnr-threads""]","[""10927162"", ""774733530"", ""40137874"", ""1405382442"", ""64952642"", ""7401202"", ""170862500"", ""21270879"", ""257291338""]",1,2,3
6433472,24,113.625,-0.25232167293628055,4671070.0,216,0.7083333333333334,"[""ottawashooting-all-rnr-threads"", ""sydneysiege-all-rnr-threads"", ""prince-toronto-all-rnr-threads""]","[""17461235"", ""2607972383"", ""371578747"", ""19569126"", ""2745860932"", ""39088744"", ""788261840"", ""396865731"", ""1692670669"", ""32909508"", ""74783402"", ""2705721566"", ""21515465"", ""165546381"", ""44561318"", ""2796385418"", ""1328313170"", ""419202838"", ""464385804"", ""26973231"", ""17257471"", ""250338868"", ""110579028"", ""2461672814"", ""1979464926"", ""1585719186"", ""14102830"", ""27973500"", ""1262915538"", ""45059895"", ""119117989"", ""307554061"", ""15689619"", ""843685266"", ""2508619652"", ""875642220"", ""1667943404"", ""55484650"", ""1377207996"", ""2822750684"", ""16751857"", ""93359723"", ""235190244"", ""557820662"", ""2444330064"", ""480977436"", ""1575867799"", ""2674769562"", ""2233662300"", ""21995609"", ""20418836"", ""17325647"", ""19788514"", ""27080522"", ""180005108"", ""26089811"", ""22418027"", ""1684729040"", ""2504602921"", ""2709410371"", ""1077124544"", ""32662315"", ""49585298"", ""284804728"", ""434989561"", ""17962349"", ""24481392"", ""2161221234"", ""303982135"", ""62391759"", ""1573531718"", ""1485964628"", ""2747413785"", ""2738314259"", ""981921793"", ""6068542"", ""247150427"", ""25612588"", ""2815209991"", ""341873977"", ""262648331"", ""2687483634"", ""445327295"", ""970391360"", ""55374833"", ""1928183017"", ""388043109"", ""2203610179"", ""269804643"", ""327651682"", ""116205474"", ""17734425"", ""242199512"", ""620417458"", ""41074304"", ""46182435"", ""94360519"", ""2500030157"", ""2598340132"", ""1645266590"", ""22530457"", ""141416686"", ""339847349"", ""170356578"", ""141776971"", ""25996734"", ""2800621519"", ""18587376"", ""473477315"", ""46100172"", ""31618419"", ""19516505"", ""1318520846"", ""2427905179"", ""23885575"", ""1274066096"", ""2401156465"", ""2408016120"", ""2625540574"", ""1854055933"", ""66796394"", ""19069438"", ""268833251"", ""6433472"", ""336661862"", ""15653527"", ""502356581"", ""296858138"", ""354544316"", ""2474717340"", ""23654321"", ""2294247621"", ""1945521565"", ""2816892041"", ""26422398"", ""1270271011"", ""493369507"", ""1051485102"", ""105240473"", ""1485584766"", ""2260621981"", ""19413325"", ""2903783646"", ""29568154"", ""347913941"", ""522839045"", ""2307421946"", ""1464941263"", ""35472060"", ""2528052019"", ""27257426"", ""2790184530"", ""1167413696"", ""31589500"", ""1289398842"", ""382793951"", ""2796029406"", ""1069848732"", ""36913636"", ""25884540"", ""350551933"", ""236877995"", ""223832606"", ""16660572"", ""9530392"", ""55075272"", ""261041421"", ""1064505300"", ""262882223"", ""19118964"", ""21938084"", ""1626451183"", ""1107194444"", ""351877178"", ""2811678258"", ""455019202"", ""133011087"", ""37659072"", ""373601625"", ""1606836498"", ""25143051"", ""107801808"", ""277321993"", ""284006171"", ""517961389"", ""764420420"", ""530850746"", ""253879378"", ""16188492"", ""22986475"", ""2814031933"", ""20026746"", ""110037176"", ""19038934"", ""2728383208"", ""30794695"", ""45458699"", ""20204796"", ""520875081"", ""49178951"", ""1543941642"", ""807623953"", ""1898945509"", ""2573537198"", ""132612207"", ""813682537"", ""292002656"", ""381592902"", ""2561621657"", ""2430396417"", ""57557424"", ""275841919"", ""864927037"", ""248027083"", ""142709459"", ""476848835""]",17,7,24
46100172,4,98.5,-0.3526344895362854,4666307.0,2,0.75,"[""ottawashooting-all-rnr-threads"", ""sydneysiege-all-rnr-threads""]","[""6433472"", ""16973333""]",3,1,4
472083714,5,96.4,-0.42447147369384763,4669203.0,2,1.0,"[""ottawashooting-all-rnr-threads"", ""sydneysiege-all-rnr-threads""]","[""1367531"", ""5402612""]",5,0,5
73267432,2,81.0,-0.6831768155097961,1127518.0,2,1.0,"[""ottawashooting-all-rnr-threads"", ""prince-toronto-all-rnr-threads""]","[""19636948"", ""83715203""]",2,0,2
576539791,2,98.5,-0.36278027296066284,4686212.0,2,0.5,"[""ottawashooting-all-rnr-threads"", ""sydneysiege-all-rnr-threads""]","[""21106414"", ""14260960""]",1,1,2
43355844,2,107.0,-0.6147921085357666,1144438.0,10,1.0,"[""ottawashooting-all-rnr-threads"", ""prince-toronto-all-rnr-threads""]","[""481358625"", ""437828796"", ""420700211"", ""27443402"", ""1548507152"", ""528820859"", ""87563045"", ""58579317"", ""339928774"", ""83993450""]",2,0,2
27443402,5,135.6,-0.46419200897216795,4636205.0,5,1.0,"[""ottawashooting-all-rnr-threads"", ""sydneysiege-all-rnr-threads""]","[""43355844"", ""13896552"", ""747398809"", ""2768501"", ""428333""]",5,0,5
351877178,2,62.0,-0.5395565629005432,1133694.0,2,1.0,"[""ottawashooting-all-rnr-threads"", ""prince-toronto-all-rnr-threads""]","[""42672470"", ""6433472""]",2,0,2
242900070,12,69.75,0.1762826293706894,4670054.0,1,1.0,"[""ottawashooting-all-rnr-threads"", ""sydneysiege-all-rnr-threads""]","[""6017542""]",12,0,12
1041049706,3,132.0,-0.30463123321533203,4603418.0,3,1.0,"[""ottawashooting-all-rnr-threads"", ""sydneysiege-all-rnr-threads""]","[""1652541"", ""6017542"", ""5402612""]",3,0,3
2453850531,40,81.97499999999998,-0.19987319707870482,12486267.0,16,0.85,"[""ottawashooting-all-rnr-threads"", ""putinmissing-all-rnr-threads"", ""sydneysiege-all-rnr-threads""]","[""1630896181"", ""14098166"", ""246130881"", ""1652541"", ""15108702"", ""2097571"", ""22138134"", ""2799960092"", ""742143"", ""499696436"", ""203123011"", ""64643056"", ""972651"", ""15400294"", ""1367531"", ""5402612""]",34,6,40
874743020,2,71.5,-0.14276108145713806,4617754.0,1,1.0,"[""ottawashooting-all-rnr-threads"", ""sydneysiege-all-rnr-threads""]","[""1367531""]",2,0,2
2401156465,11,135.8181818181818,-0.41245695677670563,4677085.0,7,0.5454545454545454,"[""ottawashooting-all-rnr-threads"", ""sydneysiege-all-rnr-threads""]","[""6433472"", ""171643578"", ""17984709"", ""51241574"", ""18999969"", ""16753407"", ""23937894""]",6,5,11
1084735669,2,41.5,0.2679307460784912,4637611.0,2,1.0,"[""ottawashooting-all-rnr-threads"", ""sydneysiege-all-rnr-threads""]","[""1652541"", ""51241574""]",2,0,2
433675700,11,119.81818181818181,-0.2105663472955877,1138640.0,8,0.6363636363636364,"[""ottawashooting-all-rnr-threads"", ""prince-toronto-all-rnr-threads""]","[""263371799"", ""87029364"", ""25235198"", ""16351521"", ""24000965"", ""19038934"", ""193725962"", ""23937894""]",7,4,11
1081610900,2,134.5,-0.07454243302345276,4615900.0,2,0.5,"[""ottawashooting-all-rnr-threads"", ""sydneysiege-all-rnr-threads""]","[""58360124"", ""24000965""]",1,1,2
17659340,4,102.5,-0.09265303611755371,1143148.0,17,1.0,"[""ottawashooting-all-rnr-threads"", ""prince-toronto-all-rnr-threads""]","[""481666573"", ""728394116"", ""2264940392"", ""50791051"", ""345595739"", ""2745860932"", ""19165526"", ""904445552"", ""14160437"", ""20787283"", ""2686207134"", ""309809359"", ""23019023"", ""283289087"", ""921467413"", ""52821098"", ""430880741""]",4,0,4
416696463,2,44.5,0.17521309852600098,4620004.0,2,1.0,"[""ottawashooting-all-rnr-threads"", ""sydneysiege-all-rnr-threads""]","[""742143"", ""14216661""]",2,0,2
14066645,2,127.5,-0.8378756046295166,4620071.0,2,0.5,"[""ottawashooting-all-rnr-threads"", ""sydneysiege-all-rnr-threads""]","[""22138134"", ""428333""]",1,1,2
19111502,10,71.6,-0.5478216230869293,4627820.0,10,0.6,"[""ottawashooting-all-rnr-threads"", ""sydneysiege-all-rnr-threads""]","[""49654153"", ""238575113"", ""19038934"", ""1934989190"", ""203123011"", ""913135650"", ""1413216920"", ""325747234"", ""87818409"", ""23937894""]",6,4,10
20561955,3,69.66666666666667,-0.2599434057871501,4641954.0,2,0.6666666666666666,"[""ottawashooting-all-rnr-threads"", ""sydneysiege-all-rnr-threads""]","[""331672974"", ""5402612""]",2,1,3
2511071191,3,130.66666666666666,-0.6853494048118591,4623777.0,3,1.0,"[""ottawashooting-all-rnr-threads"", ""sydneysiege-all-rnr-threads""]","[""1652541"", ""162304163"", ""5402612""]",3,0,3
30699754,9,124.33333333333333,-0.35513434145185685,4650732.0,13,0.7777777777777778,"[""ottawashooting-all-rnr-threads"", ""sydneysiege-all-rnr-threads""]","[""709426525"", ""244850695"", ""2885631924"", ""225288490"", ""47303841"", ""1974794186"", ""259849032"", ""30699754"", ""864927037"", ""1668697268"", ""122822249"", ""15649636"", ""2590214491""]",7,2,9
22199699,5,100.0,-0.5163910508155822,1159745.0,3,1.0,"[""ottawashooting-all-rnr-threads"", ""prince-toronto-all-rnr-threads""]","[""17909653"", ""526528241"", ""22568416""]",5,0,5
54017531,3,123.33333333333333,-0.6286862889925638,4664844.0,1,0.6666666666666666,"[""ottawashooting-all-rnr-threads"", ""sydneysiege-all-rnr-threads""]","[""1367531""]",2,1,3
2313836011,5,90.6,-0.20200637578964234,4667673.0,2,1.0,"[""ottawashooting-all-rnr-threads"", ""sydneysiege-all-rnr-threads""]","[""64643056"", ""5402612""]",5,0,5
503749143,5,131.2,-0.46032150983810427,4636479.0,3,0.8,"[""ottawashooting-all-rnr-threads"", ""sydneysiege-all-rnr-threads""]","[""19038934"", ""28785486"", ""18999969""]",4,1,5
137873483,3,73.33333333333333,-0.30673980712890625,12367541.0,3,0.6666666666666666,"[""ottawashooting-all-rnr-threads"", ""putinmissing-all-rnr-threads"", ""sydneysiege-all-rnr-threads""]","[""15438913"", ""17537467"", ""5402612""]",2,1,3
3847661,3,122.66666666666667,-0.2975100676218669,4644437.0,3,0.6666666666666666,"[""ottawashooting-all-rnr-threads"", ""sydneysiege-all-rnr-threads""]","[""16675569"", ""25516222"", ""1900801694""]",2,1,3
20228338,4,113.75,-0.6218947768211365,4666648.0,4,1.0,"[""ottawashooting-all-rnr-threads"", ""sydneysiege-all-rnr-threads""]","[""1652541"", ""129673790"", ""203123011"", ""5402612""]",4,0,4
59843216,4,130.75,-0.06343469023704529,4628080.0,3,0.25,"[""ottawashooting-all-rnr-threads"", ""sydneysiege-all-rnr-threads""]","[""1652541"", ""742143"", ""5402612""]",1,3,4
299148448,2,118.5,-0.06628745794296265,4672195.0,2,0.5,"[""ottawashooting-all-rnr-threads"", ""sydneysiege-all-rnr-threads""]","[""1652541"", ""2602208286""]",1,1,2
455636856,2,52.5,-0.15871793031692505,4663409.0,1,0.5,"[""ottawashooting-all-rnr-threads"", ""sydneysiege-all-rnr-threads""]","[""7587032""]",1,1,2
525641377,4,138.0,-0.17458805441856384,4663351.0,2,0.25,"[""ottawashooting-all-rnr-threads"", ""sydneysiege-all-rnr-threads""]","[""7587032"", ""41085467""]",1,3,4
234874463,4,96.75,0.22071054577827454,4625321.0,10,0.75,"[""ottawashooting-all-rnr-threads"", ""sydneysiege-all-rnr-threads""]","[""2238411649"", ""79526702"", ""2371415304"", ""29818443"", ""74563472"", ""280228828"", ""1651273447"", ""572608166"", ""479252856"", ""1003208960""]",3,1,4
16293469,3,67.33333333333333,-0.2578587333361308,4653354.0,3,0.3333333333333333,"[""ottawashooting-all-rnr-threads"", ""sydneysiege-all-rnr-threads""]","[""16973333"", ""37881687"", ""18999969""]",1,2,3
2168889209,2,94.5,-0.7325452268123627,4619982.0,2,1.0,"[""ottawashooting-all-rnr-threads"", ""sydneysiege-all-rnr-threads""]","[""244571847"", ""51241574""]",2,0,2
21212604,6,118.16666666666667,-0.2477766474088033,1138187.0,43,0.8333333333333334,"[""ottawashooting-all-rnr-threads"", ""prince-toronto-all-rnr-threads""]","[""2805410179"", ""19816911"", ""1564054608"", ""66164755"", ""1167434527"", ""224403587"", ""20485718"", ""333109046"", ""25605030"", ""438600923"", ""87055066"", ""2314192086"", ""298806649"", ""419202838"", ""909226608"", ""175986326"", ""2208103440"", ""2600928566"", ""50246172"", ""87811668"", ""2780739448"", ""1525449950"", ""118179702"", ""162128725"", ""91153829"", ""2806596777"", ""76779351"", ""281099451"", ""989327822"", ""29210505"", ""55041282"", ""770481672"", ""188033070"", ""108820968"", ""21110041"", ""12662442"", ""49216439"", ""80280391"", ""999907196"", ""193048446"", ""11462742"", ""481672601"", ""53568415""]",5,1,6
204944073,2,114.0,-0.44431018829345703,4621040.0,2,0.5,"[""ottawashooting-all-rnr-threads"", ""sydneysiege-all-rnr-threads""]","[""15966995"", ""5402612""]",1,1,2
1626325842,4,80.5,-0.40388134121894836,4659808.0,4,0.25,"[""ottawashooting-all-rnr-threads"", ""sydneysiege-all-rnr-threads""]","[""14511951"", ""16973333"", ""87416722"", ""17001435""]",1,3,4
206596726,2,80.5,-0.18782806396484375,4660450.0,2,0.5,"[""ottawashooting-all-rnr-threads"", ""sydneysiege-all-rnr-threads""]","[""87416722"", ""7587032""]",1,1,2
93359723,7,116.57142857142857,-0.21010914019175939,4666726.0,6,0.5714285714285714,"[""ottawashooting-all-rnr-threads"", ""sydneysiege-all-rnr-threads""]","[""8736882"", ""62894963"", ""21660529"", ""6433472"", ""491960101"", ""23937894""]",4,3,7
165546381,3,67.33333333333333,-0.5257848302523295,4686321.0,3,0.6666666666666666,"[""ottawashooting-all-rnr-threads"", ""sydneysiege-all-rnr-threads""]","[""16807528"", ""6433472"", ""64643056""]",2,1,3
846939530,3,68.33333333333333,-0.24783150355021158,4649304.0,2,1.0,"[""ottawashooting-all-rnr-threads"", ""sydneysiege-all-rnr-threads""]","[""14173315"", ""16834659""]",3,0,3
48310336,7,138.0,-0.44431338139942717,4665781.0,2,0.7142857142857143,"[""ottawashooting-all-rnr-threads"", ""sydneysiege-all-rnr-threads""]","[""1367531"", ""51241574""]",5,2,7
17734425,4,43.25,-0.2397744357585907,4665718.0,4,0.75,"[""ottawashooting-all-rnr-threads"", ""sydneysiege-all-rnr-threads""]","[""15012486"", ""6433472"", ""20402945"", ""18999969""]",3,1,4
1380691543,4,64.5,-0.46944478154182434,4664810.0,3,1.0,"[""ottawashooting-all-rnr-threads"", ""sydneysiege-all-rnr-threads""]","[""28785486"", ""428333"", ""5402612""]",4,0,4
325747234,7,111.28571428571429,-0.31515748160226004,4610843.0,31,0.5714285714285714,"[""ottawashooting-all-rnr-threads"", ""sydneysiege-all-rnr-threads"", ""prince-toronto-all-rnr-threads""]","[""887432780"", ""1039855052"", ""634874281"", ""2465801928"", ""39061679"", ""19111502"", ""567756424"", ""1436704700"", ""45409087"", ""325747234"", ""7905512"", ""836410892"", ""444225252"", ""14547848"", ""223917113"", ""21458970"", ""49072873"", ""35495165"", ""37208886"", ""113241529"", ""33247096"", ""129673790"", ""17824049"", ""20413127"", ""535459859"", ""208569778"", ""864927037"", ""325427451"", ""52503887"", ""197994096"", ""583862299""]",4,3,7
816602323,2,40.5,-0.5090799629688263,4615899.0,2,1.0,"[""ottawashooting-all-rnr-threads"", ""sydneysiege-all-rnr-threads""]","[""292777349"", ""428333""]",2,0,2
375721095,6,121.33333333333333,-0.4403589864571889,4612379.0,64,1.0,"[""ottawashooting-all-rnr-threads"", ""sydneysiege-all-rnr-threads""]","[""1038341514"", ""558168147"", ""42525672"", ""20639175"", ""292629799"", ""31118126"", ""222184684"", ""1369778664"", ""2558068521"", ""1210189555"", ""489802910"", ""333064380"", ""1657670528"", ""23811334"", ""373713486"", ""128541148"", ""1448600947"", ""859958270"", ""787895389"", ""243187466"", ""516103610"", ""469778818"", ""1695442555"", ""2567492196"", ""518551305"", ""235633579"", ""177291126"", ""1592079391"", ""2372196812"", ""375795665"", ""304184842"", ""2273282888"", ""82539013"", ""53378296"", ""2267731544"", ""19808025"", ""36048950"", ""2223453362"", ""310137625"", ""362199127"", ""860465437"", ""2784589948"", ""103588513"", ""174827761"", ""272112035"", ""118847454"", ""24452368"", ""48361069"", ""38926453"", ""2797781981"", ""319406270"", ""342678370"", ""315869655"", ""35604658"", ""199387685"", ""2925094346"", ""72797386"", ""259945285"", ""2214847005"", ""42577934"", ""2886586060"", ""257179659"", ""11462742"", ""1945410296""]",6,0,6
6068542,12,73.66666666666667,-0.3310636778672536,4873998.0,2,0.16666666666666666,"[""ottawashooting-all-rnr-threads"", ""sydneysiege-all-rnr-threads""]","[""6433472"", ""204832963""]",2,10,12
26040618,10,76.7,-0.0205535888671875,1143945.0,21,0.9,"[""ottawashooting-all-rnr-threads"", ""prince-toronto-all-rnr-threads""]","[""330929366"", ""1373018754"", ""218308653"", ""885480031"", ""34492089"", ""18145829"", ""26040618"", ""42896073"", ""17909653"", ""61377031"", ""69031247"", ""22569833"", ""281753900"", ""2437473804"", ""14661313"", ""1378497379"", ""81232966"", ""2471649080"", ""16431556"", ""30464361"", ""164764113""]",9,1,10
17614860,3,89.0,0.013814071814219156,4657827.0,3,0.3333333333333333,"[""ottawashooting-all-rnr-threads"", ""sydneysiege-all-rnr-threads""]","[""16343974"", ""126486040"", ""2378713202""]",1,2,3
2795245697,2,138.5,-0.005276203155517578,4677589.0,2,1.0,"[""ottawashooting-all-rnr-threads"", ""sydneysiege-all-rnr-threads""]","[""384438102"", ""37874853""]",2,0,2
13896552,4,100.75,-0.061107248067855835,1139981.0,12,1.0,"[""ottawashooting-all-rnr-threads"", ""prince-toronto-all-rnr-threads""]","[""27443402"", ""999907196"", ""86421703"", ""22949742"", ""27800447"", ""500737429"", ""528372492"", ""30545847"", ""1109766193"", ""99440457"", ""21546866"", ""430880741""]",4,0,4
27800447,2,140.0,-0.5551649034023285,1194088.0,2,1.0,"[""ottawashooting-all-rnr-threads"", ""prince-toronto-all-rnr-threads""]","[""21137035"", ""13896552""]",2,0,2
22192440,3,103.66666666666667,-0.6327089269955953,1138097.0,7,1.0,"[""ottawashooting-all-rnr-threads"", ""prince-toronto-all-rnr-threads""]","[""18191382"", ""14231419"", ""21923301"", ""1014210612"", ""20008319"", ""366820602"", ""147202533""]",3,0,3
176930329,4,96.25,-0.2742662727832794,1141205.0,13,1.0,"[""ottawashooting-all-rnr-threads"", ""prince-toronto-all-rnr-threads""]","[""24041474"", ""473545254"", ""57995307"", ""176930329"", ""261023298"", ""1039855052"", ""930808560"", ""2591679415"", ""568940880"", ""2550678733"", ""441341395"", ""3817401"", ""14216544""]",4,0,4
41738539,3,55.333333333333336,-0.24168535073598227,4633691.0,2,0.6666666666666666,"[""ottawashooting-all-rnr-threads"", ""sydneysiege-all-rnr-threads""]","[""172887151"", ""292777349""]",2,1,3
16753407,2,59.5,-0.48969969153404236,4610797.0,13,1.0,"[""ottawashooting-all-rnr-threads"", ""sydneysiege-all-rnr-threads""]","[""2401156465"", ""14523404"", ""14590552"", ""5854302"", ""247335309"", ""28360460"", ""19038934"", ""372343086"", ""107169602"", ""27516138"", ""33146275"", ""2578789111"", ""83699170""]",2,0,2
1480842452,2,137.5,-0.5193394422531128,4607846.0,2,1.0,"[""ottawashooting-all-rnr-threads"", ""sydneysiege-all-rnr-threads""]","[""18424289"", ""64643056""]",2,0,2
1091725316,6,58.833333333333336,-0.20657161871592203,4664295.0,4,0.8333333333333334,"[""ottawashooting-all-rnr-threads"", ""sydneysiege-all-rnr-threads""]","[""18424289"", ""1367531"", ""224135257"", ""428333""]",5,1,6
1033997960,2,121.0,-0.04634612798690796,4647461.0,2,0.5,"[""ottawashooting-all-rnr-threads"", ""sydneysiege-all-rnr-threads""]","[""223484404"", ""5402612""]",1,1,2
1210189555,3,96.0,-0.1451809803644816,4612685.0,3,0.3333333333333333,"[""ottawashooting-all-rnr-threads"", ""sydneysiege-all-rnr-threads""]","[""272172091"", ""375721095"", ""204832963""]",1,2,3
199387685,32,89.40625,-0.4030129797756672,4624163.0,2,0.03125,"[""ottawashooting-all-rnr-threads"", ""sydneysiege-all-rnr-threads""]","[""373783051"", ""375721095""]",1,31,32
512990257,3,43.0,-0.2585681676864624,4605422.0,2,1.0,"[""ottawashooting-all-rnr-threads"", ""sydneysiege-all-rnr-threads""]","[""19038934"", ""258627226""]",3,0,3
427515851,2,117.0,-0.47974371910095215,4616289.0,8,1.0,"[""ottawashooting-all-rnr-threads"", ""sydneysiege-all-rnr-threads""]","[""136118400"", ""5402612"", ""2378914268"", ""25206663"", ""415785026"", ""117825643"", ""265663375"", ""1534373568""]",2,0,2
467394861,5,126.0,-0.5188430547714233,4681481.0,2,1.0,"[""ottawashooting-all-rnr-threads"", ""sydneysiege-all-rnr-threads""]","[""6017542"", ""342894187""]",5,0,5
1176823969,3,135.66666666666666,-0.8731180230776469,4649534.0,3,0.6666666666666666,"[""ottawashooting-all-rnr-threads"", ""sydneysiege-all-rnr-threads""]","[""171606833"", ""15012486"", ""1877831""]",2,1,3
133677123,3,116.66666666666667,-0.3502599398295085,4609471.0,2,1.0,"[""ottawashooting-all-rnr-threads"", ""sydneysiege-all-rnr-threads""]","[""1652541"", ""15669672""]",3,0,3
1569425222,2,67.0,0.6175097227096558,4652724.0,2,0.5,"[""ottawashooting-all-rnr-threads"", ""sydneysiege-all-rnr-threads""]","[""3108351"", ""51241574""]",1,1,2
1503164911,2,115.5,0.14375090599060059,4609047.0,2,1.0,"[""ottawashooting-all-rnr-threads"", ""sydneysiege-all-rnr-threads""]","[""1367531"", ""51241574""]",2,0,2
1694019936,13,83.3076923076923,-0.41603440046310425,4676240.0,1,1.0,"[""ottawashooting-all-rnr-threads"", ""sydneysiege-all-rnr-threads""]","[""5402612""]",13,0,13
2261645749,3,117.66666666666667,-0.1414729356765747,4607321.0,2,0.6666666666666666,"[""ottawashooting-all-rnr-threads"", ""sydneysiege-all-rnr-threads""]","[""499696436"", ""8736882""]",2,1,3
1633311770,2,117.5,0.20330357551574707,4660384.0,2,0.5,"[""ottawashooting-all-rnr-threads"", ""sydneysiege-all-rnr-threads""]","[""7587032"", ""8736882""]",1,1,2
312693640,4,113.5,-0.3609775900840759,4661603.0,3,0.75,"[""ottawashooting-all-rnr-threads"", ""sydneysiege-all-rnr-threads""]","[""1960878613"", ""51241574"", ""8736882""]",3,1,4
80280391,5,112.6,0.3161813020706177,4649224.0,4,0.8,"[""ottawashooting-all-rnr-threads"", ""sydneysiege-all-rnr-threads""]","[""21212604"", ""7587032"", ""115393565"", ""16106522""]",4,1,5
950435708,24,126.54166666666667,-0.12388119846582414,4706397.0,4,0.041666666666666664,"[""ottawashooting-all-rnr-threads"", ""sydneysiege-all-rnr-threads""]","[""16930489"", ""18643437"", ""19806962"", ""374712154""]",1,23,24
2407248410,4,50.75,-0.20871931314468384,4661559.0,4,0.5,"[""ottawashooting-all-rnr-threads"", ""sydneysiege-all-rnr-threads""]","[""3108351"", ""2260706071"", ""7587032"", ""266084123""]",2,2,4
197777712,4,127.75,0.5420483350753784,4634736.0,4,0.25,"[""ottawashooting-all-rnr-threads"", ""sydneysiege-all-rnr-threads""]","[""35626475"", ""3108351"", ""1960878613"", ""27931710""]",1,3,4
2255785158,5,58.6,-0.19730271100997926,4613919.0,2,1.0,"[""ottawashooting-all-rnr-threads"", ""sydneysiege-all-rnr-threads""]","[""3108351"", ""25777812""]",5,0,5
750430579,2,56.5,0.3744560480117798,4615668.0,2,0.5,"[""ottawashooting-all-rnr-threads"", ""sydneysiege-all-rnr-threads""]","[""520011678"", ""8736882""]",1,1,2
16249747,2,105.5,-0.19633275270462036,4612794.0,2,0.5,"[""ottawashooting-all-rnr-threads"", ""sydneysiege-all-rnr-threads""]","[""5402612"", ""428333""]",1,1,2
1932452484,2,61.5,-0.09462612867355347,4618155.0,2,0.5,"[""ottawashooting-all-rnr-threads"", ""sydneysiege-all-rnr-threads""]","[""2799960092"", ""2097571""]",1,1,2
2260621981,6,89.16666666666667,-0.03238670031229655,4612862.0,4,0.8333333333333334,"[""ottawashooting-all-rnr-threads"", ""sydneysiege-all-rnr-threads""]","[""19038934"", ""6433472"", ""18999969"", ""5402612""]",5,1,6
15994109,4,119.75,-0.4214288741350174,1134305.0,17,1.0,"[""ottawashooting-all-rnr-threads"", ""prince-toronto-all-rnr-threads""]","[""16458926"", ""542112461"", ""107900713"", ""286723230"", ""2546622582"", ""1188108474"", ""30254858"", ""23103737"", ""191240531"", ""53234124"", ""243893605"", ""2752658132"", ""1031933461"", ""262323940"", ""481666573"", ""62616502"", ""430880741""]",4,0,4
481666573,2,73.5,-0.15462547540664673,1121689.0,2,1.0,"[""ottawashooting-all-rnr-threads"", ""prince-toronto-all-rnr-threads""]","[""17659340"", ""15994109""]",2,0,2
259630649,2,91.0,-0.7122187316417694,4630522.0,2,0.5,"[""ottawashooting-all-rnr-threads"", ""sydneysiege-all-rnr-threads""]","[""380648579"", ""51241574""]",1,1,2
563178382,2,41.5,-0.21632397174835205,4648836.0,2,1.0,"[""ottawashooting-all-rnr-threads"", ""sydneysiege-all-rnr-threads""]","[""292777349"", ""7587032""]",2,0,2
8839632,4,117.75,-0.4530971795320511,4665079.0,34,0.5,"[""ottawashooting-all-rnr-threads"", ""sydneysiege-all-rnr-threads""]","[""217118762"", ""2248861878"", ""1499508518"", ""469439467"", ""1090918099"", ""1177132308"", ""113087412"", ""765763200"", ""516890141"", ""2437280948"", ""858646280"", ""1052399454"", ""12443132"", ""2889483819"", ""539573373"", ""2710733892"", ""113095705"", ""159547698"", ""1668336080"", ""1927091514"", ""114581245"", ""2828120210"", ""29870604"", ""74904294"", ""39403686"", ""100625142"", ""36270774"", ""105102974"", ""16615615"", ""1738679586"", ""16737566"", ""18678121"", ""61131948"", ""356864823""]",2,2,4
554969283,2,126.0,-0.27826887369155884,4624272.0,1,1.0,"[""ottawashooting-all-rnr-threads"", ""sydneysiege-all-rnr-threads""]","[""28785486""]",2,0,2
25888359,2,79.5,0.0966036319732666,4613659.0,2,0.5,"[""ottawashooting-all-rnr-threads"", ""sydneysiege-all-rnr-threads""]","[""6017542"", ""35051304""]",1,1,2
2179916998,2,101.0,-0.5925102233886719,4650225.0,2,0.5,"[""ottawashooting-all-rnr-threads"", ""sydneysiege-all-rnr-threads""]","[""18643437"", ""18999969""]",1,1,2
2614001430,8,80.125,-0.3150273784995079,4608320.0,4,0.625,"[""ottawashooting-all-rnr-threads"", ""sydneysiege-all-rnr-threads""]","[""1652541"", ""2467791"", ""64643056"", ""428333""]",5,3,8
2707571696,3,104.66666666666667,-0.5830995241800944,4604045.0,2,1.0,"[""ottawashooting-all-rnr-threads"", ""sydneysiege-all-rnr-threads""]","[""16930489"", ""7587032""]",3,0,3
66525934,2,59.5,0.4472544193267822,4620965.0,2,0.5,"[""ottawashooting-all-rnr-threads"", ""sydneysiege-all-rnr-threads""]","[""19636948"", ""9609632""]",1,1,2
24242690,2,139.5,-0.4214305579662323,4609662.0,2,1.0,"[""ottawashooting-all-rnr-threads"", ""sydneysiege-all-rnr-threads""]","[""19038934"", ""5402612""]",2,0,2
64766298,4,134.0,-0.29478543996810913,4651493.0,4,0.5,"[""ottawashooting-all-rnr-threads"", ""sydneysiege-all-rnr-threads""]","[""28096105"", ""2327508680"", ""246130881"", ""22536395""]",2,2,4
950736588,2,96.5,-0.09952616691589355,4602186.0,1,0.5,"[""ottawashooting-all-rnr-threads"", ""sydneysiege-all-rnr-threads""]","[""28096105""]",1,1,2
170539874,2,38.0,-0.7058061957359314,12476701.0,2,0.5,"[""ottawashooting-all-rnr-threads"", ""putinmissing-all-rnr-threads""]","[""64643056"", ""747398809""]",1,1,2
17758398,8,106.25,-0.19755306839942932,1143133.0,3,0.625,"[""ottawashooting-all-rnr-threads"", ""prince-toronto-all-rnr-threads""]","[""30913843"", ""39728435"", ""203123011""]",5,3,8
428750698,5,84.6,-0.3912404775619507,4608716.0,3,1.0,"[""ottawashooting-all-rnr-threads"", ""sydneysiege-all-rnr-threads""]","[""15669672"", ""28785486"", ""25516222""]",5,0,5
234981515,3,85.0,-0.49868420759836835,4660902.0,3,0.6666666666666666,"[""ottawashooting-all-rnr-threads"", ""sydneysiege-all-rnr-threads""]","[""19038934"", ""292777349"", ""64643056""]",2,1,3
469699513,13,83.38461538461539,-0.3889159101706285,4623254.0,5,0.5384615384615384,"[""ottawashooting-all-rnr-threads"", ""sydneysiege-all-rnr-threads""]","[""612473"", ""742143"", ""64643056"", ""50348344"", ""5402612""]",7,6,13
1378497379,6,72.0,-0.12304908037185669,1153776.0,3,1.0,"[""ottawashooting-all-rnr-threads"", ""prince-toronto-all-rnr-threads""]","[""26040618"", ""263310916"", ""428333""]",6,0,6
347913941,5,90.8,0.032173538208007814,4618400.0,5,0.4,"[""ottawashooting-all-rnr-threads"", ""sydneysiege-all-rnr-threads""]","[""8736882"", ""230859523"", ""6433472"", ""28785486"", ""35051304""]",2,3,5
965006155,3,70.33333333333333,-0.2539047996203105,4607777.0,2,0.3333333333333333,"[""ottawashooting-all-rnr-threads"", ""sydneysiege-all-rnr-threads""]","[""60937837"", ""8736882""]",1,2,3
1066159118,6,109.16666666666667,-0.12525542577107748,4616964.0,3,0.8333333333333334,"[""ottawashooting-all-rnr-threads"", ""sydneysiege-all-rnr-threads""]","[""16671007"", ""21548431"", ""1169109691""]",5,1,6
34002867,2,37.5,-0.06724318861961365,4655670.0,2,1.0,"[""ottawashooting-all-rnr-threads"", ""sydneysiege-all-rnr-threads""]","[""87416722"", ""51241574""]",2,0,2
150156884,2,138.5,0.19307339191436768,4655900.0,2,1.0,"[""ottawashooting-all-rnr-threads"", ""sydneysiege-all-rnr-threads""]","[""1367531"", ""51241574""]",2,0,2
222168247,3,88.0,0.1769262949625651,4659876.0,3,0.3333333333333333,"[""ottawashooting-all-rnr-threads"", ""sydneysiege-all-rnr-threads""]","[""132231788"", ""18725815"", ""29518466""]",1,2,3
253615698,3,93.66666666666667,-0.47540857394536334,4598743.0,2,1.0,"[""ottawashooting-all-rnr-threads"", ""sydneysiege-all-rnr-threads""]","[""51241574"", ""16834659""]",3,0,3
20349790,3,50.0,-0.1949815551439921,4626865.0,1,1.0,"[""ottawashooting-all-rnr-threads"", ""sydneysiege-all-rnr-threads""]","[""428333""]",3,0,3
448355007,3,73.0,-0.07973710695902507,4638403.0,2,1.0,"[""ottawashooting-all-rnr-threads"", ""sydneysiege-all-rnr-threads""]","[""5402612"", ""428333""]",3,0,3
2483752741,3,42.666666666666664,0.010465145111083984,4601413.0,2,1.0,"[""ottawashooting-all-rnr-threads"", ""sydneysiege-all-rnr-threads""]","[""14569869"", ""5402612""]",3,0,3
275288575,3,69.66666666666667,-0.11246124903361003,4630646.0,3,1.0,"[""ottawashooting-all-rnr-threads"", ""sydneysiege-all-rnr-threads""]","[""16589206"", ""64643056"", ""807095""]",3,0,3
1173408768,2,139.5,-0.45412349700927734,4618917.0,2,1.0,"[""ottawashooting-all-rnr-threads"", ""sydneysiege-all-rnr-threads""]","[""7587032"", ""807095""]",2,0,2
2161859750,2,139.5,-0.18729782104492188,4596272.0,2,1.0,"[""ottawashooting-all-rnr-threads"", ""sydneysiege-all-rnr-threads""]","[""14173315"", ""742143""]",2,0,2
315880426,3,116.33333333333333,-0.5684262116750082,4656829.0,1,1.0,"[""ottawashooting-all-rnr-threads"", ""sydneysiege-all-rnr-threads""]","[""7587032""]",3,0,3
82998105,2,139.5,-0.14573276042938232,4596177.0,2,0.5,"[""ottawashooting-all-rnr-threads"", ""sydneysiege-all-rnr-threads""]","[""28785486"", ""499696436""]",1,1,2
242394241,4,127.75,-0.11217425763607025,1146373.0,3,0.75,"[""ottawashooting-all-rnr-threads"", ""prince-toronto-all-rnr-threads""]","[""12987202"", ""526528241"", ""61597754""]",3,1,4
21359504,2,102.0,0.12530124187469482,1124580.0,8,1.0,"[""ottawashooting-all-rnr-threads"", ""prince-toronto-all-rnr-threads""]","[""61597754"", ""35745942"", ""12987202"", ""22195515"", ""246574430"", ""187685383"", ""80897013"", ""23608974""]",2,0,2
19000033,11,113.0,-0.20384858413176102,1149892.0,26,0.9090909090909091,"[""ottawashooting-all-rnr-threads"", ""prince-toronto-all-rnr-threads""]","[""43115649"", ""2812472155"", ""242539243"", ""821621028"", ""157077618"", ""360693589"", ""331344120"", ""630375860"", ""2547323635"", ""47770201"", ""19000033"", ""2165815802"", ""17621519"", ""586849356"", ""1967179970"", ""57085159"", ""307554061"", ""32045747"", ""436351349"", ""1183381112"", ""430880741"", ""164082921"", ""272110718"", ""6634632"", ""208673346"", ""18179554""]",10,1,11
2797781981,2,78.0,-0.6667978167533875,4581926.0,2,1.0,"[""ottawashooting-all-rnr-threads"", ""sydneysiege-all-rnr-threads""]","[""375721095"", ""42958829""]",2,0,2
148508453,3,132.66666666666666,-0.25703712304433185,4640667.0,2,0.6666666666666666,"[""ottawashooting-all-rnr-threads"", ""sydneysiege-all-rnr-threads""]","[""19038934"", ""14260960""]",2,1,3
89947367,2,51.5,-0.4827825129032135,4591239.0,2,1.0,"[""ottawashooting-all-rnr-threads"", ""sydneysiege-all-rnr-threads""]","[""380648579"", ""2779009591""]",2,0,2
398404674,2,52.5,-0.7190757393836975,4604040.0,2,0.5,"[""ottawashooting-all-rnr-threads"", ""sydneysiege-all-rnr-threads""]","[""8736882"", ""5402612""]",1,1,2
809880978,2,89.0,0.4259684085845947,12281515.0,2,1.0,"[""ottawashooting-all-rnr-threads"", ""putinmissing-all-rnr-threads""]","[""2327508680"", ""18025377""]",2,0,2
1292608776,2,42.0,0.16295784711837769,4653282.0,2,0.5,"[""ottawashooting-all-rnr-threads"", ""sydneysiege-all-rnr-threads""]","[""952112047"", ""214007688""]",1,1,2
497485493,5,103.6,-0.4376107931137085,4593992.0,2,1.0,"[""ottawashooting-all-rnr-threads"", ""sydneysiege-all-rnr-threads""]","[""1652541"", ""17469289""]",5,0,5
117509053,3,102.66666666666667,-0.3888231913248698,4594578.0,2,0.6666666666666666,"[""ottawashooting-all-rnr-threads"", ""sydneysiege-all-rnr-threads""]","[""1652541"", ""2799960092""]",2,1,3
126800237,6,90.0,-0.40321411689122516,4671720.0,3,0.8333333333333334,"[""ottawashooting-all-rnr-threads"", ""sydneysiege-all-rnr-threads""]","[""6017542"", ""292777349"", ""18999969""]",5,1,6
121789732,2,131.5,-0.8721058666706085,4594213.0,2,1.0,"[""ottawashooting-all-rnr-threads"", ""sydneysiege-all-rnr-threads""]","[""24630719"", ""115393565""]",2,0,2
2316193393,2,34.0,-0.05378919839859009,4591902.0,2,1.0,"[""ottawashooting-all-rnr-threads"", ""sydneysiege-all-rnr-threads""]","[""19636948"", ""17004618""]",2,0,2
2738314259,3,30.666666666666668,0.7622108459472656,1107538.0,3,1.0,"[""ottawashooting-all-rnr-threads"", ""prince-toronto-all-rnr-threads""]","[""458285383"", ""6433472"", ""18206318""]",3,0,3
93804616,2,103.0,-0.4624139368534088,4644119.0,2,0.5,"[""ottawashooting-all-rnr-threads"", ""sydneysiege-all-rnr-threads""]","[""17537467"", ""76858507""]",1,1,2
1005109987,3,121.33333333333333,-0.17746853828430176,4642026.0,2,0.6666666666666666,"[""ottawashooting-all-rnr-threads"", ""sydneysiege-all-rnr-threads""]","[""19038934"", ""203123011""]",2,1,3
21803786,4,71.0,-0.08239856362342834,4599534.0,3,1.0,"[""ottawashooting-all-rnr-threads"", ""sydneysiege-all-rnr-threads""]","[""28785486"", ""37874853"", ""15220768""]",4,0,4
714530598,2,110.0,-0.16397714614868164,4646241.0,2,0.5,"[""ottawashooting-all-rnr-threads"", ""sydneysiege-all-rnr-threads""]","[""1652541"", ""211105315""]",1,1,2
21850237,3,118.33333333333333,-0.2685285409291585,4615114.0,2,0.6666666666666666,"[""ottawashooting-all-rnr-threads"", ""sydneysiege-all-rnr-threads""]","[""103065157"", ""203123011""]",2,1,3
501293202,2,127.0,0.013655543327331543,1096248.0,6,1.0,"[""ottawashooting-all-rnr-threads"", ""prince-toronto-all-rnr-threads""]","[""503487728"", ""331026320"", ""2191405329"", ""133151405"", ""72648916"", ""946887186""]",2,0,2
311198407,2,62.0,-0.4052310585975647,4598632.0,2,1.0,"[""ottawashooting-all-rnr-threads"", ""sydneysiege-all-rnr-threads""]","[""14138785"", ""16031927""]",2,0,2
633536872,2,127.0,-0.584984689950943,4615613.0,1,1.0,"[""ottawashooting-all-rnr-threads"", ""sydneysiege-all-rnr-threads""]","[""292777349""]",2,0,2
1047778988,4,126.25,-0.1540623903274536,4644826.0,3,0.75,"[""ottawashooting-all-rnr-threads"", ""sydneysiege-all-rnr-threads""]","[""16664681"", ""807095"", ""5402612""]",3,1,4
120233447,2,107.5,-0.5465618073940277,4588932.0,2,1.0,"[""ottawashooting-all-rnr-threads"", ""sydneysiege-all-rnr-threads""]","[""1652541"", ""51241574""]",2,0,2
1310820734,3,90.0,-0.02170260747273763,4595136.0,2,0.3333333333333333,"[""ottawashooting-all-rnr-threads"", ""sydneysiege-all-rnr-threads""]","[""16930489"", ""51241574""]",1,2,3
255354721,2,137.5,-0.24315977096557617,4628660.0,2,1.0,"[""ottawashooting-all-rnr-threads"", ""sydneysiege-all-rnr-threads""]","[""28785486"", ""2467791""]",2,0,2
2507342209,2,90.0,-0.5551630854606628,4599258.0,2,0.5,"[""ottawashooting-all-rnr-threads"", ""sydneysiege-all-rnr-threads""]","[""2467791"", ""17668544""]",1,1,2
272172091,4,117.5,0.1780409812927246,4619587.0,50,0.5,"[""ottawashooting-all-rnr-threads"", ""sydneysiege-all-rnr-threads""]","[""456803009"", ""1614191498"", ""286924993"", ""1245045625"", ""273189433"", ""525345413"", ""1597347326"", ""336661862"", ""1210189555"", ""1902526770"", ""1249996986"", ""176986779"", ""49700849"", ""258448915"", ""67412086"", ""2332928719"", ""48172733"", ""405364961"", ""331026320"", ""266904396"", ""2228795449"", ""332884767"", ""246801406"", ""106427888"", ""267959196"", ""431504592"", ""16792937"", ""1915467306"", ""2806168694"", ""2431432212"", ""1403732101"", ""479854353"", ""49053574"", ""105911241"", ""1230646238"", ""2538899928"", ""150046236"", ""15702055"", ""63463165"", ""24864037"", ""858180043"", ""53915727"", ""430297317"", ""405325303"", ""350985825"", ""2423108833"", ""337455676"", ""239778775"", ""2810630287"", ""568592688""]",2,2,4
331026320,3,68.66666666666667,-0.19306709369023642,1104592.0,3,0.6666666666666666,"[""ottawashooting-all-rnr-threads"", ""prince-toronto-all-rnr-threads""]","[""272172091"", ""8736882"", ""501293202""]",2,1,3
93489985,2,97.5,-0.5714699327945709,4592912.0,2,0.5,"[""ottawashooting-all-rnr-threads"", ""sydneysiege-all-rnr-threads""]","[""75584076"", ""7401202""]",1,1,2
137124849,2,51.0,-0.20485979318618774,4617505.0,2,1.0,"[""ottawashooting-all-rnr-threads"", ""sydneysiege-all-rnr-threads""]","[""16973333"", ""266084123""]",2,0,2
408241447,3,96.66666666666667,-0.3497588634490967,4597295.0,2,1.0,"[""ottawashooting-all-rnr-threads"", ""sydneysiege-all-rnr-threads""]","[""14460241"", ""266084123""]",3,0,3
175986326,2,114.5,-0.6956601738929749,4622002.0,2,0.5,"[""ottawashooting-all-rnr-threads"", ""sydneysiege-all-rnr-threads""]","[""21212604"", ""1663752234""]",1,1,2
16737566,3,107.0,0.13213372230529785,4639279.0,3,0.6666666666666666,"[""ottawashooting-all-rnr-threads"", ""sydneysiege-all-rnr-threads""]","[""2884771"", ""8839632"", ""428333""]",2,1,3
2458244786,3,136.0,0.1056143840154012,4622399.0,3,0.3333333333333333,"[""ottawashooting-all-rnr-threads"", ""sydneysiege-all-rnr-threads""]","[""382027901"", ""1125937411"", ""164418122""]",1,2,3
104342504,3,116.0,-0.14799257119496664,4618326.0,3,0.6666666666666666,"[""ottawashooting-all-rnr-threads"", ""sydneysiege-all-rnr-threads""]","[""34310801"", ""21744712"", ""428333""]",2,1,3
22930902,2,117.0,-0.18718576431274414,1095281.0,18,1.0,"[""ottawashooting-all-rnr-threads"", ""prince-toronto-all-rnr-threads""]","[""1591637096"", ""1274066096"", ""1664103122"", ""445933854"", ""93693386"", ""860049924"", ""810864775"", ""923505056"", ""120627815"", ""33520555"", ""24089166"", ""1500437611"", ""439502873"", ""384449449"", ""2436548302"", ""2400408805"", ""430880741"", ""386212199""]",2,0,2
33857678,5,130.2,-0.199301815032959,4613581.0,5,0.8,"[""ottawashooting-all-rnr-threads"", ""sydneysiege-all-rnr-threads""]","[""2097571"", ""64643056"", ""2836941830"", ""16834659"", ""5402612""]",4,1,5
372095233,2,103.5,-0.6987724602222443,4618756.0,16,0.5,"[""ottawashooting-all-rnr-threads"", ""sydneysiege-all-rnr-threads""]","[""18378680"", ""32311971"", ""612689514"", ""6058942"", ""114326949"", ""357268748"", ""2097571"", ""15464803"", ""296743238"", ""15640499"", ""149495489"", ""29662631"", ""23013302"", ""151295755"", ""25271888"", ""2776979193""]",1,1,2
196746305,2,103.0,-0.543821394443512,4604704.0,2,1.0,"[""ottawashooting-all-rnr-threads"", ""sydneysiege-all-rnr-threads""]","[""171802941"", ""2097571""]",2,0,2
282756639,5,79.4,-0.08980851173400879,4596140.0,4,0.6,"[""ottawashooting-all-rnr-threads"", ""sydneysiege-all-rnr-threads""]","[""106272927"", ""1960878613"", ""7587032"", ""64643056""]",3,2,5
932642034,2,59.5,-0.6916255950927734,4580698.0,2,1.0,"[""ottawashooting-all-rnr-threads"", ""sydneysiege-all-rnr-threads""]","[""1020058453"", ""63105173""]",2,0,2
287371352,2,85.0,-0.5551227331161499,4585093.0,2,0.5,"[""ottawashooting-all-rnr-threads"", ""sydneysiege-all-rnr-threads""]","[""16930489"", ""1367531""]",1,1,2
1173940586,3,12.666666666666666,0.1309201717376709,4640849.0,1,1.0,"[""ottawashooting-all-rnr-threads"", ""sydneysiege-all-rnr-threads""]","[""292777349""]",3,0,3
35051304,24,98.95833333333333,-0.3327608456214269,4593612.0,67,0.08333333333333333,"[""ottawashooting-all-rnr-threads"", ""sydneysiege-all-rnr-threads""]","[""2797205190"", ""2325696978"", ""20182781"", ""28149842"", ""2305811305"", ""373658858"", ""246981694"", ""216202571"", ""1556339839"", ""416690465"", ""2664984804"", ""1187514980"", ""67760893"", ""232367421"", ""136395858"", ""373758798"", ""411799851"", ""1213899720"", ""402090275"", ""2363427326"", ""2391536900"", ""1069074590"", ""35434532"", ""293950381"", ""2577908804"", ""1658154254"", ""118214601"", ""1304556728"", ""465790247"", ""403047066"", ""742143"", ""89177788"", ""174331939"", ""347913941"", ""16343974"", ""2363651838"", ""24598047"", ""25888359"", ""1097027300"", ""2895066089"", ""526544992"", ""405383139"", ""2792217104"", ""553222851"", ""2730539544"", ""128362699"", ""788479346"", ""2289119257"", ""35051304"", ""149771098"", ""1416161688"", ""87957753"", ""1732070107"", ""139680498"", ""1447035235"", ""471512320"", ""2227563385"", ""2159951328"", ""2797913416"", ""705633312"", ""1917209870"", ""37685181"", ""756919694"", ""2290235028"", ""2859241221"", ""8754802"", ""23951702""]",2,22,24
445791130,3,70.66666666666667,-0.2868226965268453,4595455.0,3,0.6666666666666666,"[""ottawashooting-all-rnr-threads"", ""sydneysiege-all-rnr-threads""]","[""240028072"", ""16343974"", ""2832527047""]",2,1,3
22129280,2,132.0,-0.0937577486038208,4638649.0,20,1.0,"[""ottawashooting-all-rnr-threads"", ""sydneysiege-all-rnr-threads""]","[""30351538"", ""37425092"", ""23568501"", ""22583725"", ""2301638123"", ""118552439"", ""363954623"", ""358803674"", ""17323875"", ""2273282888"", ""2440465051"", ""2189599459"", ""501061708"", ""2345457853"", ""28833436"", ""2925094346"", ""40227558"", ""143608097"", ""2738316383"", ""765035604""]",2,0,2
28245169,2,72.5,-0.18403172492980957,4600111.0,2,1.0,"[""ottawashooting-all-rnr-threads"", ""sydneysiege-all-rnr-threads""]","[""51241574"", ""428333""]",2,0,2
885667550,4,41.0,-0.32899656891822815,4600714.0,3,1.0,"[""ottawashooting-all-rnr-threads"", ""sydneysiege-all-rnr-threads""]","[""16343974"", ""759251"", ""428333""]",4,0,4
2740521853,3,75.66666666666667,-0.5102999210357666,4541299.0,2,0.6666666666666666,"[""ottawashooting-all-rnr-threads"", ""sydneysiege-all-rnr-threads""]","[""954124423"", ""175452918""]",2,1,3
311994165,2,136.5,-0.4447416067123413,4660127.0,2,0.5,"[""ottawashooting-all-rnr-threads"", ""sydneysiege-all-rnr-threads""]","[""63362429"", ""5402612""]",1,1,2
359678512,3,106.0,-0.14203550418217978,4609259.0,2,0.3333333333333333,"[""ottawashooting-all-rnr-threads"", ""sydneysiege-all-rnr-threads""]","[""352858004"", ""373783051""]",1,2,3
2716052092,3,79.66666666666667,-0.3397224148114522,4587393.0,3,0.6666666666666666,"[""ottawashooting-all-rnr-threads"", ""sydneysiege-all-rnr-threads""]","[""351120282"", ""74014041"", ""1169109691""]",2,1,3
65520623,4,98.75,-0.8211372643709183,4621511.0,2,0.5,"[""ottawashooting-all-rnr-threads"", ""sydneysiege-all-rnr-threads""]","[""19038934"", ""1020058453""]",2,2,4
570951676,3,51.666666666666664,-0.2040135065714518,1126942.0,2,0.3333333333333333,"[""ottawashooting-all-rnr-threads"", ""prince-toronto-all-rnr-threads""]","[""174700795"", ""18999969""]",1,2,3
19216594,3,112.33333333333333,0.4714721441268921,4620044.0,3,0.0,"[""ottawashooting-all-rnr-threads"", ""sydneysiege-all-rnr-threads""]","[""257291338"", ""7401202"", ""156123647""]",0,3,3
247866512,2,89.0,0.14295214414596558,1125496.0,2,0.5,"[""ottawashooting-all-rnr-threads"", ""prince-toronto-all-rnr-threads""]","[""1223101"", ""257291338""]",1,1,2
183832473,5,77.6,-0.26501381397247314,4642038.0,4,0.2,"[""ottawashooting-all-rnr-threads"", ""sydneysiege-all-rnr-threads""]","[""14173315"", ""16675569"", ""203123011"", ""954124423""]",1,4,5
393469195,4,83.75,-0.4539061635732651,4614713.0,21,0.5,"[""ottawashooting-all-rnr-threads"", ""sydneysiege-all-rnr-threads""]","[""89876954"", ""134033909"", ""16076032"", ""400360169"", ""2270138875"", ""11741632"", ""371920444"", ""29887789"", ""458608730"", ""93308808"", ""14592739"", ""49834861"", ""1074309715"", ""2308739186"", ""1287297769"", ""25407310"", ""49793399"", ""2432859764"", ""2762288549"", ""2213038500"", ""15400294""]",2,2,4
112532974,2,84.0,-0.47871464490890503,4667154.0,2,0.0,"[""ottawashooting-all-rnr-threads"", ""sydneysiege-all-rnr-threads""]","[""41085467"", ""5402612""]",0,2,2
15964823,2,131.0,-0.6435753107070923,4614345.0,2,0.0,"[""ottawashooting-all-rnr-threads"", ""sydneysiege-all-rnr-threads""]","[""930386257"", ""2768501""]",0,2,2
840859760,2,109.5,0.4923456907272339,1125847.0,2,0.5,"[""ottawashooting-all-rnr-threads"", ""prince-toronto-all-rnr-threads""]","[""203123011"", ""549587666""]",1,1,2
156123647,11,88.18181818181819,-0.03534442728215998,4618535.0,43,0.0,"[""ottawashooting-all-rnr-threads"", ""sydneysiege-all-rnr-threads""]","[""283501294"", ""2826946080"", ""1340573534"", ""142847511"", ""29249143"", ""22251439"", ""1520296801"", ""14253400"", ""2917213538"", ""69379823"", ""474150173"", ""374545627"", ""2434717220"", ""19431488"", ""216544692"", ""332063391"", ""302053300"", ""73653847"", ""23608974"", ""854239526"", ""347930138"", ""39704196"", ""282340727"", ""2369517908"", ""156123647"", ""579197401"", ""19216594"", ""10576322"", ""241775817"", ""407729904"", ""23468553"", ""558489512"", ""33087222"", ""14268064"", ""503693698"", ""282195067"", ""2813594772"", ""20258171"", ""2647049272"", ""12115432"", ""96500143"", ""1525868310"", ""79242025""]",0,11,11
870691879,2,43.0,-0.32729142904281616,4647302.0,2,0.0,"[""ottawashooting-all-rnr-threads"", ""sydneysiege-all-rnr-threads""]","[""592155963"", ""7587032""]",0,2,2
843685266,3,126.66666666666667,-0.08831206957499187,4622603.0,2,0.3333333333333333,"[""ottawashooting-all-rnr-threads"", ""sydneysiege-all-rnr-threads""]","[""6433472"", ""64643056""]",1,2,3
291414445,9,100.88888888888889,-0.1427321367793613,1138926.0,9,0.8888888888888888,"[""ottawashooting-all-rnr-threads"", ""prince-toronto-all-rnr-threads""]","[""21137035"", ""564807258"", ""291414445"", ""28540234"", ""291427994"", ""112716603"", ""23607802"", ""267219814"", ""251944136""]",8,1,9
2716912782,2,116.0,-0.5538626313209534,4739235.0,2,0.0,"[""ottawashooting-all-rnr-threads"", ""sydneysiege-all-rnr-threads""]","[""153029181"", ""5402612""]",0,2,2
86002394,4,55.5,0.014743685722351074,4619506.0,8,0.0,"[""ottawashooting-all-rnr-threads"", ""sydneysiege-all-rnr-threads""]","[""279781142"", ""18278257"", ""26104295"", ""269958757"", ""46763517"", ""22209272"", ""500405244"", ""28869233""]",0,4,4
2821577173,7,77.71428571428571,0.05797037056514195,4667383.0,7,0.0,"[""ottawashooting-all-rnr-threads"", ""sydneysiege-all-rnr-threads""]","[""14173315"", ""1367531"", ""384438102"", ""28785486"", ""742143"", ""16469809"", ""87818409""]",0,7,7
18145829,3,104.66666666666667,-0.0574342409769694,1127136.0,3,0.6666666666666666,"[""ottawashooting-all-rnr-threads"", ""prince-toronto-all-rnr-threads""]","[""26040618"", ""276708416"", ""194617976""]",2,1,3
18501635,2,119.0,-0.5903906226158142,4626903.0,2,0.5,"[""ottawashooting-all-rnr-threads"", ""sydneysiege-all-rnr-threads""]","[""39364684"", ""51241574""]",1,1,2
29189467,2,93.5,-0.6843360960483551,4660960.0,2,0.0,"[""ottawashooting-all-rnr-threads"", ""sydneysiege-all-rnr-threads""]","[""39364684"", ""133093395""]",0,2,2
19114232,2,133.5,-0.12075287103652954,1138392.0,4,0.5,"[""ottawashooting-all-rnr-threads"", ""prince-toronto-all-rnr-threads""]","[""1216410716"", ""11125052"", ""115833467"", ""20708703""]",1,1,2
772326630,4,75.75,-0.035223037004470825,4616212.0,4,0.75,"[""ottawashooting-all-rnr-threads"", ""sydneysiege-all-rnr-threads"", ""prince-toronto-all-rnr-threads""]","[""18594087"", ""17909653"", ""19038934"", ""1378163893""]",3,1,4
491461409,2,87.0,0.16704469919204712,4579213.0,2,0.0,"[""ottawashooting-all-rnr-threads"", ""sydneysiege-all-rnr-threads""]","[""39364684"", ""711348452""]",0,2,2
12987202,2,97.0,0.26248252391815186,1139016.0,20,0.5,"[""ottawashooting-all-rnr-threads"", ""prince-toronto-all-rnr-threads""]","[""20959518"", ""73121063"", ""22333382"", ""589213923"", ""134941111"", ""21359504"", ""39848809"", ""486194640"", ""16410157"", ""2369517908"", ""2739792487"", ""562287825"", ""964509788"", ""242394241"", ""26916944"", ""105306151"", ""42974852"", ""471579680"", ""21827064"", ""209609597""]",1,1,2
73121063,2,63.5,-0.163296639919281,4607875.0,2,0.5,"[""ottawashooting-all-rnr-threads"", ""sydneysiege-all-rnr-threads""]","[""12987202"", ""2768501""]",1,1,2
2739792487,5,121.0,0.1744415283203125,12468712.0,4,0.2,"[""ottawashooting-all-rnr-threads"", ""putinmissing-all-rnr-threads""]","[""47409343"", ""12987202"", ""18965790"", ""1427757265""]",1,4,5
2369517908,3,67.66666666666667,0.16565958658854166,4611692.0,2,0.0,"[""ottawashooting-all-rnr-threads"", ""sydneysiege-all-rnr-threads""]","[""12987202"", ""156123647""]",0,3,3
204832963,2,99.5,-0.14309009909629822,4609433.0,40,0.0,"[""ottawashooting-all-rnr-threads"", ""sydneysiege-all-rnr-threads""]","[""518311900"", ""95328073"", ""1210189555"", ""2788448292"", ""24001226"", ""68599996"", ""28198048"", ""2737577329"", ""33561971"", ""14409894"", ""55795410"", ""39359983"", ""1205946938"", ""6068542"", ""229803979"", ""207736024"", ""832598270"", ""2809015505"", ""15606701"", ""6331792"", ""40381745"", ""404460410"", ""2723055877"", ""536305079"", ""252192718"", ""258796139"", ""2727002783"", ""947586372"", ""352939772"", ""173431835"", ""15846020"", ""1087371074"", ""2217283489"", ""17857194"", ""392790310"", ""110314533"", ""405437947"", ""18337545"", ""1943677812"", ""293798728""]",0,2,2
495115403,4,77.5,-0.026858031749725342,4642694.0,3,0.5,"[""ottawashooting-all-rnr-threads"", ""sydneysiege-all-rnr-threads""]","[""508110571"", ""331998971"", ""28785486""]",2,2,4
98101047,3,123.0,-0.5934703548749288,4665694.0,3,0.0,"[""ottawashooting-all-rnr-threads"", ""sydneysiege-all-rnr-threads""]","[""16973333"", ""133093395"", ""149913262""]",0,3,3
262662868,2,114.5,-0.3362075686454773,4663761.0,2,0.5,"[""ottawashooting-all-rnr-threads"", ""sydneysiege-all-rnr-threads""]","[""5402612"", ""16469809""]",1,1,2
17700085,5,74.8,-0.36995735168457033,4664399.0,4,0.2,"[""ottawashooting-all-rnr-threads"", ""sydneysiege-all-rnr-threads""]","[""1960878613"", ""28785486"", ""37881687"", ""16811829""]",1,4,5
99337454,2,89.0,-0.3634486794471741,4644372.0,2,0.0,"[""ottawashooting-all-rnr-threads"", ""sydneysiege-all-rnr-threads""]","[""380648579"", ""28785486""]",0,2,2
2526192348,3,56.666666666666664,-0.26523826519648236,4663375.0,2,0.3333333333333333,"[""ottawashooting-all-rnr-threads"", ""sydneysiege-all-rnr-threads""]","[""129673790"", ""22968158""]",1,2,3
23111958,2,26.5,0.003193795680999756,4621310.0,2,0.5,"[""ottawashooting-all-rnr-threads"", ""sydneysiege-all-rnr-threads""]","[""14940354"", ""252794509""]",1,1,2
716501756,2,82.5,0.005004465579986572,1084721.0,2,0.5,"[""ottawashooting-all-rnr-threads"", ""prince-toronto-all-rnr-threads""]","[""16642807"", ""252794509""]",1,1,2
573210588,3,105.66666666666667,0.2661951382954915,1112243.0,2,0.6666666666666666,"[""ottawashooting-all-rnr-threads"", ""prince-toronto-all-rnr-threads""]","[""17909653"", ""252794509""]",2,1,3
2728348611,5,36.4,0.6563919067382813,4657007.0,5,0.0,"[""ottawashooting-all-rnr-threads"", ""sydneysiege-all-rnr-threads""]","[""14173315"", ""379590591"", ""16215478"", ""1702119050"", ""2768501""]",0,5,5
185472553,10,79.9,-0.2188997209072113,4615790.0,4,0.6,"[""ottawashooting-all-rnr-threads"", ""sydneysiege-all-rnr-threads""]","[""19041310"", ""292777349"", ""16664681"", ""7401202""]",6,4,10
2825490802,3,104.33333333333333,-0.4265563090642293,4658342.0,3,0.0,"[""ottawashooting-all-rnr-threads"", ""sydneysiege-all-rnr-threads""]","[""88734887"", ""50004938"", ""203123011""]",0,3,3
297080451,2,44.0,-0.1176755428314209,4658740.0,2,0.0,"[""ottawashooting-all-rnr-threads"", ""sydneysiege-all-rnr-threads""]","[""148116121"", ""64643056""]",0,2,2
342313862,6,117.16666666666667,-0.4040472110112508,1159636.0,4,0.5,"[""ottawashooting-all-rnr-threads"", ""prince-toronto-all-rnr-threads""]","[""575994658"", ""203123011"", ""148116121"", ""19057300""]",3,3,6
193114114,6,93.0,0.21900811791419983,4600457.0,2,0.6666666666666666,"[""ottawashooting-all-rnr-threads"", ""sydneysiege-all-rnr-threads""]","[""289998339"", ""5402612""]",4,2,6
2821078376,2,94.5,0.3343263268470764,4613700.0,2,0.0,"[""ottawashooting-all-rnr-threads"", ""sydneysiege-all-rnr-threads""]","[""1652541"", ""16469809""]",0,2,2
16106522,2,79.5,-0.45250141620635986,1148132.0,19,0.5,"[""ottawashooting-all-rnr-threads"", ""prince-toronto-all-rnr-threads""]","[""15433737"", ""780315337"", ""23811334"", ""128541148"", ""210874244"", ""19431488"", ""67246122"", ""50706943"", ""1616996281"", ""425924469"", ""25412430"", ""526528241"", ""2412689935"", ""20646854"", ""252382528"", ""80280391"", ""2683742138"", ""14690573"", ""1183313611""]",1,1,2
263691341,3,82.0,-0.12218765417734782,4575544.0,2,0.3333333333333333,"[""ottawashooting-all-rnr-threads"", ""sydneysiege-all-rnr-threads""]","[""254873869"", ""33798654""]",1,2,3
1703137165,2,55.5,-0.3203880786895752,4646128.0,2,0.0,"[""ottawashooting-all-rnr-threads"", ""sydneysiege-all-rnr-threads""]","[""220843663"", ""1888149452""]",0,2,2
287238322,3,99.0,-0.46206629276275635,1115389.0,2,0.3333333333333333,"[""ottawashooting-all-rnr-threads"", ""prince-toronto-all-rnr-threads""]","[""47705588"", ""18228708""]",1,2,3
1081973952,2,100.5,-0.24227583408355713,4671620.0,2,0.5,"[""ottawashooting-all-rnr-threads"", ""sydneysiege-all-rnr-threads""]","[""759251"", ""15966995""]",1,1,2
18649788,3,70.33333333333333,0.2632300059000651,4605020.0,3,0.0,"[""ottawashooting-all-rnr-threads"", ""sydneysiege-all-rnr-threads""]","[""28785486"", ""1374932796"", ""44166798""]",0,3,3
243121060,2,125.5,-0.3490159511566162,4629724.0,2,0.0,"[""ottawashooting-all-rnr-threads"", ""sydneysiege-all-rnr-threads""]","[""103065157"", ""87416722""]",0,2,2
261041421,3,63.666666666666664,0.013394991556803385,4601277.0,2,0.3333333333333333,"[""ottawashooting-all-rnr-threads"", ""sydneysiege-all-rnr-threads""]","[""6433472"", ""16973333""]",1,2,3
439502873,3,92.0,-0.3727523485819499,1118810.0,3,0.6666666666666666,"[""ottawashooting-all-rnr-threads"", ""prince-toronto-all-rnr-threads""]","[""87029364"", ""40316065"", ""22930902""]",2,1,3
156287314,2,105.0,0.06577897071838379,1119389.0,2,0.5,"[""ottawashooting-all-rnr-threads"", ""prince-toronto-all-rnr-threads""]","[""12848262"", ""107883101""]",1,1,2
13162152,2,111.5,-0.2344341278076172,1129730.0,2,0.5,"[""ottawashooting-all-rnr-threads"", ""prince-toronto-all-rnr-threads""]","[""68577152"", ""21137035""]",1,1,2
103065157,2,128.5,0.5710244178771973,4626404.0,46,0.0,"[""ottawashooting-all-rnr-threads"", ""sydneysiege-all-rnr-threads""]","[""1616016024"", ""1614191498"", ""51096905"", ""2752143491"", ""754701355"", ""1434049987"", ""1979584178"", ""271745440"", ""21850237"", ""132835684"", ""44870891"", ""1710379296"", ""2181414980"", ""2690666330"", ""495680721"", ""545052852"", ""2639204928"", ""242394505"", ""5854302"", ""19458057"", ""150452311"", ""422868987"", ""232294176"", ""169605328"", ""71319477"", ""25645943"", ""352224598"", ""132240706"", ""471183778"", ""43533997"", ""854003948"", ""24156429"", ""1008666679"", ""286600957"", ""1322357396"", ""1282844444"", ""324304367"", ""104258522"", ""415401869"", ""243121060"", ""1907702035"", ""23470695"", ""151827802"", ""164324743"", ""44109122"", ""1316863484""]",0,2,2
71319477,3,82.0,-0.14936920007069907,4650873.0,2,0.3333333333333333,"[""ottawashooting-all-rnr-threads"", ""sydneysiege-all-rnr-threads""]","[""103065157"", ""7587032""]",1,2,3
1375717166,5,129.6,-0.3112957000732422,4628914.0,2,0.4,"[""ottawashooting-all-rnr-threads"", ""sydneysiege-all-rnr-threads""]","[""2271035214"", ""742143""]",2,3,5
2738332984,3,26.666666666666668,0.4923270543416341,4669353.0,3,0.0,"[""ottawashooting-all-rnr-threads"", ""sydneysiege-all-rnr-threads""]","[""35441526"", ""67197351"", ""428333""]",0,3,3
176310317,6,71.66666666666667,-0.5336423615614573,4674312.0,3,0.8333333333333334,"[""ottawashooting-all-rnr-threads"", ""sydneysiege-all-rnr-threads""]","[""2467791"", ""14216661"", ""5402612""]",5,1,6
328440716,2,56.5,-0.20829075574874878,4628565.0,2,0.0,"[""ottawashooting-all-rnr-threads"", ""sydneysiege-all-rnr-threads""]","[""19899606"", ""14216661""]",0,2,2
19518885,2,89.5,-0.5596327781677246,4600277.0,2,0.0,"[""ottawashooting-all-rnr-threads"", ""sydneysiege-all-rnr-threads""]","[""2799960092"", ""742143""]",0,2,2
246574430,2,39.5,0.1969895362854004,1127045.0,2,0.5,"[""ottawashooting-all-rnr-threads"", ""prince-toronto-all-rnr-threads""]","[""21359504"", ""635608354""]",1,1,2
1256370990,2,104.0,0.08720260858535767,4608543.0,2,0.0,"[""ottawashooting-all-rnr-threads"", ""sydneysiege-all-rnr-threads""]","[""635608354"", ""16469809""]",0,2,2
96500143,2,123.0,0.32858896255493164,4596649.0,2,0.0,"[""ottawashooting-all-rnr-threads"", ""sydneysiege-all-rnr-threads""]","[""2163076560"", ""156123647""]",0,2,2
457119703,4,63.5,-0.13862541317939758,4592680.0,2,0.25,"[""ottawashooting-all-rnr-threads"", ""sydneysiege-all-rnr-threads""]","[""412682869"", ""19292807""]",1,3,4
275430896,2,51.5,-0.6912773549556732,4629798.0,2,0.5,"[""ottawashooting-all-rnr-threads"", ""sydneysiege-all-rnr-threads""]","[""17354377"", ""2897135260""]",1,1,2
331344120,2,98.5,0.2778094410896301,1116003.0,2,0.5,"[""ottawashooting-all-rnr-threads"", ""prince-toronto-all-rnr-threads""]","[""19000033"", ""36419991""]",1,1,2
12993222,7,121.85714285714286,-0.37956684827804565,1126156.0,56,0.8571428571428571,"[""ottawashooting-all-rnr-threads"", ""prince-toronto-all-rnr-threads""]","[""9886882"", ""9606552"", ""306466505"", ""320788003"", ""300533440"", ""329292840"", ""43900191"", ""2186460294"", ""299556884"", ""29457256"", ""385178828"", ""105400920"", ""313689878"", ""710146483"", ""2758723732"", ""14431283"", ""23226549"", ""284308565"", ""2291437513"", ""798274"", ""1548856122"", ""12208042"", ""19578119"", ""19897469"", ""18774528"", ""2264940392"", ""1626623202"", ""213810836"", ""1262935440"", ""31143391"", ""23366711"", ""610414467"", ""129070316"", ""2540432978"", ""1373601"", ""2714377555"", ""30121919"", ""15102684"", ""26823774"", ""20408413"", ""23857263"", ""15240920"", ""503693698"", ""430880741"", ""25996734"", ""573857778"", ""2333000980"", ""51158622"", ""201034694"", ""228295036"", ""142745975"", ""23976801"", ""276408922"", ""80005970"", ""384991535"", ""188788876""]",6,1,7
180853802,3,58.666666666666664,-0.3364230791727702,4645332.0,2,0.0,"[""ottawashooting-all-rnr-threads"", ""sydneysiege-all-rnr-threads""]","[""1367531"", ""51241574""]",0,3,3
721092824,2,135.5,-0.795846551656723,4593350.0,2,0.5,"[""ottawashooting-all-rnr-threads"", ""sydneysiege-all-rnr-threads""]","[""51241574"", ""742143""]",1,1,2
499696436,8,106.125,-0.1378636136651039,4591370.0,34,0.375,"[""ottawashooting-all-rnr-threads"", ""sydneysiege-all-rnr-threads""]","[""51241574"", ""147696136"", ""15787301"", ""516103610"", ""832990914"", ""2194747062"", ""82998105"", ""430096982"", ""877020889"", ""415312254"", ""2910763730"", ""15877276"", ""499696436"", ""22070847"", ""762373104"", ""252054530"", ""2478060493"", ""390421144"", ""215133466"", ""71796084"", ""965259080"", ""2237808535"", ""49551808"", ""2453850531"", ""2524504334"", ""19650408"", ""901337576"", ""25298606"", ""2261645749"", ""21190891"", ""18546055"", ""2753308284"", ""293204804"", ""316777623""]",3,5,8
253533891,2,89.0,0.18590790033340454,4592183.0,2,0.0,"[""ottawashooting-all-rnr-threads"", ""sydneysiege-all-rnr-threads""]","[""17537467"", ""141084952""]",0,2,2
1865005212,2,121.0,-0.4539037048816681,12299046.0,2,0.5,"[""ottawashooting-all-rnr-threads"", ""putinmissing-all-rnr-threads""]","[""141084952"", ""988324790""]",1,1,2
1534113012,4,106.75,-0.5605124682188034,4586553.0,2,0.75,"[""ottawashooting-all-rnr-threads"", ""sydneysiege-all-rnr-threads""]","[""972651"", ""358347117""]",3,1,4
430096982,4,37.25,-0.2983658015727997,4577819.0,3,0.75,"[""ottawashooting-all-rnr-threads"", ""sydneysiege-all-rnr-threads""]","[""258627226"", ""499696436"", ""358347117""]",3,1,4
2827694780,3,114.33333333333333,-0.47010719776153564,4583663.0,3,0.0,"[""ottawashooting-all-rnr-threads"", ""sydneysiege-all-rnr-threads""]","[""16992416"", ""358347117"", ""20891396""]",0,3,3
218308653,2,109.0,-0.3378828167915344,1120692.0,2,0.5,"[""ottawashooting-all-rnr-threads"", ""prince-toronto-all-rnr-threads""]","[""26040618"", ""18479513""]",1,1,2
534721187,2,130.5,-0.8645128607749939,4618013.0,2,0.0,"[""ottawashooting-all-rnr-threads"", ""sydneysiege-all-rnr-threads""]","[""7589572"", ""1367531""]",0,2,2
38156420,3,68.0,-0.0861043135325114,4592860.0,10,0.6666666666666666,"[""ottawashooting-all-rnr-threads"", ""sydneysiege-all-rnr-threads""]","[""27831488"", ""15432179"", ""948701443"", ""54763576"", ""45670812"", ""40049352"", ""2209778173"", ""131606751"", ""16368367"", ""168676003""]",2,1,3
128798208,2,112.5,0.2460254430770874,4605254.0,2,0.5,"[""ottawashooting-all-rnr-threads"", ""sydneysiege-all-rnr-threads""]","[""742143"", ""1169109691""]",1,1,2
136635546,2,66.5,-0.25471723079681396,4614274.0,2,0.0,"[""ottawashooting-all-rnr-threads"", ""sydneysiege-all-rnr-threads""]","[""14316371"", ""1169109691""]",0,2,2
1658154254,2,126.5,-0.8346920907497406,4596929.0,2,0.0,"[""ottawashooting-all-rnr-threads"", ""sydneysiege-all-rnr-threads""]","[""35051304"", ""20748745""]",0,2,2
2725366949,2,87.0,-0.5503442883491516,4595561.0,2,0.5,"[""ottawashooting-all-rnr-threads"", ""sydneysiege-all-rnr-threads""]","[""20748745"", ""16031927""]",1,1,2
190055835,2,72.5,0.35507214069366455,1106751.0,2,0.5,"[""ottawashooting-all-rnr-threads"", ""prince-toronto-all-rnr-threads""]","[""42672470"", ""257291338""]",1,1,2
132220923,2,110.0,-0.22423076629638672,4608230.0,2,0.5,"[""ottawashooting-all-rnr-threads"", ""sydneysiege-all-rnr-threads""]","[""257291338"", ""16834659""]",1,1,2
1363461480,2,84.5,-0.5470419526100159,4594848.0,2,0.0,"[""ottawashooting-all-rnr-threads"", ""sydneysiege-all-rnr-threads""]","[""377163508"", ""46213956""]",0,2,2
635204214,3,100.33333333333333,-0.16137073437372842,4609802.0,3,0.0,"[""ottawashooting-all-rnr-threads"", ""sydneysiege-all-rnr-threads""]","[""373783051"", ""2260706071"", ""20043786""]",0,3,3
2531741394,2,78.0,-0.4379732608795166,4585682.0,2,0.0,"[""ottawashooting-all-rnr-threads"", ""sydneysiege-all-rnr-threads""]","[""148653311"", ""246130881""]",0,2,2
23885575,3,107.33333333333333,-0.12565787633260092,1111509.0,4,0.6666666666666666,"[""ottawashooting-all-rnr-threads"", ""prince-toronto-all-rnr-threads""]","[""318835344"", ""6433472"", ""332580928"", ""270535933""]",2,1,3
1729065984,2,27.0,0.0013695955276489258,4621631.0,2,0.5,"[""ottawashooting-all-rnr-threads"", ""sydneysiege-all-rnr-threads""]","[""742143"", ""64643056""]",1,1,2
174050336,2,131.0,-0.08316737413406372,4586433.0,2,0.5,"[""ottawashooting-all-rnr-threads"", ""sydneysiege-all-rnr-threads""]","[""20639175"", ""24000965""]",1,1,2
15232098,2,120.5,-0.008608877658843994,4600702.0,14,0.0,"[""ottawashooting-all-rnr-threads"", ""sydneysiege-all-rnr-threads""]","[""85706862"", ""2154834407"", ""1457294988"", ""14913761"", ""74194971"", ""19682106"", ""1198117633"", ""960446563"", ""462884580"", ""523456759"", ""1554738476"", ""375359863"", ""167283308"", ""1476174037""]",0,2,2
23608974,2,43.0,-0.4718782305717468,3475253.0,2,0.5,"[""sydneysiege-all-rnr-threads"", ""prince-toronto-all-rnr-threads""]","[""21359504"", ""156123647""]",1,1,2
1333122608,7,126.71428571428571,-0.33256312779017855,7592698.0,4,0.8571428571428571,"[""sydneysiege-all-rnr-threads"", ""putinmissing-all-rnr-threads""]","[""65616414"", ""2557287270"", ""87416722"", ""1333122608""]",6,1,7
1368100356,7,94.14285714285714,-0.3493461183139256,7636631.0,6,0.42857142857142855,"[""sydneysiege-all-rnr-threads"", ""putinmissing-all-rnr-threads""]","[""16198940"", ""3684431"", ""65616414"", ""37881687"", ""44544222"", ""16675569""]",3,4,7
137777900,2,73.5,-0.5404835641384125,7631081.0,2,1.0,"[""sydneysiege-all-rnr-threads"", ""putinmissing-all-rnr-threads""]","[""156464691"", ""833057665""]",2,0,2
148224229,2,133.0,-0.43346405029296875,7638690.0,1,1.0,"[""sydneysiege-all-rnr-threads"", ""putinmissing-all-rnr-threads""]","[""2467791""]",2,0,2
16931849,3,88.0,-0.4156467914581299,7728535.0,5,0.3333333333333333,"[""sydneysiege-all-rnr-threads"", ""putinmissing-all-rnr-threads""]","[""420842266"", ""376884268"", ""875809039"", ""520011678"", ""5469742""]",1,2,3
875809039,3,115.33333333333333,-0.4943489034970601,7733538.0,2,1.0,"[""sydneysiege-all-rnr-threads"", ""putinmissing-all-rnr-threads""]","[""16031927"", ""16931849""]",3,0,3
17879224,4,97.0,-0.3223348706960678,7760953.0,3,1.0,"[""sydneysiege-all-rnr-threads"", ""putinmissing-all-rnr-threads""]","[""20639175"", ""1265727487"", ""2608248157""]",4,0,4
2862224447,5,69.4,-0.06090161800384521,7699769.0,7,0.2,"[""sydneysiege-all-rnr-threads"", ""putinmissing-all-rnr-threads""]","[""267906861"", ""20402945"", ""1048468734"", ""2225747204"", ""15438913"", ""2862224447"", ""2219938974""]",1,4,5
60618619,5,90.6,-0.21513261795043945,7779860.0,2,1.0,"[""sydneysiege-all-rnr-threads"", ""putinmissing-all-rnr-threads""]","[""64643056"", ""399314636""]",5,0,5
870204643,2,56.5,-0.16417747735977173,7750942.0,2,1.0,"[""sydneysiege-all-rnr-threads"", ""putinmissing-all-rnr-threads""]","[""205242337"", ""16710420""]",2,0,2
41109410,2,131.5,-0.38418319821357727,7736896.0,2,0.5,"[""sydneysiege-all-rnr-threads"", ""putinmissing-all-rnr-threads""]","[""315878798"", ""10774652""]",1,1,2
143182513,2,96.5,0.37256985902786255,7905517.0,2,1.0,"[""sydneysiege-all-rnr-threads"", ""putinmissing-all-rnr-threads""]","[""260076391"", ""87416722""]",2,0,2
37919483,2,70.0,-0.10002607107162476,7721718.0,2,0.0,"[""sydneysiege-all-rnr-threads"", ""putinmissing-all-rnr-threads""]","[""2331419624"", ""2163076560""]",0,2,2
49622659,2,62.5,-0.6577948927879333,7733058.0,1,0.0,"[""sydneysiege-all-rnr-threads"", ""putinmissing-all-rnr-threads""]","[""18101696""]",0,2,2
296988845,2,76.5,-0.5384378135204315,7867206.0,2,0.5,"[""sydneysiege-all-rnr-threads"", ""putinmissing-all-rnr-threads""]","[""2768501"", ""64643056""]",1,1,2
